id,season_id,team_id,player_id,games,points,goals,assists,penalty,p_m
109,71,66,3652,79,61,21,40,74,-13
143,74,69,8492,80,52,21,31,37,-6
160,59,80,8580,66,34,22,12,18,-12
179,74,77,9475,39,9,1,8,16,-1
196,29,79,31372,33,6,1,5,2,-2
211,65,82,8810,39,25,15,10,14,-11
214,71,88,8810,72,50,27,23,44,8
231,77,83,8560,51,24,3,21,67,-4
248,77,65,8870,81,49,14,35,32,6
265,68,72,9076,47,15,8,7,17,-7
282,83,69,8898,42,24,15,9,14,0
299,71,89,10349,73,31,13,18,32,0
316,29,70,24026,69,16,10,6,36,10
332,53,71,8913,24,7,1,6,12,-1
335,62,81,8913,3,0,0,0,0,-2
356,71,88,219473,82,41,11,30,28,-6
374,65,74,11427,82,26,11,15,59,2
409,77,70,9140,54,17,11,6,27,-5
426,5,88,72768,26,3,0,3,76,-4
443,86,84,757,81,29,11,18,22,-11
459,56,73,9502,63,12,4,8,19,-2
462,65,73,9502,66,21,4,17,4,-8
479,20,65,9104,72,48,10,38,112,16
497,56,72,9629,16,1,1,0,2,-4
515,56,74,9430,16,4,1,3,2,-2
532,50,63,9074,77,70,22,48,26,-28
549,59,73,9499,78,43,16,27,36,0
566,80,77,13406,3,1,1,0,0,1
584,17,74,52055,10,0,0,0,26,-3
587,86,72,204970,3,0,0,0,2,-2
605,56,75,8985,79,28,15,13,76,9
622,2,76,54467,25,2,1,1,59,-6
639,74,78,11429,80,58,26,32,104,7
677,59,67,8945,60,26,13,13,47,-14
695,47,71,9023,7,0,0,0,0,-3
710,68,83,11722,8,2,1,1,6,4
713,50,77,8679,40,13,3,10,18,-6
730,86,80,153712,36,14,5,9,10,-7
747,65,84,12393,12,1,0,1,2,6
764,14,85,21323,45,58,14,44,72,18
782,59,82,8368,62,13,3,10,36,-14
802,29,78,42512,25,1,0,1,118,-5
821,17,62,250333,7,0,0,0,0,-1
836,17,71,70045,78,70,31,39,41,-15
839,56,79,9469,15,1,0,1,22,-1
863,74,87,9467,3,0,0,0,2,-1
880,80,82,10362,20,3,2,1,12,0
897,59,78,15415,8,2,0,2,4,3
920,56,78,10197,14,13,3,10,2,-3
962,2,75,21892,71,47,23,24,138,9
977,53,88,9435,4,1,1,0,6,-2
980,62,83,11481,23,3,2,1,12,-7
998,68,88,10207,16,6,1,5,10,2
1016,29,65,231486,45,24,6,18,14,-4
1033,83,70,10988,36,3,1,2,31,11
1050,62,81,10262,79,25,10,15,29,-6
1067,53,1479,11404,26,5,2,3,6,-1
1084,11,84,27951,82,70,26,44,123,15
1100,23,88,22367,58,18,12,6,27,-2
1103,2,84,76693,7,0,0,0,27,-3
1125,23,86,31538,67,29,12,17,25,4
1142,62,76,13407,27,6,0,6,15,-12
1159,59,69,9093,82,32,9,23,22,-3
1176,50,83,11169,1,1,1,0,0,1
1196,14,86,64641,29,2,0,2,61,0
1236,65,547,10663,66,53,12,41,72,-8
1239,74,547,10663,69,45,18,27,124,5
1260,68,86,10211,48,7,3,4,29,5
1277,62,73,10221,80,9,2,7,83,1
1294,59,76,9731,82,48,30,18,16,-1
1311,71,79,14081,67,13,4,9,90,-8
1328,23,1479,27901,53,17,2,15,28,-10
1349,62,1479,11719,9,1,0,1,7,-3
1367,56,78,14128,6,2,1,1,0,-1
1370,68,78,14128,29,8,2,6,0,5
1387,68,64,11417,33,9,3,6,6,-11
1404,35,86,21509,82,58,20,38,60,8
1422,53,1479,9466,5,0,0,0,2,2
1439,68,69,11359,48,10,0,10,42,0
1456,56,77,10317,47,8,4,4,22,8
1476,8,86,72168,20,8,2,6,41,-14
1494,68,62,9154,47,15,4,11,40,-7
1511,20,77,76440,82,46,12,34,50,25
1528,23,63,8756,79,27,10,17,82,-13
1545,2,75,27465,2,0,0,0,0,-2
1567,47,71,8896,10,0,0,0,6,-1
1588,2,79,31677,9,0,0,0,6,-4
1605,29,62,41331,49,10,3,7,28,4
1623,35,89,3581,33,17,1,16,6,3
1627,53,63,3581,82,33,11,22,36,-3
1644,14,70,38461,35,25,11,14,29,3
1664,32,83,9131,82,20,13,7,214,2
1681,23,70,47079,1,0,0,0,0,-1
1701,23,85,9139,64,23,13,10,45,5
1719,14,88,73233,43,20,15,5,20,-3
1740,11,86,32036,84,30,12,18,28,8
1755,20,71,72764,22,1,0,1,15,-1
1776,83,83,199952,62,63,34,29,12,25
1798,80,547,221722,73,64,36,28,26,7
1815,83,80,105932,4,1,0,1,0,0
1832,65,62,10977,67,48,26,22,62,-13
1849,86,78,269093,16,3,1,2,4,-1
1868,17,63,11571,59,46,13,33,40,2
1884,47,70,11001,5,1,1,0,12,0
1887,53,81,11001,19,2,1,1,9,-5
1904,86,66,199716,2,0,0,0,2,0
1921,77,89,4226,79,71,50,21,53,21
1938,83,79,4229,78,98,42,56,87,16
1956,56,63,9210,81,45,21,24,46,36
1974,65,65,8648,6,0,0,0,6,-1
1991,50,67,9173,41,27,13,14,33,5
90,5,78,31023,66,35,10,25,95,7
2033,80,70,4217,60,20,8,12,10,5
2072,56,81,8660,52,16,2,14,36,-4
2090,59,89,9486,73,23,3,20,32,50
2107,77,85,9471,74,35,7,28,38,-6
2124,56,65,9188,81,47,19,28,52,19
2139,83,84,59095,68,11,1,10,35,-7
2142,5,78,21563,79,59,23,36,66,-5
2166,62,65,11343,78,37,17,20,40,6
2183,65,62,9185,58,15,5,10,24,0
2200,83,64,793,77,37,16,21,26,0
2220,80,83,34785,82,36,4,32,38,-22
2237,80,62,2435,3,0,0,0,2,-4
2254,62,79,9431,60,31,9,22,28,20
2269,53,63,9223,56,27,6,21,20,-3
2272,62,63,9223,75,62,13,49,28,23
2291,62,79,17758,4,3,1,2,5,1
2310,50,67,9243,2,0,0,0,2,1
2344,23,74,68552,12,0,0,0,7,-5
2362,71,65,4100,17,4,2,2,2,5
2379,8,75,67315,75,14,5,9,193,6
2394,65,79,11538,60,33,11,22,29,10
2397,74,86,11538,25,9,4,5,8,1
2416,32,88,2664,47,4,0,4,43,3
2433,26,86,10823,5,0,0,0,13,0
2454,47,83,9010,79,28,17,11,63,-6
2472,56,73,11408,46,17,7,10,22,1
2491,59,64,9208,16,3,2,1,0,-4
2527,53,86,11436,82,20,10,10,50,-3
2542,56,74,9432,81,40,22,18,45,7
2545,65,74,9432,76,54,29,25,61,-8
2562,65,68,9479,71,54,23,31,49,4
2579,56,65,9412,1,0,0,0,2,1
2599,50,76,10873,1,0,0,0,0,0
2633,56,89,8613,52,33,11,22,50,4
2650,17,77,31458,24,15,10,5,24,1
2665,68,71,9417,27,1,1,0,53,-8
2668,74,86,9417,12,0,0,0,22,0
2686,5,84,26141,44,34,14,20,17,1
2703,53,67,10982,40,5,3,2,41,1
2720,74,83,11414,57,29,11,18,8,7
2737,56,64,12365,11,0,0,0,2,-4
2763,17,88,71089,50,5,3,2,102,-6
2782,11,68,9150,83,32,18,14,54,-3
2798,20,68,73027,4,0,0,0,0,-2
2801,59,82,9428,2,0,0,0,0,-1
2818,50,67,8952,3,1,0,1,2,-1
2835,32,74,21308,62,74,30,44,122,0
2852,77,78,10666,82,39,18,21,62,2
2869,62,64,9426,51,10,0,10,16,-19
2906,86,88,238538,33,11,8,3,9,-2
2924,68,1479,11479,48,19,6,13,16,13
2927,74,79,11479,21,9,2,7,8,8
2944,65,73,11748,5,0,0,0,0,-1
2961,68,84,2364,47,27,10,17,8,12
2971,29,81,14735,13,2,1,1,2,0
2972,32,62,14735,49,4,1,3,16,-4
2973,47,65,9087,77,34,16,18,56,3
2974,50,65,9087,44,17,7,10,38,-4
2975,53,65,9087,62,24,10,14,42,6
2976,56,62,9087,58,40,21,19,70,18
3051,5,88,70559,5,0,0,0,11,-1
3054,26,85,1581,4,0,0,0,0,-2
3075,41,1479,8989,10,4,1,3,4,-1
3096,2,63,32088,70,27,6,21,84,0
3113,23,70,29041,2,0,0,0,2,1
3150,11,74,22101,71,52,28,24,58,11
3170,56,64,10407,79,20,15,5,162,-11
3185,53,65,9192,1,0,0,0,0,-1
3188,65,75,9192,39,4,2,2,27,-1
3205,29,73,14736,10,3,2,1,6,-4
3223,47,68,233743,82,41,17,24,80,27
3240,80,78,10208,66,40,18,22,36,4
3257,59,79,6142,81,109,51,58,71,15
3274,74,80,9206,78,54,18,36,24,5
3291,83,82,9203,77,11,3,8,22,-6
3306,29,68,69618,2,0,0,0,0,0
3309,56,65,9213,8,1,1,0,5,-3
3326,53,86,9358,44,17,11,6,8,6
3345,59,74,9179,82,27,8,19,44,11
3362,65,88,4227,82,76,25,51,20,12
3386,86,70,9231,7,2,1,1,4,-4
3422,68,78,9204,30,20,7,13,15,-5
3437,59,70,9211,74,15,3,12,18,-15
3440,65,79,9211,75,21,4,17,47,9
3457,71,77,9183,51,17,3,14,70,-3
3474,71,1479,9182,82,42,21,21,26,13
3491,83,20120,9360,71,44,25,19,24,-11
3508,50,63,9229,9,5,4,1,6,0
3525,59,63,11320,19,1,1,0,21,-5
3542,71,80,12384,33,2,1,1,63,-1
3560,83,79,9184,79,51,9,42,56,-9
3563,80,547,177730,20,5,2,3,4,-7
3580,74,62,9186,79,34,4,30,17,18
3605,83,68,10236,82,56,8,48,35,7
3622,80,67,10428,68,19,3,16,34,-5
3639,17,78,26580,17,1,0,1,8,-1
3656,29,84,9029,75,26,5,21,54,-3
3695,5,78,42495,13,2,1,1,8,-3
3698,5,88,70098,33,9,3,6,14,-3
3718,62,80,9354,1,0,0,0,0,0
3735,65,71,14866,5,1,1,0,2,2
3752,20,86,69468,79,21,0,21,101,-20
3753,23,86,69468,64,21,8,13,31,-13
3754,23,78,69468,11,9,5,4,10,2
3755,26,78,69468,28,5,2,3,16,-6
3756,26,85,69468,23,4,2,2,11,-4
3758,29,85,69468,13,2,2,0,15,2
3824,5,83,20597,40,49,15,34,32,13
3827,14,83,20597,44,33,10,23,26,-5
3844,56,64,13618,6,1,0,1,0,0
3861,86,85,50295,62,18,8,10,29,-8
2009,53,63,4123,57,10,7,3,19,0
3912,59,73,11353,31,11,2,9,4,1
3946,65,72,18017,82,17,4,13,26,-4
3949,74,71,18017,74,8,2,6,14,-21
3966,65,88,15477,81,12,5,7,123,-5
3987,65,1479,31572,2,0,0,0,0,-2
4005,20,76,1246,74,43,12,31,57,4
4022,47,81,9132,34,1,0,1,22,-10
4039,62,66,11627,1,0,0,0,0,0
4057,50,65,9007,82,31,2,29,76,0
4072,65,69,14861,3,0,0,0,2,-2
4075,59,75,11718,40,4,2,2,26,-12
4092,74,87,15068,70,9,3,6,36,-11
4109,62,80,15304,24,13,6,7,10,2
4126,65,74,4155,53,18,2,16,20,9
4147,59,64,10398,61,20,7,13,20,0
4164,77,79,3678,82,51,22,29,36,15
4183,83,85,168738,14,4,2,2,8,-2
4204,38,67,9072,68,32,11,21,20,-13
4223,50,78,10201,27,2,1,1,52,-3
4240,26,65,10819,22,7,2,5,4,5
4257,17,88,21431,49,35,17,18,46,-5
4279,32,74,21401,26,4,1,3,6,-2
4296,65,84,18616,6,2,0,2,5,1
4313,65,66,10405,73,12,5,7,23,0
4328,65,86,14618,76,17,4,13,47,4
4331,74,86,14618,56,8,5,3,50,-2
4348,5,71,10861,58,28,12,16,18,-2
4369,38,77,54636,5,1,0,1,2,1
4387,86,83,316113,4,1,1,0,0,-3
4404,8,88,9669,45,65,16,49,6,6
4421,83,74,11117,71,28,6,22,18,-22
4438,35,85,8759,81,20,8,12,44,-5
4453,71,70,10975,25,1,0,1,11,-6
4475,11,62,68895,2,2,1,1,7,2
4497,14,85,70659,4,1,0,1,6,2
4514,20,88,16744,65,32,10,22,10,-9
4531,38,62,53937,69,17,3,14,126,5
4549,32,69,18371,13,6,4,2,6,2
4566,59,82,729588,24,6,2,4,12,-6
4582,41,70,2695,16,1,1,0,0,-9
4585,53,70,2695,69,34,15,19,34,4
4602,17,84,16136,15,13,6,7,8,-2
4619,8,77,1634,52,16,2,14,61,3
4636,8,88,31214,11,3,0,3,4,-4
4653,5,67,9102,14,3,1,2,18,-3
4674,17,68,73031,3,0,0,0,0,-1
4696,59,86,4335,9,5,3,2,0,-1
4712,20,80,24168,22,5,1,4,19,3
4715,86,62,146598,79,32,14,18,12,6
4753,17,65,26597,11,1,0,1,48,5
4770,56,82,11398,5,1,0,1,0,-2
4788,20,86,8485,63,18,6,12,69,-22
4805,77,86,49212,81,46,21,25,26,16
4822,26,78,9114,69,39,14,25,38,14
4837,8,77,74537,21,5,3,2,17,-1
4840,74,547,90399,65,22,7,15,46,2
4857,86,73,29640,64,50,28,22,26,8
4874,86,78,89464,80,28,10,18,15,20
4895,65,68,8847,7,1,1,0,0,0
4914,53,70,10992,22,5,3,2,6,0
4934,56,72,9163,49,9,2,7,22,3
4952,32,82,42489,4,0,0,0,2,1
4970,65,72,9039,11,2,0,2,0,0
4973,74,72,9039,43,5,3,2,4,-10
4995,29,70,32604,14,0,0,0,10,-1
5032,80,71,93624,10,1,1,0,2,1
5049,17,63,32204,82,49,23,26,46,6
5066,86,80,92726,81,48,9,39,26,-22
5083,47,64,8736,18,3,2,1,2,-6
5105,50,78,9138,60,12,6,6,38,-14
5108,17,65,28796,7,0,0,0,2,2
5127,14,65,25914,16,0,0,0,8,-5
5144,8,65,54635,12,5,0,5,0,2
5163,20,72,8541,82,62,23,39,54,24
5187,20,74,47281,3,0,0,0,6,-1
5207,23,78,69465,10,1,1,0,6,0
5224,8,67,67352,15,8,3,5,6,5
5243,14,67,67306,28,3,1,2,68,1
5246,23,76,67306,31,3,1,2,47,-6
5269,26,62,21375,79,54,11,43,52,14
5286,5,77,22128,42,25,7,18,18,18
5324,14,67,32176,32,6,2,4,36,-1
5341,8,65,70626,36,7,1,6,44,-6
5361,20,76,19611,51,10,7,3,57,-4
5376,83,85,37783,81,15,0,15,27,-8
5379,86,67,310583,82,44,9,35,34,-13
5397,2,74,54393,47,13,5,8,10,2
5418,23,64,9153,77,17,3,14,124,-3
5435,11,63,67703,36,1,0,1,144,-2
5457,5,89,21420,80,78,28,50,205,-2
5475,2,89,21416,30,14,6,8,124,-1
5492,83,84,39385,40,3,3,0,16,-7
5507,86,86,73344,27,8,3,5,4,1
5511,5,65,71078,1,0,0,0,2,0
5528,50,74,8626,82,96,30,66,78,26
5545,86,82,80656,82,47,27,20,60,25
5572,29,65,53019,36,6,0,6,73,-2
5609,14,83,60366,10,2,0,2,7,-6
5626,47,70,9049,70,40,13,27,115,0
5641,26,89,13685,67,29,8,21,22,10
5644,35,89,13685,11,2,2,0,8,-4
5666,20,63,1316,44,18,4,14,8,-3
5689,26,70,8835,80,30,9,21,102,21
5706,14,84,9040,45,13,2,11,34,-3
5723,8,63,30314,73,31,18,13,24,20
5742,17,76,23271,16,5,1,4,33,-6
5759,17,79,54457,70,19,5,14,71,6
5778,26,73,9043,63,18,6,12,44,-24
5781,35,82,9043,28,3,1,2,7,-9
5798,35,78,9050,23,3,0,3,28,1
5815,8,77,26584,21,4,1,3,2,-4
3895,26,71,8698,14,6,1,5,8,2
5874,14,62,48582,30,15,7,8,45,5
5910,35,89,21562,61,21,9,12,12,2
5913,8,74,52061,30,3,0,3,67,-1
5936,5,71,72199,57,34,21,13,52,-18
5953,41,79,26328,49,3,1,2,85,-10
5970,8,74,40947,65,9,3,6,131,-9
5991,8,86,72165,10,2,0,2,12,-9
6010,11,74,52376,46,8,3,5,102,-8
6027,41,73,9026,82,32,14,18,33,-21
6050,23,66,32133,81,36,16,20,12,-8
6053,32,82,32133,59,19,8,11,10,4
6071,20,64,53594,67,43,23,20,105,5
6090,5,76,2927,1,0,0,0,0,0
6107,14,77,104410,42,7,4,3,6,-13
6124,8,63,21386,84,102,32,70,33,23
6142,35,80,4713,63,22,6,16,29,5
6159,38,67,8778,76,35,14,21,44,-14
6177,50,1479,4482,24,11,1,10,10,3
6199,17,64,21349,81,85,38,47,85,14
6218,41,83,10822,1,0,0,0,0,0
6245,47,63,8703,19,8,2,6,8,-2
6264,38,68,8285,36,4,3,1,78,-4
6281,62,85,8647,75,10,2,8,48,0
6304,68,77,8767,34,16,6,10,10,-13
6319,35,89,8628,71,43,17,26,38,5
6322,47,89,8628,71,57,23,34,84,3
6339,26,86,8569,78,38,16,22,52,7
6356,32,68,11033,8,0,0,0,0,-1
6373,26,79,602,4,0,0,0,2,2
6390,38,71,10217,20,2,0,2,12,-3
6407,32,65,19556,53,15,2,13,39,-4
6424,41,68,8750,56,19,6,13,24,-2
6439,86,79,8750,71,20,7,13,14,6
6459,59,63,255997,77,14,5,9,53,-7
6479,32,64,19117,3,0,0,0,0,0
6496,62,72,8817,69,6,0,6,48,-2
6513,47,79,8986,73,51,22,29,61,-24
6530,68,63,4525,48,19,7,12,70,14
6547,26,71,8912,73,21,5,16,42,10
6562,26,68,12723,1,0,0,0,0,1
6565,35,64,8897,63,5,1,4,154,0
6584,35,76,8582,71,38,13,25,80,-4
6602,41,88,8559,48,13,6,7,27,0
6620,56,77,8790,78,20,8,12,155,0
6637,59,81,8902,16,2,0,2,4,-5
6654,38,84,29033,1,0,0,0,2,0
6671,35,1479,729581,65,15,7,8,10,-9
6688,14,89,9012,23,4,3,1,41,2
6691,23,89,9012,51,6,4,2,46,-3
6727,65,1479,2673,74,13,0,13,46,0
6747,5,76,70557,8,1,1,0,2,-2
6766,68,71,28376,26,3,0,3,10,-1
6783,23,1479,411791,19,3,3,0,6,-10
6805,23,76,27549,78,20,10,10,47,-9
6820,35,79,8687,79,29,9,20,47,-6
6823,50,74,8687,80,40,10,30,52,10
6842,50,89,9089,57,13,4,9,47,-5
6860,17,85,21306,81,34,14,20,139,60
6877,35,73,69913,26,10,3,7,14,-3
6897,26,66,19551,18,12,6,6,0,3
6921,8,65,21400,84,70,35,35,48,23
6938,17,62,27150,75,15,3,12,145,-5
6953,11,88,23028,8,6,3,3,2,-2
6956,5,75,19326,77,58,27,31,14,18
6973,59,64,8764,4,0,0,0,0,-1
7010,5,67,32223,50,21,5,16,45,-4
7027,5,62,38548,29,9,2,7,27,-11
7045,11,80,74527,27,3,1,2,22,-20
7062,2,75,27903,63,23,5,18,30,-11
7079,11,68,70181,2,1,1,0,0,-2
7082,8,72,24780,77,81,30,51,155,3
7102,26,79,8618,72,44,21,23,24,-10
7120,5,65,28900,78,16,6,10,80,-2
7142,41,79,9680,10,9,1,8,6,-2
7160,53,65,8752,35,6,2,4,24,-8
7177,50,71,8602,77,28,14,14,40,-1
7194,29,84,10852,4,0,0,0,0,0
7216,20,64,32210,11,5,0,5,6,1
7220,26,66,32210,65,9,2,7,50,-1
7238,38,69,8542,69,14,2,12,84,13
7259,50,66,8787,61,8,2,6,18,-8
7293,47,83,8538,82,67,9,58,46,-1
7310,56,68,8763,2,1,0,1,0,2
7327,53,84,1028,63,25,8,17,38,8
7342,32,78,10191,56,6,1,5,159,4
7345,41,78,10191,57,2,0,2,141,-6
7365,14,84,8547,48,40,18,22,40,-5
7382,26,81,5513,68,21,9,12,80,-33
7400,41,65,8761,82,45,21,24,106,-14
7417,35,62,32218,62,13,7,6,51,-20
7438,5,84,26416,66,29,6,23,39,9
7455,59,63,10432,20,1,0,1,20,-3
7472,23,70,24086,80,7,0,7,131,21
7475,32,80,12446,4,2,2,0,2,2
7492,26,89,10600,3,0,0,0,2,-2
7509,71,74,11663,51,8,4,4,128,-1
7526,38,69,8605,66,16,4,12,34,-7
7563,65,76,10450,79,45,24,21,46,-15
7580,32,85,130734,82,71,15,56,18,9
7595,59,73,8894,82,37,4,33,48,4
7598,68,69,8894,48,32,4,28,24,2
7615,83,64,9200,62,25,9,16,58,3
7633,86,88,10460,44,12,3,9,9,-9
7652,86,76,7613,82,26,6,20,42,18
7669,68,75,11042,26,1,1,0,67,1
7686,56,63,11105,72,42,17,25,136,17
7703,41,88,9098,31,5,1,4,16,0
7718,53,83,8599,58,16,10,6,14,-12
7721,59,66,8599,18,6,1,5,6,2
7738,68,78,10440,48,36,18,18,40,0
7755,71,1479,9336,55,24,9,15,64,8
5853,29,73,31453,24,5,0,5,28,-2
7811,56,1479,8522,81,91,25,66,121,5
7843,11,78,72196,30,5,2,3,56,-4
7846,50,69,9100,77,25,7,18,26,16
7863,5,88,192,28,9,1,8,12,4
7883,50,84,9011,48,16,6,10,40,1
7900,62,79,10152,42,30,11,19,24,7
7917,80,78,3633,82,34,23,11,32,-7
7934,68,65,4202,47,23,9,14,25,16
7954,11,62,21304,75,82,28,54,95,35
7969,68,77,12266,7,2,2,0,12,1
7972,74,84,12266,3,1,0,1,7,1
7989,86,68,9363,10,4,1,3,2,-6
8006,56,63,8786,70,60,36,24,16,23
8023,17,76,73805,6,0,0,0,14,-1
8040,62,1479,8537,82,98,50,48,104,9
8057,62,89,3680,77,65,18,47,40,24
8074,77,62,8697,64,32,15,17,24,1
8093,65,66,11446,48,7,3,4,6,-4
8110,65,74,9296,79,36,16,20,34,12
8127,77,83,9341,51,17,6,11,12,-10
8144,41,74,8696,56,18,3,15,53,-5
8162,65,83,9251,70,28,7,21,6,2
8179,71,77,12401,19,4,0,4,16,-3
8196,62,73,8766,27,12,5,7,10,2
8211,20,83,32220,73,11,1,10,93,-14
8214,26,85,32220,69,11,1,10,36,-1
8232,71,80,11418,76,16,6,10,30,0
8253,17,77,21492,55,13,5,8,62,-3
8270,68,65,8789,47,48,23,25,27,28
8287,26,1479,8528,72,8,1,7,142,-5
8305,11,83,19215,12,1,0,1,6,0
8322,47,88,9654,1,1,0,1,0,0
8340,41,84,8968,70,11,5,6,137,-2
8360,65,75,23512,17,3,1,2,10,3
8383,32,64,8859,82,118,54,64,30,45
8400,2,89,32134,7,0,0,0,2,-1
8419,8,86,72864,43,7,1,6,126,-25
8442,17,63,5672,82,53,24,29,34,-5
8462,53,70,9144,8,2,0,2,39,1
8479,8,71,21476,83,45,15,30,210,-28
8486,23,75,21476,81,34,4,30,122,22
8503,5,76,31756,15,8,3,5,0,6
8522,5,65,8963,58,15,5,10,168,-4
8540,59,86,14497,23,6,1,5,54,6
8557,77,75,11771,1,0,0,0,2,-1
8574,5,62,39864,10,3,2,1,25,-2
8592,11,78,24084,14,1,0,1,4,-3
8609,14,72,8590,11,0,0,0,0,-1
8612,20,88,8590,30,6,3,3,25,-13
8647,8,79,72028,56,13,8,5,14,-1
8664,29,86,54517,69,24,12,12,61,-3
8681,17,74,25150,78,32,17,15,38,9
8698,59,81,11423,52,7,5,2,18,-15
8716,71,66,14331,12,0,0,0,4,-2
8731,77,71,11422,82,25,10,15,10,-21
8734,83,82,11422,20,4,1,3,0,0
8753,71,65,14960,3,0,0,0,0,-1
8771,71,1479,13392,78,18,5,13,39,21
8788,8,86,60924,66,27,12,15,253,-26
8808,17,1479,42967,14,12,7,5,18,2
8825,80,68,117437,47,10,6,4,8,-5
8848,2,85,32239,64,13,0,13,81,7
8867,8,86,73606,30,8,6,2,6,-21
8870,77,71,15033,29,1,1,0,24,-6
8887,71,74,12577,21,2,0,2,20,-5
8921,56,64,12458,11,4,3,1,6,-4
8938,86,80,14380,5,0,0,0,0,0
8955,74,78,11473,54,9,4,5,44,16
8972,8,83,26591,19,1,1,0,34,5
8989,65,79,12508,24,2,0,2,16,-4
8992,71,547,12508,55,6,3,3,21,-6
9009,38,75,32013,75,19,6,13,72,-14
9026,8,72,39240,45,21,10,11,41,-1
9044,71,78,11464,81,45,10,35,38,1
9061,77,71,12059,16,14,8,6,34,6
9078,62,77,9318,75,40,21,19,35,15
9095,86,75,15030,56,31,15,16,17,16
9112,86,71,10423,25,10,5,5,10,-3
9115,17,1479,67314,4,0,0,0,4,0
9132,65,71,11703,3,1,0,1,2,0
9154,14,79,14179,39,3,2,1,63,-7
9191,74,547,15031,49,2,1,1,86,-3
9210,11,80,10951,66,43,17,26,48,-40
9227,23,80,30948,69,9,2,7,50,8
9246,17,76,25739,73,8,5,3,50,-22
9249,11,67,29311,77,56,21,35,24,4
9268,77,547,15043,26,2,2,0,4,-3
9287,8,78,14033,33,4,1,3,98,-13
9304,26,64,3640,41,8,2,6,24,-3
9321,23,75,360,69,8,2,6,38,-6
9338,11,88,21355,18,10,4,6,55,-3
9355,83,84,9334,61,26,11,15,8,8
9370,59,73,12459,28,3,0,3,0,3
9373,68,73,12459,47,13,9,4,18,-10
9390,74,88,12535,81,26,13,13,21,-3
9407,86,78,11119,57,46,23,23,46,3
9424,68,75,5367,48,9,1,8,21,4
9460,65,82,11100,38,6,2,4,25,-4
9477,80,1479,12182,1,0,0,0,0,-1
9492,86,73,10613,62,8,2,6,18,7
9495,74,66,14733,49,10,2,8,27,1
9512,56,65,9321,80,70,25,45,42,-2
9529,47,84,8544,45,18,8,10,71,-8
9546,77,78,12516,40,3,2,1,52,2
9565,35,74,21311,41,23,7,16,32,-1
9582,86,81,11453,82,46,9,37,34,38
9599,62,75,12461,37,24,14,10,39,-1
9614,74,62,4288,52,27,10,17,14,4
9617,83,62,4288,82,45,14,31,78,-21
9634,83,77,9277,82,85,20,65,50,10
9651,74,69,11592,4,1,0,1,2,-3
7794,86,76,9355,73,23,8,15,44,6
9707,65,74,4564,64,38,14,24,24,21
9739,17,79,27823,13,11,6,5,4,4
9742,26,76,27823,33,6,1,5,13,-5
9759,2,83,39867,7,4,2,2,2,-1
9776,56,88,12515,82,23,9,14,73,-8
9793,74,75,5995,77,27,15,12,42,-6
9810,5,89,27133,78,52,14,38,49,20
9827,2,88,47097,66,20,8,12,259,9
9847,23,76,24266,9,4,1,3,2,-2
9862,71,86,12151,75,34,5,29,30,14
9865,77,70,12151,62,23,7,16,72,16
9885,41,70,8959,76,44,14,30,46,-21
9902,29,63,8661,77,45,19,26,4,-6
9919,11,67,21326,66,79,32,47,22,8
9936,74,86,14644,4,0,0,0,11,-1
9960,5,74,68521,43,9,2,7,78,-15
9978,59,80,14487,15,3,2,1,14,1
9996,11,86,54460,49,7,1,6,63,-5
10017,71,89,14818,62,9,4,5,28,-9
10039,50,75,5683,80,31,11,20,40,6
10064,23,67,8777,26,9,4,5,20,6
10082,14,76,22426,12,8,3,5,14,3
10099,11,79,22345,84,70,38,32,41,9
10117,29,75,16735,2,0,0,0,0,0
10133,8,65,3589,19,17,7,10,18,-3
10136,17,65,3589,70,51,22,29,86,-3
10153,26,68,67412,51,7,0,7,16,4
10172,68,86,3666,48,40,7,33,26,6
10190,56,62,2675,19,15,8,7,18,-7
10207,50,78,9091,82,29,6,23,69,-10
10224,29,81,8561,54,18,7,11,73,-27
10248,59,65,8744,7,1,0,1,12,4
10263,62,86,3667,82,73,37,36,16,-3
10283,26,80,4716,60,30,15,15,37,18
10303,32,68,8722,14,1,0,1,14,-10
10329,50,85,4372,71,40,20,20,24,6
10348,8,65,26355,22,4,1,3,25,0
10365,56,70,8956,18,15,5,10,49,-4
10382,47,89,8781,77,33,16,17,72,-7
10398,41,83,38463,9,4,0,4,2,4
10401,32,72,10897,1,0,0,0,0,1
10422,32,86,2676,12,13,7,6,0,1
10439,5,62,31970,18,5,0,5,31,0
10456,20,75,73611,13,0,0,0,5,0
10473,32,70,28803,60,9,6,3,45,-1
10492,8,84,8676,84,71,38,33,96,20
10511,29,81,12290,8,2,1,1,0,-1
10526,35,80,8982,1,0,0,0,2,0
10529,47,86,8982,39,11,2,9,16,4
10565,41,65,2658,60,13,2,11,40,-15
10586,47,88,9118,81,40,14,26,38,16
10603,47,67,8807,40,7,2,5,47,-2
10623,41,62,8880,13,5,3,2,25,1
10643,26,65,64763,53,9,5,4,145,2
10660,11,89,13521,47,16,7,9,27,3
10663,17,88,13521,31,17,6,11,10,5
10686,35,85,1935,8,1,0,1,8,1
10703,26,67,26127,72,14,3,11,44,-9
10721,68,89,8758,47,14,3,11,48,-5
10738,59,1479,5666,14,2,0,2,8,-7
10755,41,80,8885,80,46,19,27,49,22
10772,53,78,8996,82,65,16,49,50,-10
10787,29,74,8726,82,50,26,24,18,-17
10790,35,71,8726,12,4,2,2,0,-1
10808,14,62,8947,46,50,21,29,33,11
10848,41,83,9672,65,48,19,29,110,4
10867,59,65,8558,68,38,7,31,18,18
10884,20,81,31350,13,5,0,5,16,0
10902,8,78,66114,32,10,3,7,63,-5
10918,53,64,10404,79,22,11,11,47,1
10921,29,78,5519,11,6,2,4,2,2
10957,50,67,2682,79,29,2,27,32,17
10974,26,63,2669,11,3,1,2,2,-1
10991,35,72,25607,21,2,0,2,25,-3
11008,5,72,67384,9,2,0,2,13,-2
11025,71,89,17778,13,1,0,1,4,-4
11042,38,79,8706,22,4,1,3,36,-16
11057,35,81,8630,26,6,1,5,8,-6
11060,2,78,21364,61,115,25,90,29,15
11080,41,68,10842,3,1,1,0,0,-1
11098,38,70,8934,3,0,0,0,6,0
11132,11,86,11225,26,4,2,2,4,-3
11153,41,74,9626,12,4,1,3,4,-9
11177,38,73,8881,11,1,1,0,0,-1
11197,59,85,7411,42,7,4,3,6,-10
11200,65,67,7411,71,25,8,17,16,-2
11217,23,70,8904,79,46,11,35,51,17
11236,26,63,13509,4,0,0,0,2,-1
11253,14,79,27580,36,2,2,0,82,0
11275,56,82,11863,8,4,4,0,0,3
11295,68,77,11397,47,11,3,8,34,3
11312,26,62,516465,13,2,1,1,10,-2
11327,71,74,516465,19,8,1,7,4,1
11330,65,84,11253,63,33,16,17,8,8
11353,71,76,14009,77,38,8,30,26,-8
11370,59,73,9322,35,15,8,7,7,-2
11387,32,74,8846,38,7,2,5,16,-6
11421,83,20120,13937,30,14,2,12,15,8
11438,62,72,6011,58,22,8,14,14,3
11453,86,84,12111,23,4,1,3,8,3
11456,32,69,8780,4,1,1,0,4,0
11475,17,77,8844,82,23,6,17,89,16
11492,80,71,11095,82,51,20,31,16,3
11512,68,67,11662,47,31,10,21,16,-14
11529,65,62,9016,81,12,4,8,57,-15
11549,77,65,15232,11,0,0,0,6,-4
11566,83,73,12669,75,53,14,39,24,24
11581,77,89,17496,8,2,0,2,2,4
11584,62,80,15526,8,2,0,2,4,0
11601,71,67,13786,12,1,1,0,4,0
11618,68,76,17533,48,10,3,7,28,-8
9688,53,63,11336,58,7,4,3,74,-1
11682,68,65,11460,10,4,1,3,0,0
11724,77,83,19226,6,1,0,1,2,0
11727,68,72,19038,42,16,11,5,16,-3
11744,68,69,20723,20,5,4,1,8,4
11764,14,74,26348,37,4,1,3,19,-2
11781,77,66,12562,36,1,1,0,12,-5
11798,68,76,6914,20,5,2,3,6,-2
11815,71,88,23810,62,29,12,17,10,21
11832,68,547,18596,38,5,2,3,31,-5
11847,71,72,11864,48,12,4,8,12,2
11850,71,80,18238,20,2,0,2,4,-3
11859,5,76,67477,39,1,0,1,39,5
11860,8,76,67477,27,6,1,5,32,9
11861,11,76,67477,65,13,2,11,76,21
11862,14,76,67477,41,12,1,11,53,3
11863,17,76,67477,19,7,1,6,21,-13
11864,20,76,67477,17,4,0,4,12,3
11866,26,63,67477,3,0,0,0,6,-3
11867,62,82,17023,42,20,11,9,12,3
11868,65,82,17023,13,3,0,3,16,-5
11879,68,75,15530,3,0,0,0,0,0
11880,74,75,15530,17,0,0,0,6,0
11881,77,75,15530,38,7,1,6,49,-8
11882,80,75,15530,24,6,1,5,4,1
11883,80,70,15530,12,3,0,3,6,-2
11884,83,70,15530,73,13,1,12,50,6
11885,86,69,15530,80,7,1,6,41,-11
11886,65,71,19045,2,1,0,1,0,0
11887,62,82,11823,4,2,0,2,0,-3
11888,65,82,11823,8,2,1,1,6,-3
11889,74,66,40211,10,2,0,2,0,-5
11890,65,80,19222,2,0,0,0,2,-1
11891,68,80,19222,6,0,0,0,18,1
11893,74,80,19222,63,11,1,10,107,15
11894,77,80,19222,63,2,1,1,107,-4
11895,80,80,19222,70,3,1,2,154,-3
11896,83,80,19222,52,11,3,8,64,-6
11897,86,80,19222,53,5,1,4,89,-12
11898,77,68,14954,7,0,0,0,4,-2
11899,11,62,1815,8,3,1,2,0,0
11900,14,62,1815,10,3,1,2,6,-1
11901,17,62,1815,5,0,0,0,2,-1
11902,68,62,30456,11,3,1,2,4,-3
11903,71,62,30456,8,2,0,2,2,1
11904,74,62,30456,4,0,0,0,0,-3
11905,62,64,15560,18,9,2,7,18,-2
11906,65,64,15560,24,7,4,3,15,0
11907,68,64,15560,32,6,4,2,6,-5
11908,74,71,31296,1,0,0,0,5,0
11910,62,70,6003,6,2,0,2,0,1
11911,65,70,6003,55,11,3,8,16,11
11912,68,70,6003,32,5,2,3,18,-10
11913,71,71,6003,30,12,3,9,8,-4
11914,80,84,6003,26,6,1,5,4,-8
11915,59,76,64330,5,2,0,2,26,-1
11916,62,76,64330,68,14,5,9,147,-13
11917,65,76,64330,80,14,7,7,121,-17
11918,68,76,64330,48,11,4,7,63,-2
11919,71,76,64330,79,14,8,6,90,-11
11920,74,76,64330,78,14,8,6,114,-4
11921,77,76,64330,80,19,10,9,119,2
11922,80,83,64330,82,9,5,4,123,0
11923,83,83,64330,50,12,3,9,50,0
11924,86,76,64330,67,14,6,8,53,5
11925,20,1479,20396,22,1,0,1,8,-5
11927,20,80,39482,6,1,0,1,7,-3
11928,65,82,19166,27,14,7,7,14,1
11929,68,82,19166,35,18,9,9,4,9
11930,71,82,19166,79,40,21,19,18,-4
11931,74,82,19166,78,40,22,18,22,-2
11932,77,82,19166,81,53,27,26,22,-8
11933,80,82,19166,82,62,35,27,22,13
11934,83,82,19166,65,46,24,22,14,19
11935,86,82,19166,80,69,41,28,20,3
11936,62,69,11608,53,12,4,8,2,-1
11937,65,69,11608,70,23,3,20,6,-4
11938,68,69,11608,39,15,5,10,4,1
11939,71,69,11608,67,26,5,21,16,15
11940,74,69,11608,66,25,9,16,6,3
11941,77,69,11608,77,29,11,18,14,11
11942,80,69,11608,76,38,10,28,20,33
11944,86,69,11608,82,43,14,29,20,-1
11945,68,81,19140,2,0,0,0,0,-2
11946,71,81,19140,49,10,5,5,28,10
11947,74,81,19140,52,7,1,6,16,-4
11948,77,75,19140,30,10,2,8,6,0
11949,80,75,19140,26,4,0,4,10,1
11950,80,64,19140,34,9,2,7,4,-6
11951,83,64,19140,46,13,3,10,31,6
11952,86,64,19140,12,1,1,0,4,-6
11953,62,71,11365,12,5,3,2,4,-3
11954,65,71,11365,17,5,2,3,6,1
11955,68,71,11365,23,3,1,2,6,-8
11956,32,82,1918,79,32,13,19,22,-9
11957,35,82,1918,75,31,13,18,6,-14
11958,38,82,1918,79,46,20,26,16,12
11959,41,82,1918,82,53,22,31,40,-26
11961,50,82,1918,82,64,16,48,60,6
11962,53,82,1918,66,26,7,19,34,-8
11963,74,81,19228,16,0,0,0,15,0
11964,77,81,19228,4,0,0,0,4,0
11965,80,81,19228,34,4,0,4,39,-1
11966,83,85,19228,31,4,1,3,68,-1
11967,86,85,19228,34,2,0,2,23,-5
11968,62,65,15062,6,1,1,0,0,1
11969,65,65,15062,13,2,2,0,0,-5
11970,68,65,15062,1,1,1,0,0,1
11971,71,65,15062,75,26,14,12,2,3
11972,74,65,15062,61,9,5,4,2,-1
11973,74,86,15062,19,5,2,3,0,3
11974,77,86,15062,6,0,0,0,0,-1
11664,77,547,19044,2,0,0,0,0,0
11975,77,83,15062,16,6,2,4,0,3
11976,80,64,15062,4,0,0,0,0,-2
11977,80,83,15062,36,4,2,2,4,-5
11978,26,62,58057,2,0,0,0,0,-3
11979,29,62,58057,1,0,0,0,0,0
11980,62,64,15708,39,6,0,6,10,-3
12112,71,71,40077,10,1,1,0,0,-2
12147,83,75,19740,77,15,4,11,34,-2
12165,20,79,8830,57,36,6,30,28,3
12185,29,76,53468,2,1,0,1,0,1
12206,74,70,12121,80,25,13,12,148,-20
12221,23,80,10234,73,16,3,13,62,8
12224,32,80,10234,74,22,6,16,72,7
12241,8,81,38187,84,43,15,28,74,-25
12258,17,72,27546,61,15,6,9,107,-10
12275,23,80,74517,3,0,0,0,4,0
12296,83,81,12074,81,50,21,29,24,3
12313,29,65,54519,43,9,2,7,60,6
12330,14,62,68872,6,1,0,1,11,-2
12345,8,79,350,22,1,0,1,14,-2
12348,11,88,69970,31,2,0,2,77,4
12365,29,77,8997,55,59,27,32,83,11
12382,29,79,25640,30,13,4,9,10,-2
12416,14,85,8738,1,1,0,1,2,1
12434,20,64,2577,65,86,28,58,73,31
12452,14,70,8966,14,2,0,2,14,-7
12470,17,81,27224,8,1,0,1,0,0
12473,23,75,27224,34,10,4,6,8,-1
12490,41,63,8984,78,25,15,10,67,-5
12507,47,69,8919,82,79,34,45,50,14
12524,35,82,9662,77,24,13,11,100,-40
12541,41,70,9082,70,24,8,16,64,15
12558,26,74,8666,14,7,3,4,12,-6
12575,11,79,67254,71,11,4,7,27,-3
12590,56,74,67254,82,46,24,22,57,-10
12593,11,63,8573,81,31,18,13,48,-1
12610,5,71,8691,2,0,0,0,0,-3
12631,5,65,8967,5,2,0,2,0,-2
12648,56,80,8967,44,7,3,4,16,2
12686,11,76,12625,5,0,0,0,0,-6
12705,35,71,5671,73,10,5,5,108,10
12721,11,62,20595,63,23,2,21,110,5
12724,17,81,20595,45,11,4,7,108,-10
12743,53,68,9124,65,13,3,10,38,21
12760,41,1479,92447,36,16,5,11,24,-7
12777,23,1479,11559,10,2,0,2,10,1
12794,26,76,3729,22,5,2,3,8,0
12813,8,63,8644,13,4,1,3,4,-3
12830,20,75,15728,5,0,0,0,4,0
12845,8,86,25746,13,2,1,1,71,-5
12848,20,86,25746,44,5,3,2,193,-3
12865,35,75,8906,82,56,27,29,40,-3
12883,29,63,26138,11,1,0,1,13,-4
12900,41,63,25717,37,4,3,1,28,0
12917,47,64,9014,21,15,6,9,14,5
12954,23,88,26871,34,8,5,3,32,2
12973,14,1479,25726,26,6,1,5,91,0
12976,23,1479,25726,78,12,1,11,217,-3
12993,32,80,27226,15,6,1,5,14,4
13013,35,63,4320,54,14,8,6,42,9
13030,20,67,8690,80,35,7,28,95,10
13051,35,1479,10829,5,0,0,0,9,-1
13073,17,70,25833,3,0,0,0,0,-1
13093,26,68,27311,75,27,12,15,92,-1
13109,86,73,45534,80,64,14,50,42,7
13112,17,63,1427,33,11,5,6,10,-11
13129,41,70,12672,7,0,0,0,2,-1
13146,23,83,18646,72,12,0,12,78,-13
13163,38,63,8533,70,16,1,15,76,8
13181,35,81,25643,23,3,1,2,4,-4
13198,29,80,3568,10,3,0,3,4,1
13232,26,75,69904,10,0,0,0,52,1
13235,17,79,74679,35,2,0,2,38,-5
13241,14,84,12648,3,1,0,1,4,3
13242,14,81,12648,15,3,2,1,4,5
13243,17,81,12648,7,3,1,2,6,5
13244,20,1479,12648,6,0,0,0,2,-5
13245,17,83,15427,1,1,0,1,2,1
13246,20,83,15427,22,2,0,2,2,-5
13247,26,70,15427,1,0,0,0,0,0
13362,14,89,8839,3,1,0,1,2,3
13365,20,81,8839,59,8,1,7,108,2
13382,62,1479,31236,47,13,4,9,4,-6
13399,26,73,69975,2,1,0,1,14,0
13417,20,62,218,3,0,0,0,0,-1
13434,86,86,16031,80,37,14,23,10,10
13451,68,89,882,34,22,6,16,4,3
13483,68,79,30918,33,7,2,5,20,9
13486,74,1479,30918,16,6,1,5,22,2
13503,86,78,14368,82,77,28,49,12,22
13522,80,62,32992,81,24,12,12,46,-6
13539,41,70,6808,28,0,0,0,7,-1
13556,77,81,6002,78,47,10,37,46,21
13575,68,547,14651,48,33,17,16,80,-3
13592,86,78,14737,72,54,17,37,40,3
13607,71,83,14720,78,50,20,30,67,-11
13610,80,83,14720,82,61,32,29,95,-7
13627,68,71,6009,42,16,9,7,14,-1
13644,71,76,23809,51,16,3,13,30,-7
13661,65,68,11862,58,28,4,24,36,-5
13678,62,65,38082,46,7,4,3,4,-3
13698,74,74,38007,80,46,21,25,88,24
13715,71,74,30916,74,15,4,11,25,7
13734,26,80,2655,50,12,1,11,40,18
13751,71,73,24646,7,0,0,0,6,-2
13768,2,63,9660,45,8,2,6,89,2
13787,71,72,37545,60,29,7,22,22,-3
13804,77,64,15128,78,49,13,36,31,-16
13822,23,1479,67303,1,0,0,0,2,0
13839,74,83,11842,76,17,11,6,49,-8
13855,2,89,53140,9,1,1,0,0,-8
13858,74,62,31272,11,3,1,2,0,-5
13876,68,73,8371,1,0,0,0,0,-1
13893,8,67,22716,33,10,2,8,20,4
13903,80,1479,16047,71,24,3,21,30,3
13904,83,1479,16047,15,4,1,3,8,-6
13905,83,72,16047,57,28,3,25,32,-1
12093,80,82,22625,15,3,0,3,14,4
13908,26,89,8911,22,0,0,0,8,-8
13987,65,82,32892,31,10,2,8,16,0
14004,77,89,14427,43,7,3,4,50,0
14027,86,87,38048,50,8,1,7,22,-2
14044,38,67,42530,41,0,0,0,92,-5
14061,17,81,76452,21,0,0,0,13,-7
14078,68,73,28437,34,16,11,5,4,6
14097,71,89,31614,9,3,0,3,5,0
14112,71,62,23003,1,0,0,0,7,-1
14115,77,69,16032,76,34,14,20,24,21
14132,65,86,5366,81,48,9,39,57,10
14149,8,77,8867,84,123,53,70,95,1
14166,53,79,8867,19,8,2,6,12,-2
14186,20,81,43340,72,9,4,5,95,6
14203,83,76,19067,82,62,40,22,44,-25
14220,74,67,15482,28,5,3,2,10,-14
14235,35,76,8603,70,37,11,26,78,7
14255,38,76,8692,81,65,26,39,32,-12
14272,14,83,3721,5,0,0,0,0,-3
14290,20,79,8683,57,18,2,16,84,24
14307,83,67,23801,69,8,4,4,69,-13
14324,56,68,8890,63,49,17,32,37,1
14344,26,62,32130,36,14,5,9,30,1
14362,23,71,39295,17,4,2,2,2,-1
14365,32,63,39295,7,0,0,0,4,-3
14382,62,80,8673,67,27,7,20,20,-15
14399,23,65,18721,58,23,10,13,33,-1
14416,35,71,8878,74,18,5,13,103,14
14433,29,79,8680,71,59,20,39,26,24
14452,17,86,1860,1,0,0,0,2,-1
14469,8,62,10850,80,88,40,48,54,25
14485,29,63,4392,5,1,0,1,0,-1
14488,20,81,3726,64,17,4,13,44,-21
14523,17,64,729659,8,2,1,1,2,1
14540,20,62,27965,27,10,2,8,2,0
14557,11,70,1559,8,5,2,3,4,1
14577,26,67,8909,82,56,27,29,81,7
14594,38,72,8693,52,19,11,8,16,-2
14609,38,85,8969,73,22,13,9,138,10
14612,50,62,8969,32,0,0,0,58,-3
14632,26,88,118228,78,7,2,5,36,-10
14649,32,75,10632,19,5,2,3,10,-8
14666,38,69,42956,78,42,16,26,18,1
14683,86,69,37773,18,0,0,0,4,-8
14700,11,78,1633,55,25,15,10,20,-6
14717,56,85,8949,78,11,5,6,28,-9
14733,8,71,54627,28,7,2,5,28,-4
14739,14,75,8716,5,1,0,1,5,2
14756,62,82,8716,14,1,1,0,23,-7
14795,23,62,9681,26,5,2,3,24,-5
14812,29,68,1903,82,49,9,40,64,23
14829,32,77,8926,82,8,2,6,131,23
14846,23,81,22794,26,20,9,11,36,-7
14861,26,79,9069,18,4,2,2,34,-10
14864,32,81,9069,29,8,4,4,97,-3
14883,23,66,69075,4,0,0,0,0,-2
14900,38,70,2683,80,48,31,17,20,39
14917,14,81,67416,15,2,2,0,81,-2
14934,38,77,729593,43,8,2,6,32,5
14951,86,80,23102,3,0,0,0,0,-2
14968,29,81,41351,5,0,0,0,2,-1
14983,47,65,5531,33,6,1,5,38,-13
14986,56,62,5531,81,34,10,24,46,-8
15007,32,74,8772,3,0,0,0,0,0
15025,38,79,9083,7,1,0,1,0,-6
15059,32,79,972,16,0,0,0,7,-1
15076,14,75,73616,9,0,0,0,34,-2
15093,11,62,8931,73,84,41,43,145,37
15108,11,78,597473,1,0,0,0,0,0
15111,17,74,597473,28,3,1,2,53,-5
15128,5,79,31456,73,24,2,22,87,19
15145,14,76,42473,1,0,0,0,0,-1
15167,17,64,8791,71,27,13,14,30,15
15184,41,82,13400,8,1,0,1,6,-4
15201,23,88,21331,57,40,16,24,66,5
15218,41,81,3662,81,66,32,34,52,23
15233,32,73,3663,81,41,13,28,38,1
15236,41,73,3663,82,47,18,29,46,9
15253,41,86,3665,77,39,9,30,34,9
15270,29,88,2710,63,17,9,8,80,-12
15287,65,84,5524,78,18,7,11,14,-11
15324,41,77,729598,34,5,1,4,19,13
15341,29,64,8773,76,51,17,34,22,6
15356,77,64,8773,52,22,4,18,24,3
15359,38,77,8704,28,8,4,4,8,2
15376,29,62,8908,57,12,5,7,46,-2
15393,32,76,9080,14,1,0,1,12,2
15410,68,88,8825,11,5,0,5,2,2
15427,41,89,9108,19,10,5,5,6,2
15444,32,83,564,82,49,23,26,14,1
15461,74,72,9045,58,34,7,27,23,-10
15477,41,83,8655,62,31,13,18,62,7
15480,53,83,8655,72,56,26,30,92,10
15500,53,67,4339,44,2,1,1,100,-4
15520,35,78,8829,48,10,2,8,18,10
15537,50,74,9081,82,13,9,4,24,-4
15560,35,72,48706,15,9,2,7,8,-3
15595,26,71,18434,2,2,2,0,2,1
15614,35,83,8735,3,0,0,0,0,1
15617,41,88,8735,17,7,4,3,2,-7
15635,53,63,10981,19,0,0,0,2,-2
15653,80,73,8709,46,25,4,21,14,-5
15671,50,84,8713,6,0,0,0,16,-1
15692,41,76,31543,40,24,9,15,2,3
15709,38,71,8742,3,0,0,0,0,-1
15726,35,66,8729,81,40,16,24,35,-10
15741,74,85,8729,11,6,3,3,0,-2
15744,41,81,8631,71,16,6,10,12,-4
15761,65,1479,8525,82,22,8,14,48,-14
15778,20,85,32724,70,13,4,9,58,8
15795,77,67,9044,79,33,12,21,12,-5
13907,17,89,8911,3,1,1,0,0,-1
15849,38,66,8609,57,20,10,10,33,-19
15867,74,69,38210,63,7,2,5,32,-1
15884,29,75,67486,12,1,1,0,4,2
15901,32,80,12236,17,5,3,2,6,-1
15919,65,68,10997,41,5,2,3,91,2
15936,47,63,11726,2,0,0,0,7,1
15953,35,77,9090,50,19,4,15,109,0
15970,47,71,1627,31,19,5,14,24,3
15985,26,63,22093,60,20,5,15,66,-5
15988,35,74,22093,17,1,1,0,12,3
16005,59,80,33243,2,0,0,0,0,-1
16022,26,68,67312,51,6,0,6,58,-4
16041,74,79,8873,82,10,1,9,17,9
16058,23,65,50167,41,2,1,1,79,3
16075,47,85,366708,71,45,23,22,42,27
16092,41,76,5211,77,51,25,26,16,23
16107,53,71,8923,13,0,0,0,5,-1
16127,29,1479,8551,71,57,19,38,16,9
16145,32,89,51742,69,14,7,7,48,4
16162,2,89,29147,28,5,1,4,81,6
16179,47,86,9035,81,24,6,18,58,7
16197,8,79,1446,63,9,3,6,106,25
16215,29,77,1444,49,3,1,2,58,8
16230,80,80,8946,53,4,1,3,63,-11
16233,59,83,223,60,9,2,7,20,-7
16250,17,1479,67186,31,14,2,12,39,7
16269,41,67,8677,62,26,15,11,41,-1
16288,8,88,97460,39,52,25,27,57,12
16305,86,84,39615,55,12,2,10,18,3
16322,71,85,8611,45,37,17,20,6,1
16342,47,64,5527,82,14,3,11,65,-7
16357,77,74,10707,68,28,13,15,43,12
16360,86,20120,10707,35,12,4,8,24,3
16394,86,74,23114,16,2,1,1,0,-5
16411,47,70,8591,43,7,4,3,22,-3
16429,68,70,8917,1,0,0,0,0,0
16446,77,77,23320,4,0,0,0,0,1
16463,29,67,7302,1,0,0,0,0,-1
16478,77,89,34789,82,77,20,57,32,27
16481,86,89,34789,76,72,21,51,50,7
16498,2,67,68621,11,2,0,2,8,-5
16515,50,85,10999,5,0,0,0,2,0
16532,74,68,32790,33,3,0,3,34,-4
16549,77,79,46992,33,12,6,6,10,-1
16567,83,78,24783,80,66,33,33,17,15
16584,71,68,31285,16,6,4,2,10,0
16599,35,73,9137,58,8,3,5,24,-12
16602,47,73,9137,69,4,3,1,44,-2
16619,86,68,33939,33,10,2,8,4,-2
16653,62,66,23669,82,63,31,32,46,3
16671,80,547,22925,23,2,0,2,6,-6
16688,77,71,14355,82,65,26,39,54,-4
16706,38,84,11482,2,0,0,0,0,1
16722,80,68,37188,5,1,1,0,10,-2
16725,14,75,39298,5,0,0,0,2,-2
16744,74,69,17676,80,37,24,13,28,2
16761,29,74,8872,80,30,10,20,78,-6
16780,23,81,39226,19,5,5,0,2,-2
16797,17,80,10644,50,17,5,12,24,-30
16816,38,78,8534,5,4,1,3,10,-2
16833,29,67,9165,14,8,1,7,15,1
16850,26,68,8532,82,51,18,33,50,-13
16853,35,62,8532,57,20,6,14,49,-15
16870,32,68,8695,51,37,14,23,10,-4
16887,32,72,9062,54,55,21,34,75,23
16921,41,86,9042,47,9,4,5,38,3
16938,14,83,629178,39,9,2,7,16,-8
16955,32,84,10192,61,12,4,8,65,0
16972,23,64,21310,73,43,22,21,125,0
16975,32,64,21310,39,26,13,13,59,-2
16992,20,64,10831,9,3,1,2,23,1
17013,50,75,2668,81,75,22,53,74,-21
17030,38,83,567,4,0,0,0,0,1
17048,50,85,9077,8,4,2,2,6,3
17065,41,66,8740,73,22,10,12,43,6
17083,35,79,8472,21,2,1,1,17,-12
17101,53,80,8566,82,12,5,7,73,-3
17104,14,80,23862,6,0,0,0,0,3
17121,47,72,8701,82,20,10,10,16,2
17138,41,72,8739,53,26,10,16,43,9
17155,38,71,2654,63,28,4,24,66,-7
17169,86,72,75068,27,13,4,9,8,-2
17170,23,72,4317,11,9,5,4,0,3
17171,26,72,4317,76,46,13,33,18,-4
17172,29,72,4317,44,26,5,21,8,8
17221,17,75,9151,42,2,0,2,18,-7
17224,26,78,9151,1,0,0,0,2,-3
17241,38,76,12482,8,3,2,1,4,2
17258,32,71,10651,47,9,4,5,49,-5
17275,32,73,1654,23,4,3,1,2,-7
17293,29,76,8929,75,17,1,16,84,-4
17311,26,72,2656,64,12,5,7,240,4
17328,80,75,45541,10,2,0,2,4,-3
17343,2,83,67696,1,0,0,0,0,0
17346,20,89,17838,1,0,0,0,0,0
17363,53,81,8636,62,57,29,28,39,-7
17383,56,81,1904,42,5,0,5,36,-3
17422,20,68,13519,18,9,3,6,4,2
17439,71,75,26399,5,0,0,0,0,0
17457,32,78,5370,77,21,8,13,117,-3
17472,20,65,9126,71,41,22,19,16,-4
17475,29,65,9126,59,36,23,13,28,-16
17492,35,83,11572,1,0,0,0,0,1
17509,80,62,45485,76,25,15,10,50,-1
17537,32,63,9073,45,5,2,3,26,-12
17555,77,70,21707,76,58,10,48,30,22
17572,47,76,794,82,66,35,31,54,-8
17589,29,68,27646,47,20,10,10,4,-4
17605,38,77,10837,2,0,0,0,2,0
17608,20,84,77879,19,2,0,2,11,-4
17625,35,73,8798,28,9,4,5,18,-13
15829,65,72,8653,33,18,7,11,8,9
17677,23,1479,39759,8,4,2,2,8,0
17717,17,75,8855,3,0,0,0,0,-1
17732,59,64,8855,71,24,10,14,47,-3
17735,77,1479,23658,1,0,0,0,0,0
17754,11,1479,6810,20,9,5,4,10,-3
17772,35,71,8526,82,34,12,22,41,7
17791,35,69,9095,81,69,21,48,18,-4
17808,41,82,13404,50,3,1,2,98,-3
17825,50,76,8784,11,0,0,0,8,0
17843,29,70,19444,8,0,0,0,2,-5
17858,59,75,8719,68,11,2,9,68,-10
17861,65,73,8719,23,5,0,5,8,4
17878,53,70,8771,64,24,10,14,40,-2
17896,41,67,9167,14,9,1,8,4,10
17913,23,78,8592,61,52,22,30,22,11
17932,35,76,8776,82,18,8,10,36,-11
17949,77,64,12377,7,0,0,0,4,-1
17982,53,77,2660,80,44,8,36,50,0
17985,62,77,2660,82,37,6,31,36,11
18002,29,71,729592,52,4,0,4,34,-3
18019,53,84,362141,82,74,29,45,50,6
18037,35,67,8770,82,45,10,35,34,4
18054,53,84,8426,4,2,1,1,0,1
18075,50,62,8754,39,4,0,4,31,-4
18092,47,73,8745,34,6,3,3,79,3
18107,47,79,2672,30,7,3,4,4,-6
18110,41,63,9027,50,14,4,10,35,-1
18131,35,68,9594,8,3,1,2,2,-4
18148,47,84,8563,51,6,2,4,43,3
18168,35,80,8620,72,50,22,28,66,-7
18187,32,81,5523,22,4,2,2,36,0
18204,47,68,8645,16,2,1,1,21,-1
18222,20,68,72872,3,0,0,0,2,1
18240,65,81,9111,13,0,0,0,17,4
18257,74,78,8993,7,0,0,0,2,0
18277,53,79,8718,46,6,2,4,24,-2
18294,50,66,9057,41,14,3,11,30,0
18311,65,80,9105,29,3,1,2,33,0
18317,47,78,9522,2,0,0,0,0,0
18320,56,79,9522,22,6,2,4,27,-2
18321,62,83,9522,8,1,0,1,4,0
18322,47,70,11724,2,0,0,0,0,1
18323,53,81,11724,2,0,0,0,2,-1
18364,62,84,729603,82,94,19,75,40,26
18367,71,84,729603,70,50,11,39,42,3
18370,80,84,729603,82,50,15,35,28,-27
18415,32,74,5867,14,3,0,3,12,1
18435,59,71,4697,43,21,13,8,30,-9
18455,59,80,9009,81,32,15,17,38,-7
18492,65,73,8972,30,2,0,2,61,-1
18507,80,77,33248,63,19,10,9,8,3
18510,71,71,32190,30,5,3,2,21,-2
18527,83,63,38292,68,16,1,15,70,16
18548,41,76,7106,27,5,1,4,6,-1
18565,71,79,24395,41,17,5,12,6,5
18582,47,86,8779,45,16,4,12,26,0
18599,77,69,24916,60,16,5,11,20,3
18616,8,79,1671,78,13,4,9,10,-8
18636,65,73,8606,71,58,19,39,30,12
18639,71,89,8606,53,24,1,23,22,1
18657,50,85,396,63,68,33,35,36,26
18674,47,65,8622,45,34,13,21,16,4
18697,80,80,25497,3,0,0,0,0,-1
18720,26,74,21380,81,43,23,20,64,-10
18737,83,80,49325,79,41,23,18,35,-17
18769,47,76,250613,74,17,1,16,32,-9
18772,56,76,250613,51,10,6,4,28,-16
18789,5,63,54620,5,1,0,1,2,1
18806,74,84,45561,10,1,1,0,0,-7
18823,59,86,2612,79,17,4,13,66,3
18843,59,64,10983,1,0,0,0,0,0
18860,77,79,122839,1,0,0,0,0,0
18877,41,86,12839,2,0,0,0,0,-1
18896,14,83,563,47,47,23,24,14,-5
18899,23,83,563,82,74,33,41,49,-3
18916,41,88,8882,8,1,0,1,4,0
18933,83,88,34860,20,6,4,2,0,-1
18950,2,75,68102,60,26,4,22,52,5
18967,83,80,8004,64,7,1,6,35,-7
18985,2,76,22687,75,53,21,32,49,-8
19002,86,69,107151,71,7,2,5,64,-4
19020,35,63,11804,23,3,1,2,84,3
19037,32,74,3727,21,3,3,0,8,-6
19054,11,62,21395,25,13,4,9,20,-3
19071,20,67,13239,2,0,0,0,2,1
19089,77,77,45562,36,11,6,5,4,5
19106,35,63,32745,81,18,3,15,35,22
19124,20,74,68929,6,0,0,0,18,-1
19139,8,63,54559,14,8,1,7,6,1
19142,17,63,54559,41,16,8,8,14,4
19160,77,88,20722,68,10,3,7,32,-10
19177,74,89,11008,82,34,19,15,30,-4
19195,5,79,72167,44,4,1,3,57,7
19212,56,70,8714,23,10,3,7,77,2
19231,83,69,49519,38,10,2,8,18,-6
19250,20,86,27953,25,4,4,0,8,-5
19265,23,74,3723,1,0,0,0,0,0
19285,83,64,38639,6,3,1,2,0,0
19302,80,66,15743,82,45,16,29,16,-10
19319,83,65,31274,82,35,18,17,14,-10
19339,11,70,21322,61,24,6,18,143,6
19356,80,85,62459,27,7,1,6,6,-8
19374,77,62,37197,11,1,0,1,0,0
19389,83,68,45276,82,69,27,42,32,-2
19392,68,72,10711,37,6,0,6,12,4
19409,74,80,23856,80,46,20,26,20,0
19426,77,77,32895,63,39,11,28,30,8
19443,86,69,19973,82,18,4,14,30,-15
19460,77,84,33604,69,28,15,13,14,-14
19477,80,74,38633,82,56,22,34,21,17
19494,77,65,26431,1,0,0,0,0,0
17660,50,76,8877,82,59,26,33,46,5
19530,74,63,37194,15,1,1,0,4,3
19564,2,71,2698,79,69,27,42,85,22
19581,80,74,32436,7,0,0,0,0,-2
19598,17,80,8663,76,35,16,19,36,-5
19615,11,1479,67389,6,0,0,0,5,0
19631,11,79,21410,51,40,14,26,134,-15
19634,17,63,21410,27,24,16,8,64,7
19654,80,79,4090,19,6,1,5,6,-2
19671,8,76,54065,2,0,0,0,0,0
19688,8,71,5635,9,1,0,1,0,-4
19705,2,89,21677,6,2,1,1,0,-1
19722,14,76,8857,34,27,13,14,10,-12
19739,11,74,22706,13,6,2,4,13,-2
19757,62,71,9221,78,10,0,10,85,-10
19760,71,71,9221,17,2,1,1,16,-6
19783,41,80,8914,55,8,2,6,24,6
19800,32,88,8725,59,29,12,17,12,11
19838,23,71,8553,65,11,7,4,80,-17
19857,41,74,11497,7,1,0,1,4,-2
19877,35,82,14462,2,1,0,1,0,1
19898,53,80,3659,71,82,41,41,76,33
19901,62,86,3659,80,64,26,38,56,8
19918,68,82,3661,12,8,3,5,6,5
19935,62,82,8616,45,10,3,7,26,10
19958,47,73,8760,81,48,25,23,101,8
19975,50,65,10219,15,2,2,0,0,-3
19995,77,66,9033,81,19,5,14,37,-13
20013,47,79,8935,64,9,2,7,124,-3
20032,56,69,8712,21,6,3,3,16,3
20035,41,88,8587,77,48,24,24,24,8
20052,71,72,8657,56,8,0,8,20,3
20070,50,78,9088,19,12,4,8,4,0
20087,59,70,8938,73,36,22,14,153,-14
20121,62,88,4502,73,57,22,35,59,14
20138,68,85,176,48,29,5,24,44,-5
20157,35,69,8593,52,10,4,6,14,0
20160,47,69,8593,79,14,2,12,43,2
20177,50,71,8826,59,9,4,5,86,-10
20194,50,85,9638,26,1,1,0,22,-2
20211,26,86,52373,78,16,7,9,158,-3
20230,50,89,8768,64,32,16,16,22,-13
20247,68,88,8891,48,18,7,11,28,1
20264,23,80,65335,19,0,0,0,45,0
20279,68,77,3473,4,0,0,0,0,-1
20282,11,1479,42664,80,33,8,25,64,0
20299,5,67,21555,20,4,1,3,14,-2
20319,41,63,7601,7,0,0,0,6,-3
20336,41,89,9635,3,0,0,0,0,-1
20353,35,68,29037,4,0,0,0,5,-7
20389,56,67,8962,18,4,1,3,23,-1
20404,32,66,281032,37,5,2,3,21,-11
20407,41,66,281032,57,10,3,7,51,-8
20424,83,20120,39239,45,18,3,15,6,-5
20441,68,76,8588,35,14,3,11,20,12
20463,80,63,37754,81,51,8,43,37,-10
20480,8,72,39476,4,2,0,2,0,-3
20498,38,82,10664,53,17,4,13,34,-9
20515,71,67,33239,79,13,6,7,14,-10
20530,53,69,1793,27,9,2,7,2,-2
20533,2,76,31908,77,56,22,34,57,-10
20550,56,81,10989,32,2,1,1,128,3
20567,53,1479,8531,77,8,3,5,81,-10
20584,65,69,10215,39,6,2,4,14,-1
20601,71,83,8728,6,0,0,0,0,-2
20619,35,73,2705,10,4,2,2,0,0
20651,86,83,41201,82,72,20,52,14,24
20658,47,73,9055,74,13,7,6,163,9
20675,80,1479,34897,66,20,6,14,36,13
20692,74,69,53592,58,16,8,8,23,13
20709,53,69,8799,11,4,1,3,6,-5
20728,80,62,13398,81,16,4,12,85,2
20747,86,74,90407,78,25,8,17,44,-4
20764,80,77,76744,2,0,0,0,0,0
20784,35,1479,8652,73,32,6,26,31,0
20787,50,88,8652,26,4,0,4,10,-10
20804,47,71,8883,75,66,36,30,58,-5
20821,17,81,8823,66,18,9,9,81,-9
20838,26,89,8853,5,0,0,0,0,-3
20855,32,1479,9157,15,12,2,10,10,-2
20872,32,62,8747,23,0,0,0,79,-2
20889,80,64,42446,75,23,10,13,18,-14
20910,35,79,8571,33,10,3,7,18,-1
20927,38,69,11822,57,1,0,1,90,-1
20945,59,67,8803,65,22,12,10,82,-7
20962,26,68,42844,20,2,0,2,31,-4
20979,23,80,6639,60,4,2,2,31,-14
21005,35,76,29039,1,0,0,0,2,0
21022,26,68,8809,48,7,0,7,64,-1
21037,35,68,9030,29,4,1,3,10,-5
21040,41,78,9030,69,11,4,7,8,-2
21057,20,65,30070,1,1,0,1,5,1
21076,41,74,11749,4,1,1,0,0,-1
21093,38,67,9094,74,31,15,16,40,4
21110,32,73,31366,3,1,0,1,0,1
21127,20,72,8694,17,5,2,3,2,-4
21144,74,72,8694,69,34,13,21,12,-20
21161,26,65,8702,14,4,1,3,12,-13
21181,47,84,8737,8,0,0,0,10,1
21199,71,81,9120,19,4,0,4,22,0
21216,56,71,8749,71,9,2,7,60,-4
21233,11,74,32764,79,9,2,7,110,4
21250,47,75,4501,75,39,12,27,116,-11
21267,59,74,8801,77,32,14,18,31,-10
21285,38,66,8815,63,8,1,7,40,-5
21288,47,66,8815,64,10,2,8,46,10
21305,56,89,8762,32,6,1,5,32,-3
21326,38,69,10655,1,0,0,0,0,0
21345,53,83,10313,11,4,2,2,6,-1
21362,38,81,8995,70,15,1,14,46,4
21379,53,64,8598,77,54,29,25,36,8
21396,83,62,88673,71,8,2,6,27,-3
19513,14,76,30697,47,26,11,15,60,-14
21431,86,81,649497,80,17,13,4,80,7
21467,23,65,5365,20,3,0,3,34,1
21485,80,78,45360,7,0,0,0,4,-4
21502,38,64,10212,13,6,1,5,10,-2
21519,56,80,6533,79,74,24,50,24,7
21534,83,88,10427,82,60,10,50,54,23
21537,80,69,85379,5,1,0,1,4,0
21554,71,72,8860,40,4,1,3,29,-2
21571,29,86,10194,57,35,14,21,35,4
21588,83,78,11317,78,54,15,39,22,8
21605,38,81,45134,62,17,10,7,119,0
21624,80,1479,84817,1,0,0,0,0,1
21642,47,89,12794,9,0,0,0,2,-2
21657,38,80,8556,67,8,0,8,130,-1
21662,53,1479,8556,33,3,1,2,30,2
21680,35,76,59424,60,6,2,4,104,0
21698,5,86,22158,44,28,9,19,26,-38
21735,20,79,70554,23,0,0,0,36,-12
21752,38,69,69990,8,8,5,3,6,5
21774,23,83,8892,63,28,10,18,40,-8
21790,68,72,8892,9,5,2,3,4,-4
21793,38,67,8552,58,6,1,5,178,1
21818,26,89,8627,49,17,9,8,50,-6
21835,50,68,8723,72,9,1,8,119,1
21852,26,83,31457,76,59,37,22,12,16
21870,56,85,641981,53,37,14,23,38,18
21887,26,65,68884,20,0,0,0,32,-6
21907,47,71,729606,22,4,1,3,24,-5
21926,2,72,38190,11,7,4,3,6,1
21929,8,85,38190,80,62,34,28,42,19
21947,50,69,16533,76,22,3,19,64,-4
21964,38,85,18900,16,8,2,6,8,6
21985,29,77,2084,12,2,0,2,6,0
22022,74,74,38008,4,0,0,0,4,-1
22040,80,89,38051,60,17,3,14,16,22
22055,41,84,8572,20,2,2,0,95,3
22058,53,66,8572,32,2,1,1,76,4
22075,5,83,55546,64,49,16,33,26,-22
22093,20,83,55384,48,14,2,12,51,8
22112,80,71,16802,82,38,12,26,6,7
22129,50,66,9161,1,0,0,0,0,0
22147,86,84,151880,74,16,9,7,10,-12
22170,68,547,8564,26,2,1,1,19,-3
22185,86,79,199922,82,76,40,36,26,13
22188,86,70,16631,81,25,6,19,24,-4
22206,80,71,117801,41,10,4,6,4,5
22223,77,83,10014,6,2,0,2,4,0
22240,77,84,52442,1,0,0,0,0,0
22257,77,70,117071,1,1,1,0,0,1
22291,83,87,126451,2,0,0,0,2,-1
22306,86,547,82359,13,2,0,2,2,-2
22309,77,69,39028,2,0,0,0,0,0
22326,80,67,88714,41,8,5,3,21,-1
22344,83,66,121918,65,19,3,16,18,-6
22361,77,81,118709,21,10,4,6,4,1
22378,71,62,85065,75,34,22,12,8,-20
22395,74,84,117063,68,25,13,12,16,-8
22412,5,88,22376,77,29,10,19,63,10
22427,74,80,81170,67,15,6,9,14,1
22430,80,62,81170,4,3,1,2,0,2
22447,80,83,128556,21,3,2,1,23,2
22464,35,64,24167,74,15,5,10,26,-5
22481,74,84,22454,30,12,4,8,8,-2
22498,38,82,8710,39,7,0,7,77,-3
22523,41,80,3657,78,55,22,33,71,22
22555,38,1479,8516,79,30,12,18,54,4
22558,50,63,8516,60,13,5,8,36,-8
22575,47,65,2691,15,5,2,3,31,-7
22596,62,83,569,66,5,2,3,14,-5
22613,41,71,8595,71,34,12,22,14,-7
22630,47,62,9013,77,31,20,11,64,-10
22647,65,69,2692,55,44,12,32,28,10
22664,74,77,8816,67,15,9,6,19,-9
22679,77,67,9115,36,5,1,4,10,-11
22682,8,84,40900,53,56,25,31,14,31
22701,2,77,31941,76,37,14,23,131,-9
22721,65,68,8586,57,27,11,16,10,5
22738,59,81,8546,23,1,0,1,21,-4
22755,47,78,9506,26,2,0,2,25,-12
22772,68,1479,9382,21,6,1,5,4,2
22791,47,78,9387,22,5,3,2,6,-1
22810,41,74,8686,25,7,2,5,14,-4
22827,5,72,729552,19,4,0,4,4,7
22848,41,72,2711,2,0,0,0,2,0
22865,80,72,9099,61,31,10,21,21,-9
22886,47,79,10328,5,4,1,3,2,0
22904,74,69,8804,82,54,18,36,8,9
22921,80,66,9515,65,8,5,3,18,-8
22936,47,83,9509,1,0,0,0,0,0
22941,65,74,9509,1,0,0,0,0,-1
22958,65,75,8664,81,52,17,35,56,-15
22975,80,87,96116,4,1,0,1,0,0
22993,62,66,9517,72,10,3,7,72,5
23011,68,63,10226,10,0,0,0,10,0
23030,50,69,8836,75,18,7,11,47,3
23048,56,65,8876,61,44,26,18,41,6
23063,56,73,9516,72,16,4,12,124,-15
23083,71,67,8578,79,33,6,27,38,-27
23100,47,79,8675,53,25,12,13,45,-13
23118,29,63,21422,63,33,19,14,28,-11
23137,65,67,11566,2,0,0,0,0,-3
23160,74,67,8970,33,4,1,3,40,-9
23177,62,84,9671,66,22,6,16,73,32
23192,83,87,33742,5,0,0,0,0,0
23195,41,77,8584,5,0,0,0,2,-4
23214,53,86,9112,15,8,3,5,22,-1
23231,65,72,3630,22,8,2,6,10,0
23248,65,84,9058,44,3,2,1,40,4
23265,62,66,2712,70,52,19,33,24,3
23282,56,89,9508,82,53,23,30,31,-1
23299,56,69,9079,51,3,0,3,87,3
21414,35,62,8483,44,16,4,12,20,6
23335,53,72,967,75,26,6,20,46,27
23373,50,64,8597,66,30,15,15,46,1
23391,50,89,8672,30,9,2,7,24,5
23408,38,71,729444,13,0,0,0,4,-2
23427,71,64,9520,55,33,14,19,30,3
23443,74,64,13537,55,12,3,9,10,-7
23446,35,71,10855,2,0,0,0,2,0
23463,86,86,10013,79,16,12,4,26,-1
23480,80,68,49058,68,21,10,11,58,-23
23497,80,71,71963,82,77,29,48,20,7
23514,74,73,88033,1,0,0,0,0,-1
23531,14,67,52381,46,37,24,13,27,-3
23550,59,70,14073,19,10,5,5,18,3
23565,47,73,9148,40,12,8,4,42,-2
23568,56,73,9148,78,17,11,6,24,-13
23594,83,83,92288,38,9,7,2,4,-1
23611,41,71,5668,54,26,9,17,26,13
23645,62,89,8820,14,7,1,6,6,7
23662,86,1479,4665,27,6,0,6,17,4
23681,71,78,9065,2,0,0,0,0,-3
23697,20,84,26309,78,27,5,22,38,-2
23700,26,77,26309,33,6,2,4,20,0
23719,86,63,184606,34,9,6,3,2,-11
23736,77,75,104284,1,0,0,0,0,0
23753,53,82,10991,3,0,0,0,15,0
23770,86,88,151440,43,13,6,7,6,-1
23791,20,78,70154,11,2,0,2,11,-4
23813,11,70,72030,20,7,2,5,21,-6
23830,17,70,31696,13,1,0,1,15,-6
23833,26,62,31696,41,3,1,2,35,-13
23850,80,64,39033,12,0,0,0,2,-8
23867,17,1479,28862,12,1,0,1,41,0
23884,41,74,9715,6,4,2,2,0,-4
23918,8,83,5532,41,19,4,15,61,1
23937,56,1479,11017,29,4,1,3,51,3
23954,2,88,62421,61,31,7,24,127,12
23957,8,77,62421,37,26,9,17,93,0
23976,17,70,31891,34,27,7,20,36,4
23994,20,74,70966,67,14,8,6,37,2
24014,32,79,31947,36,5,1,4,26,5
24033,71,85,34764,36,15,8,7,14,0
24050,29,77,31950,77,12,4,8,162,3
24069,11,70,8506,8,0,0,0,12,-2
24084,8,74,31982,82,19,2,17,153,9
24087,17,74,31982,82,14,3,11,220,19
24104,77,65,9609,19,5,4,1,4,-7
24121,83,62,223246,10,0,0,0,2,-3
24141,56,68,9067,82,34,6,28,72,14
24158,50,85,9503,4,0,0,0,2,1
24193,2,88,73585,31,6,2,4,12,-5
24211,50,74,8682,79,40,22,18,30,-7
24217,47,72,8915,8,0,0,0,2,-1
24234,71,83,8862,53,14,6,8,36,-1
24251,77,75,11002,45,2,1,1,12,3
24271,74,1479,19442,18,3,2,1,2,1
24288,77,65,9123,29,6,0,6,8,1
24305,68,66,8629,44,44,13,31,46,14
24322,50,72,9022,48,1,1,0,114,-2
24337,23,88,8577,81,50,23,27,94,-3
24340,32,88,8577,54,49,17,32,69,-8
24358,62,78,11420,9,3,1,2,9,1
24375,20,86,31949,81,16,1,15,64,-14
24392,86,85,321,72,35,10,25,14,-7
24410,50,65,8549,37,14,5,9,26,2
24428,71,76,9078,28,9,4,5,12,-9
24463,80,77,9519,13,1,1,0,2,-5
24466,47,83,8884,80,27,15,12,50,5
24483,65,547,75430,7,1,1,0,0,0
24500,71,63,9101,82,21,8,13,47,1
24517,71,64,273443,70,25,7,18,43,4
24534,62,81,2704,80,29,14,15,56,0
24551,59,62,6667,82,19,11,8,54,0
24568,71,63,9086,75,23,5,18,45,31
24583,50,89,9143,68,17,1,16,63,-14
24586,56,81,9143,50,23,4,19,36,-4
24603,32,64,19141,80,59,7,52,48,25
24620,80,70,6662,32,11,3,8,4,-3
24637,80,62,723,1,0,0,0,0,-1
24654,83,80,183872,21,6,2,4,8,1
24671,86,78,161865,78,35,12,23,45,14
24688,74,82,9402,56,29,8,21,34,-10
24706,50,82,9071,11,3,0,3,8,-4
24800,59,72,3228,31,4,1,3,10,-3
24821,23,71,7110,19,2,0,2,8,-4
24838,65,63,9518,69,15,9,6,15,-5
24856,5,72,54819,7,1,1,0,4,1
24873,56,68,8594,81,36,15,21,42,0
24891,56,62,9034,82,89,35,54,37,-2
24906,29,63,8976,71,19,8,11,67,-4
24909,38,86,8976,33,8,0,8,30,-10
24926,56,78,8974,69,8,1,7,44,11
24944,47,77,8856,17,0,0,0,37,6
24961,50,77,729545,2,0,0,0,0,0
24978,17,81,22341,75,79,23,56,77,-11
24996,56,75,5690,33,2,0,2,61,-6
25017,35,83,11806,2,0,0,0,2,0
25032,86,78,556,65,27,10,17,14,2
25054,29,83,73567,3,0,0,0,5,-1
25073,26,65,13631,62,13,2,11,70,0
25090,29,78,8669,63,34,13,21,28,20
25107,41,65,8651,5,2,0,2,2,-1
25124,53,73,8711,18,13,3,10,8,9
25141,86,79,231345,16,4,0,4,0,-7
25158,23,89,32748,9,6,0,6,6,4
25161,53,83,9511,81,21,5,16,44,-9
25179,68,71,8822,14,2,1,1,25,-4
25196,35,81,7303,21,7,4,3,6,0
25215,47,63,8700,58,23,6,17,46,-2
25232,86,83,223243,82,94,26,68,22,22
25249,35,83,8971,82,16,6,10,18,10
25271,14,72,22102,30,28,8,20,20,9
23317,83,86,46962,16,1,0,1,2,1
25291,8,72,69560,15,5,0,5,2,3
25294,17,85,69560,62,27,12,15,4,11
25313,80,77,242635,82,30,6,24,34,-7
25332,26,74,8570,70,45,9,36,38,-7
25352,23,77,8785,82,74,36,38,54,-2
25369,14,70,71815,47,16,7,9,36,-7
25386,8,75,69531,47,25,10,15,19,13
25403,17,75,8775,69,36,9,27,65,10
25418,56,77,10809,1,0,0,0,0,0
25421,65,1479,10809,15,2,2,0,6,6
25438,53,86,8930,79,17,8,9,30,-8
25458,71,65,8681,59,16,4,12,16,0
25475,59,85,1305,62,13,4,9,44,-15
25492,26,76,1607,12,1,1,0,6,2
25509,47,78,10370,33,12,7,5,33,-8
25526,23,88,10400,11,1,1,0,4,-7
25541,83,67,62577,48,25,7,18,14,-10
25544,29,79,8619,70,46,13,33,43,13
25565,47,84,10222,43,12,7,5,61,5
25589,29,77,67421,67,7,1,6,45,-2
25607,8,89,22703,4,0,0,0,0,1
25624,38,84,10228,81,37,7,30,23,-15
25642,41,76,10188,1,0,0,0,0,0
25659,50,80,9037,43,7,4,3,10,4
25675,11,78,33739,43,7,1,6,76,-6
25679,29,62,8824,78,22,10,12,67,-6
25696,38,70,8727,76,10,3,7,35,15
25713,35,68,4516,31,11,5,6,34,-2
25730,80,66,67708,67,29,11,18,22,-8
25747,53,63,191228,75,29,13,16,15,11
25765,38,76,69981,4,0,0,0,28,-1
25777,56,80,8634,71,40,3,37,28,4
25778,59,80,8634,53,28,3,25,28,-5
126,41,82,8615,57,34,13,21,54,-11
391,47,68,8888,10,3,2,1,2,2
939,14,1479,31276,44,19,10,9,25,-7
1216,17,88,72256,15,1,1,0,42,-3
1491,59,62,9154,82,30,11,19,81,17
1759,83,1479,43578,10,2,1,1,0,-4
2006,83,78,301407,41,9,3,6,12,-12
2050,53,64,8828,77,48,18,30,14,10
2327,80,65,18084,50,8,2,6,22,1
2616,8,85,8613,73,87,34,53,72,33
2889,32,1479,8545,44,7,3,4,12,-5
3133,53,84,9442,27,13,5,8,24,-1
3403,62,68,10437,11,0,0,0,16,-3
3678,86,79,98121,43,17,8,9,26,12
3878,62,67,9212,64,31,16,15,34,11
3930,29,65,9064,82,84,43,41,48,10
4201,29,67,9072,82,45,20,25,16,-3
4456,71,86,11544,25,5,3,2,6,-2
5012,23,81,69451,54,3,1,2,166,-2
5305,26,70,33769,69,27,13,14,26,2
5591,11,71,70513,24,18,13,5,14,4
5832,38,64,25148,65,10,5,5,34,0
5895,8,63,67936,55,10,7,3,177,4
6174,47,79,4482,49,28,6,22,46,-20
6442,29,73,69917,3,0,0,0,4,-2
6710,50,65,8948,25,5,3,2,14,-2
6993,17,74,67702,25,4,2,2,30,-1
7276,56,73,7434,38,11,3,8,14,0
7546,11,76,70449,17,2,1,1,49,-2
7777,80,69,178573,6,0,0,0,0,-3
7828,71,77,10429,82,86,28,58,46,7
8090,59,77,11446,10,1,0,1,0,-2
8343,50,1479,8968,14,1,0,1,13,-1
8630,20,79,5079,36,9,4,5,22,-11
9174,86,86,11102,81,70,27,43,22,-6
9441,20,68,8565,82,56,27,29,170,7
9670,74,85,976,68,8,3,5,22,-4
9724,11,72,27639,78,50,20,30,52,24
9993,11,81,32127,6,3,1,2,2,2
10266,71,86,3667,82,70,33,37,18,0
10547,47,79,8678,72,15,3,12,66,-2
10825,11,74,53928,12,6,4,2,12,5
11115,23,84,25440,35,5,3,2,181,-3
11404,65,80,3967,81,78,19,59,42,16
11635,41,80,8903,5,1,0,1,2,1
11699,29,78,5850,67,39,16,23,51,24
11865,23,76,67477,19,3,0,3,12,2
11892,71,80,19222,13,1,1,0,48,-2
11909,59,70,6003,2,1,0,1,0,1
11926,17,63,39482,27,4,0,4,16,2
11960,47,82,1918,80,65,22,43,50,-9
12090,71,82,22625,49,6,2,4,37,-7
12130,32,67,32599,54,13,4,9,12,9
12399,56,1479,8519,82,59,14,45,70,-8
12665,41,85,8819,67,43,14,29,22,7
12936,53,89,119949,40,37,11,26,24,-19
13216,5,77,27216,57,30,14,16,26,-6
13468,68,1479,17498,42,21,10,11,9,2
13731,17,80,2655,20,2,0,2,14,0
13906,86,72,16047,50,17,4,13,22,-17
13984,80,70,23165,60,12,3,9,49,-7
14238,47,62,8603,51,26,7,19,56,8
14506,38,65,21559,20,4,3,1,22,-1
14773,5,77,8905,78,56,20,36,93,-10
15042,8,63,1950,39,14,8,6,12,-6
15307,50,72,8921,76,9,6,3,92,-10
15812,62,69,17841,15,2,1,1,4,-1
15864,65,69,38210,51,12,1,11,57,-17
16110,29,70,1563,12,5,1,4,4,-1
16377,14,65,21483,12,8,4,4,8,3
16636,68,77,37584,18,5,3,2,19,0
16904,29,86,119799,79,37,12,25,22,9
17168,86,75,75068,36,11,2,9,26,-1
17402,56,72,8688,34,14,6,8,29,-2
17642,14,1479,8877,15,7,2,5,6,1
17697,41,63,10808,33,5,3,2,33,1
17966,29,76,7298,17,6,2,4,6,-1
18237,59,82,9111,57,11,2,9,62,-9
18474,2,78,32726,54,5,1,4,50,3
18754,29,72,21372,78,29,8,21,103,30
19017,26,65,11804,11,0,0,0,44,-4
19268,38,80,3723,12,4,3,1,15,-2
19547,77,80,45581,26,3,2,1,9,-3
19821,47,1479,8524,82,85,34,51,32,24
20104,56,1479,8893,17,6,3,3,19,6
20370,38,1479,8865,80,3,1,2,74,-23
20636,68,72,15179,4,0,0,0,2,-1
20907,29,81,8571,17,5,2,3,25,-4
21164,32,75,8702,60,25,6,19,34,-1
21411,26,70,8483,11,0,0,0,0,-3
21448,41,68,7297,67,16,3,13,51,2
21715,65,547,11506,13,1,0,1,7,-1
22005,68,81,44415,2,0,0,0,0,1
22274,83,81,90411,23,4,3,1,11,-1
22540,41,82,3660,29,8,2,6,16,-8
22807,35,83,11484,23,4,1,3,8,3
23066,65,73,9516,77,30,6,24,92,-5
23314,53,1479,9916,4,0,0,0,0,-3
23628,86,76,161337,10,2,1,1,6,2
23901,77,65,41028,6,1,0,1,2,-1
24176,59,66,10318,6,0,0,0,5,-2
24445,86,78,3654,78,17,3,14,40,-3
24703,38,63,9071,80,38,10,28,64,-4
25035,20,74,10816,27,2,1,1,4,-4
17570,38,67,794,79,75,26,49,20,-3
17571,41,67,794,82,57,29,28,30,-15
17573,50,76,794,81,59,27,32,46,-12
17574,53,76,794,80,41,16,25,39,-11
17575,56,79,794,65,36,17,19,36,3
17576,59,63,794,38,14,9,5,12,8
17577,2,74,27646,59,47,24,23,21,8
17585,20,68,27646,68,60,29,31,4,4
17586,23,68,27646,61,31,14,17,21,-13
17587,23,66,27646,10,6,4,2,2,2
17588,26,66,27646,74,58,25,33,16,4
17590,29,77,70054,2,0,0,0,2,0
17591,2,63,68083,1,0,0,0,5,-1
17593,23,66,8743,23,2,0,2,44,-2
17594,26,66,8743,61,15,1,14,95,15
17595,29,66,8743,64,4,3,1,90,-22
17596,32,64,8743,46,3,1,2,40,2
17597,35,81,8743,46,3,0,3,51,-4
17598,38,81,8743,67,8,1,7,35,-6
17599,41,81,8743,58,4,1,3,42,11
17600,47,81,8743,82,9,0,9,60,7
17601,50,81,8743,81,8,1,7,44,0
17602,53,67,8743,55,7,1,6,30,1
17603,38,69,10311,1,0,0,0,0,0
17604,32,77,10837,1,0,0,0,0,-1
17607,17,84,77879,3,1,1,0,0,1
17609,23,84,77879,11,0,0,0,5,-7
17610,32,88,10454,10,4,1,3,2,4
17611,29,80,52952,10,0,0,0,6,-2
17612,32,80,52952,41,2,1,1,20,-5
17613,32,81,52952,12,2,1,1,22,0
17614,35,63,52952,22,2,0,2,16,-4
17615,14,83,10535,1,0,0,0,2,0
17616,17,83,10535,7,2,1,1,6,-1
17617,20,83,10535,23,8,3,5,6,4
17618,14,84,8798,11,1,0,1,33,0
17619,17,84,8798,63,12,4,8,137,-7
17620,20,84,8798,64,18,3,15,132,2
17621,23,84,8798,59,13,3,10,164,-8
17622,26,73,8798,71,40,15,25,103,0
17623,29,73,8798,69,28,7,21,90,-16
17624,32,73,8798,74,54,25,29,66,-2
17626,38,73,8798,60,33,15,18,58,2
17627,41,73,8798,75,67,25,42,94,4
17628,47,73,8798,33,16,5,11,36,2
17629,50,66,8798,81,51,21,30,45,-10
17630,53,66,8798,58,32,14,18,115,-3
17631,56,66,8798,41,15,5,10,39,-4
17632,59,66,8798,33,5,3,2,23,-4
17633,59,89,8798,9,3,2,1,9,1
17634,17,64,1420,4,1,0,1,6,-2
17635,20,63,1420,9,2,0,2,4,-1
17636,32,76,1420,12,1,0,1,0,-2
17637,41,85,1420,8,1,0,1,2,-1
17638,2,85,8877,3,1,0,1,0,-2
17639,8,85,8877,51,21,4,17,16,0
17640,11,85,8877,62,29,8,21,10,2
17641,14,85,8877,13,8,2,6,2,3
17643,17,1479,8877,62,34,13,21,32,-20
17644,17,84,8877,12,4,1,3,6,2
17645,20,84,8877,78,37,17,20,25,-3
17646,23,84,8877,48,19,10,9,34,-14
17647,23,77,8877,27,22,11,11,16,3
17648,26,77,8877,25,3,0,3,8,-9
17649,26,81,8877,54,10,8,2,28,-20
17650,29,81,8877,67,44,19,25,86,-29
17651,29,68,8877,13,8,4,4,16,-1
17652,32,68,8877,55,34,13,21,44,-12
17653,32,80,8877,13,7,3,4,4,1
17654,35,82,8877,80,43,20,23,54,-35
17655,38,82,8877,75,43,18,25,52,-21
17657,41,78,8877,16,10,5,5,14,4
17658,47,78,8877,48,41,22,19,49,-17
17659,47,73,8877,31,22,10,12,14,0
17661,53,76,8877,52,26,14,12,28,-10
17662,56,76,8877,7,2,2,0,0,-5
17663,26,79,8156,0,0,0,0,0,0
17664,35,63,8156,1,0,0,0,0,0
17665,23,65,3307,1,0,0,0,0,0
17666,23,1479,2699,3,0,0,0,0,-1
17667,26,1479,2699,73,8,3,5,24,-12
17668,29,1479,2699,63,18,7,11,26,-13
17669,32,1479,2699,12,2,1,1,2,1
17670,26,65,11040,7,0,0,0,19,-2
17671,26,75,11040,8,0,0,0,33,1
17672,38,76,11040,3,0,0,0,2,0
17673,47,79,11040,6,0,0,0,8,2
17674,50,79,11040,44,5,1,4,18,12
17675,53,79,11040,6,0,0,0,4,-4
17676,38,62,68718,2,0,0,0,0,0
17678,26,1479,39759,20,5,2,3,16,-10
87,5,79,76355,50,0,0,0,175,-6
657,83,80,188843,10,3,1,2,0,-4
4734,2,89,21393,79,74,24,50,69,-10
8904,56,79,11308,5,1,1,0,4,-1
11943,83,69,11608,61,37,9,28,8,-6
15577,20,71,9666,73,22,6,16,52,2
19510,5,76,30697,71,70,28,42,71,11
23354,53,63,10256,20,6,0,6,6,2
8380,23,64,8859,64,63,27,36,50,0
8381,26,64,8859,73,96,41,55,29,23
8382,29,64,8859,60,81,28,53,28,30
8384,35,64,8859,82,79,26,53,18,12
8385,38,64,8859,58,58,26,32,24,4
10697,41,84,729566,41,15,8,7,12,7
10698,8,67,26127,80,31,4,27,59,9
10699,11,67,26127,84,41,14,27,69,22
10700,14,67,26127,39,11,4,7,46,5
10701,20,67,26127,62,30,11,19,43,19
24,11,72,31347,76,33,10,23,51,7
25,14,72,31347,41,16,5,11,19,-1
26,17,72,31347,52,10,5,5,14,-10
73,32,84,42376,66,56,12,44,10,1
74,35,84,42376,53,50,11,39,22,5
75,38,82,42376,79,68,20,48,30,-4
76,41,82,42376,58,26,6,20,26,-24
77,47,89,42376,31,12,4,8,14,-3
78,41,74,8939,58,6,2,4,16,-10
79,47,74,8939,78,7,5,2,38,2
80,50,74,8939,41,11,2,9,22,7
81,53,73,8939,51,8,4,4,32,-8
82,56,73,8939,2,0,0,0,0,0
83,59,86,8939,76,19,8,11,37,4
84,62,69,8939,4,0,0,0,2,-1
85,65,69,8939,35,2,1,1,14,-8
86,2,79,76355,23,2,1,1,71,-2
0,41,1479,8517,21,6,0,6,12,1
2,47,1479,8517,67,41,19,22,69,19
3,50,1479,8517,81,60,25,35,81,23
4,53,1479,8517,82,50,21,29,80,8
5,56,1479,8517,62,35,16,19,55,9
6,56,79,8517,20,18,7,11,16,3
7,59,79,8517,50,32,13,19,39,3
8,62,79,8517,66,48,23,25,47,18
9,65,79,8517,82,61,26,35,49,16
10,68,79,8517,48,52,22,30,39,30
11,71,79,8517,78,68,35,33,66,25
12,74,79,8517,74,40,17,23,56,2
13,77,79,8517,80,40,17,23,41,29
14,80,79,8517,71,29,9,20,36,0
15,83,81,8517,82,29,13,16,35,8
16,86,65,8517,56,10,5,5,23,-7
17,38,78,9665,1,1,1,0,0,0
18,41,78,9665,20,4,2,2,4,-9
19,47,78,9665,6,2,1,1,4,1
20,50,78,9665,22,4,3,1,4,2
44,5,86,41118,4,0,0,0,0,-2
45,8,86,41118,55,16,7,9,81,-25
46,86,84,197901,1,0,0,0,2,-1
47,47,86,8886,47,22,10,12,14,-7
48,41,86,8658,69,19,2,17,12,8
49,47,86,8658,74,43,11,32,26,17
50,50,80,8658,80,38,7,31,18,40
51,53,88,8658,77,24,8,16,16,-6
52,56,88,8658,22,7,3,4,6,-7
21,2,63,31347,29,16,8,8,22,2
22,5,63,31347,60,48,25,23,46,-3
23,8,89,31347,68,28,11,17,65,-16
27,20,72,31347,62,19,4,15,14,6
28,23,72,31347,66,18,9,9,22,-4
29,26,72,31347,56,10,2,8,36,-3
30,2,85,22350,64,46,21,25,28,3
31,5,85,22350,80,69,34,35,30,17
32,8,85,22350,52,51,25,26,18,0
33,8,88,22350,34,22,12,10,14,-2
34,11,88,22350,25,11,4,7,2,-2
35,11,84,22350,34,17,7,10,22,-13
38,41,82,10673,2,0,0,0,0,0
39,47,82,10673,2,0,0,0,0,-2
40,50,82,10673,7,1,1,0,0,0
41,53,89,10673,8,4,2,2,0,1
43,2,63,41118,50,11,4,7,68,-13
53,59,64,8658,4,1,0,1,0,-6
54,41,77,8833,1,0,0,0,0,0
55,47,77,8833,57,27,6,21,33,10
56,50,77,8833,25,5,2,3,14,-4
57,50,76,8833,35,3,0,3,24,0
59,53,76,8833,52,12,3,9,22,6
60,56,76,8833,27,9,4,5,14,-19
61,59,76,8833,64,15,4,11,40,-2
63,2,75,42376,54,25,6,19,20,2
70,23,62,42376,81,44,17,27,32,-7
71,26,62,42376,70,37,12,25,18,-12
72,29,84,42376,79,62,17,45,16,8
91,8,78,31023,11,5,1,4,10,3
92,8,89,31023,71,13,5,8,46,3
93,11,70,31023,74,44,11,33,82,13
94,14,70,31023,44,12,1,11,28,8
95,17,70,31023,8,0,0,0,6,-3
96,2,78,16065,78,35,8,27,81,4
97,5,78,16065,48,16,9,7,40,-8
100,41,66,3652,81,31,11,20,40,-6
101,47,66,3652,82,100,45,55,81,-8
102,50,66,3652,82,70,30,40,68,-6
103,53,66,3652,82,82,38,44,50,-2
104,56,66,3652,82,75,40,35,50,15
105,59,66,3652,70,70,29,41,68,4
106,62,66,3652,81,76,33,43,72,-10
107,65,66,3652,82,70,24,46,48,-20
108,68,66,3652,48,53,18,35,54,5
110,74,66,3652,77,54,23,31,41,-13
111,77,66,3652,63,33,10,23,32,-3
112,77,74,3652,20,6,3,3,2,1
113,80,69,3652,82,65,28,37,34,17
114,83,69,3652,82,76,42,34,42,8
115,86,69,3652,81,52,22,30,34,-7
116,41,68,3655,55,22,14,8,57,-5
117,47,68,3655,71,47,28,19,89,8
118,50,68,3655,82,62,31,31,61,15
119,53,68,3655,82,62,27,35,85,15
120,56,68,3655,67,45,22,23,48,-5
121,59,68,3655,65,57,20,37,42,-1
122,62,63,3655,80,53,26,27,85,29
123,65,63,3655,46,32,17,15,54,0
124,68,63,3655,43,22,13,9,22,1
125,71,82,3655,36,19,5,14,24,-3
127,47,82,8615,73,54,27,27,50,-13
128,50,82,8615,71,32,10,22,26,-19
129,53,82,8615,82,61,26,35,34,-9
130,56,74,8615,82,58,23,35,39,6
131,62,77,8615,56,22,16,6,22,5
132,47,67,8492,81,48,25,23,72,-11
133,50,67,8492,82,84,43,41,40,47
134,53,67,8492,82,64,36,28,64,-5
135,56,67,8492,73,64,40,24,44,-1
136,59,67,8492,71,53,28,25,42,9
137,62,67,8492,80,73,32,41,24,2
138,65,67,8492,78,61,26,35,52,-6
139,68,67,8492,38,41,20,21,20,-1
140,71,67,8492,13,9,4,5,4,-5
141,71,76,8492,47,44,17,27,34,4
142,71,75,8492,18,15,6,9,8,8
144,77,69,8492,74,41,18,23,22,-10
145,80,85,8492,48,38,15,23,16,2
146,80,68,8492,20,10,2,8,6,-7
147,83,84,8492,61,41,17,24,28,-12
148,83,82,8492,19,15,7,8,8,9
149,86,85,8492,64,36,16,20,26,-12
150,2,76,23379,56,14,5,9,61,-19
151,5,76,23379,12,2,1,1,17,-4
152,11,76,23379,3,1,1,0,4,-1
153,14,76,23379,13,0,0,0,11,-2
154,20,65,23379,8,0,0,0,6,1
155,41,86,8580,2,1,1,0,4,1
156,47,86,8580,81,35,17,18,45,1
157,50,86,8580,78,66,26,40,36,17
158,53,86,8580,79,55,24,31,47,19
159,56,86,8580,77,57,23,34,52,11
161,62,80,8580,66,33,18,15,49,-12
162,65,80,8580,77,60,35,25,32,4
163,68,80,8580,23,14,4,10,17,8
164,71,80,8580,82,39,17,22,41,-25
165,74,80,8580,66,34,13,21,33,3
166,77,80,8580,32,10,6,4,12,1
167,77,83,8580,13,6,1,5,6,-1
168,80,83,8580,5,2,1,1,2,-2
171,50,77,9475,20,7,3,4,16,-2
172,53,77,9475,78,36,9,27,74,17
173,56,77,9475,80,28,7,21,97,7
174,59,77,9475,81,19,5,14,54,-6
175,62,77,9475,82,16,2,14,53,15
176,65,77,9475,81,24,4,20,56,10
177,68,77,9475,33,5,1,4,41,-10
178,71,77,9475,82,17,5,12,63,-6
180,74,81,9475,4,2,0,2,9,3
181,77,81,9475,80,10,1,9,53,12
182,80,81,9475,80,12,5,7,50,-1
183,83,81,9475,72,15,1,14,40,3
184,86,81,9475,74,23,4,19,34,4
185,2,75,31372,57,20,9,11,32,-8
186,5,72,31372,76,36,19,17,32,8
187,8,72,31372,50,19,7,12,25,-1
188,11,72,31372,76,41,21,20,32,14
189,14,72,31372,42,18,10,8,16,-4
190,17,80,31372,72,29,15,14,21,-9
191,20,80,31372,68,26,18,8,16,-1
192,23,76,31372,82,35,12,23,39,7
193,26,76,31372,2,1,0,1,2,1
194,26,89,31372,17,2,0,2,4,-4
195,26,62,31372,7,0,0,0,2,-5
197,47,75,6664,12,3,2,1,2,1
198,50,75,6664,22,11,1,10,6,3
199,53,75,6664,78,53,26,27,29,15
200,56,75,6664,74,41,23,18,50,-7
201,59,75,6664,59,33,15,18,32,1
202,62,75,6664,81,45,20,25,36,3
203,65,75,6664,53,24,12,12,16,-8
204,65,73,6664,19,12,4,8,10,7
205,47,77,8810,81,42,23,19,40,10
206,50,77,8810,62,37,14,23,48,-17
207,53,77,8810,82,53,29,24,55,6
208,56,77,8810,82,84,46,38,68,23
209,59,77,8810,74,61,33,28,38,2
210,62,77,8810,80,66,36,30,39,27
88,8,79,76355,26,0,0,0,60,-1
89,2,78,31023,67,35,10,25,89,19
215,74,88,8810,82,62,28,34,28,7
216,77,88,8810,77,62,24,38,20,18
217,80,88,8810,82,66,32,34,41,2
218,83,88,8810,27,22,13,9,2,4
219,86,88,8810,76,33,13,20,42,-20
220,47,62,8560,82,49,20,29,93,5
221,50,62,8560,79,50,17,33,98,10
222,53,62,8560,82,60,17,43,182,12
223,56,62,8560,80,47,11,36,100,-11
224,59,62,8560,55,22,10,12,49,3
225,59,83,8560,26,10,2,8,34,-2
226,62,83,8560,66,30,8,22,88,-2
227,65,83,8560,82,44,12,32,92,-10
228,68,83,8560,48,28,9,19,65,-4
229,71,83,8560,80,31,8,23,144,2
230,74,83,8560,70,29,3,26,108,-11
232,77,80,8560,20,8,1,7,23,-3
233,80,80,8560,81,30,9,21,100,-6
234,83,80,8560,53,16,3,13,34,-8
235,83,88,8560,26,10,3,7,15,-7
236,86,88,8560,67,6,1,5,53,-21
237,62,68,11747,2,0,0,0,5,-1
238,47,65,8870,69,32,5,27,60,5
239,50,65,8870,81,24,4,20,104,-6
240,53,65,8870,82,32,9,23,90,13
241,56,65,8870,82,26,8,18,62,23
242,59,65,8870,78,30,4,26,59,20
243,62,65,8870,82,48,9,39,47,0
244,65,65,8870,78,34,9,25,22,21
245,68,65,8870,47,20,8,12,23,12
246,71,65,8870,82,41,7,34,22,23
247,74,65,8870,82,31,8,23,27,-3
249,80,65,8870,79,39,3,36,26,5
250,83,65,8870,81,26,7,19,38,-3
251,86,65,8870,78,28,5,23,41,-6
252,47,76,7735,53,20,6,14,26,-6
253,50,71,7735,4,1,1,0,4,-1
254,53,71,7735,71,41,10,31,22,8
255,56,71,7735,64,29,9,20,26,1
256,59,71,7735,60,27,11,16,12,-17
257,47,86,9076,39,27,14,13,35,4
258,50,86,9076,62,31,15,16,29,5
259,53,86,9076,59,23,13,10,62,-2
260,53,67,9076,17,9,3,6,2,1
261,56,84,9076,81,32,15,17,27,4
262,59,84,9076,59,22,11,11,21,0
263,62,68,9076,68,15,5,10,21,-14
264,65,72,9076,32,6,1,5,16,6
266,71,72,9076,78,12,3,9,33,-15
267,74,72,9076,67,32,16,16,28,2
268,77,76,9076,24,6,1,5,9,3
269,83,76,9076,4,0,0,0,0,-2
270,47,72,8898,81,32,14,18,28,-1
271,50,72,8898,82,62,31,31,30,-3
272,53,72,8898,81,65,32,33,25,13
273,56,72,8898,82,94,45,49,24,30
274,59,72,8898,81,82,38,44,32,24
275,62,72,8898,13,6,3,3,6,-1
276,65,72,8898,82,69,31,38,32,-5
277,68,69,8898,48,38,18,20,16,2
278,71,69,8898,67,56,29,27,30,10
279,74,69,8898,74,62,33,29,41,21
280,77,69,8898,70,53,25,28,36,-3
281,80,69,8898,69,42,19,23,30,-3
283,86,69,8898,74,61,28,33,26,-2
284,26,77,11570,2,1,0,1,0,-1
285,29,77,11570,27,7,2,5,8,-1
286,32,77,11570,66,14,5,9,16,2
287,35,73,11570,73,38,16,22,22,-13
288,38,73,11570,71,34,18,16,28,-17
289,41,67,11570,37,7,2,5,29,-5
290,47,82,11570,7,0,0,0,2,-1
291,47,89,10349,11,0,0,0,2,0
292,50,89,10349,14,3,2,1,8,3
293,53,89,10349,23,6,1,5,6,4
294,56,89,10349,61,25,12,13,22,8
295,59,89,10349,69,39,21,18,24,18
296,62,89,10349,52,20,10,10,16,0
297,65,547,10349,35,3,2,1,12,-6
298,68,89,10349,41,17,9,8,10,14
300,74,89,10349,75,33,19,14,20,8
301,77,79,10349,55,14,8,6,19,0
302,80,79,10349,52,11,6,5,14,3
303,80,83,10349,1,0,0,0,0,-1
304,83,83,10349,4,0,0,0,2,-1
305,83,86,10349,14,4,3,1,0,7
306,86,69,10349,72,15,7,8,30,-8
307,2,75,24026,78,44,20,24,63,-1
308,5,75,24026,72,39,18,21,39,2
309,8,75,24026,61,17,4,13,20,-9
310,11,75,24026,79,38,14,24,48,16
311,14,78,24026,42,16,5,11,16,11
312,17,70,24026,71,23,8,15,38,-2
313,20,70,24026,73,21,5,16,36,9
314,23,70,24026,77,24,7,17,40,3
315,26,70,24026,74,16,4,12,31,-3
317,47,63,9397,17,2,1,1,10,-1
318,50,63,9397,15,1,0,1,14,7
319,53,63,9397,82,8,4,4,81,2
320,56,63,9397,82,17,5,12,76,20
321,59,63,9397,56,7,2,5,80,1
322,62,63,9397,31,5,1,4,23,8
324,65,547,9397,80,14,3,11,98,-4
325,68,547,9397,42,4,2,2,53,5
326,71,547,9397,69,13,2,11,101,11
327,74,547,9397,70,14,2,12,69,5
328,77,547,9397,64,3,1,2,66,-7
329,80,547,9397,42,4,2,2,27,4
330,47,71,8913,8,1,1,0,0,1
331,50,71,8913,46,11,4,7,18,-2
212,65,88,8810,16,9,6,3,2,-1
213,68,88,8810,48,33,26,7,16,0
337,29,62,9121,13,5,4,1,16,2
338,32,62,9121,51,13,9,4,74,-8
339,35,62,9121,19,1,1,0,40,-3
343,41,88,9121,13,3,2,1,24,-1
344,47,88,9121,46,9,8,1,73,-8
345,50,88,9121,21,2,0,2,32,-1
346,50,84,9121,42,10,7,3,93,4
347,53,84,9121,46,1,0,1,110,-5
348,47,77,219473,79,34,11,23,65,6
349,50,77,219473,59,32,10,22,52,-12
350,53,77,219473,73,75,28,47,76,14
351,56,77,219473,79,80,30,50,63,22
352,59,77,219473,82,62,31,31,79,-2
353,62,77,219473,81,66,23,43,62,11
354,65,88,219473,74,44,18,26,71,3
355,68,88,219473,48,32,12,20,42,-8
357,74,88,219473,53,16,5,11,39,-10
358,77,89,219473,39,5,2,3,8,-2
360,5,89,32602,2,0,0,0,2,-3
361,8,81,32602,55,39,10,29,36,-21
362,11,81,32602,66,34,11,23,23,-6
363,14,81,32602,24,14,2,12,6,0
364,14,72,32602,21,7,2,5,6,2
365,17,72,32602,64,23,2,21,18,1
366,20,72,32602,73,21,4,17,19,17
367,23,70,32602,57,24,2,22,26,11
368,26,70,32602,61,11,2,9,18,6
369,29,70,32602,4,0,0,0,4,-2
370,53,88,11427,8,5,4,1,4,4
371,56,88,11427,28,5,4,1,42,-9
372,59,74,11427,71,6,4,2,47,-6
373,62,74,11427,82,35,21,14,74,2
375,68,74,11427,38,5,2,3,29,-13
376,71,74,11427,82,18,6,12,56,1
377,74,81,11427,82,24,15,9,54,3
378,77,81,11427,76,20,13,7,57,-7
379,80,81,11427,54,22,13,9,48,5
380,80,83,11427,21,3,0,3,18,-2
381,83,72,11427,69,23,13,10,45,-9
382,86,72,11427,47,19,13,6,22,-13
383,86,73,11427,26,5,5,0,16,-1
384,47,88,9512,4,0,0,0,2,-1
385,47,76,9512,21,4,1,3,8,2
386,50,76,9512,23,9,2,7,6,6
387,53,76,9512,31,4,1,3,8,-9
388,56,76,9512,65,15,7,8,32,-20
389,59,76,9512,36,14,7,7,14,-8
390,62,84,9512,62,17,9,8,18,10
392,50,68,8888,10,1,0,1,2,1
393,53,68,8888,26,1,0,1,0,-1
394,56,68,8888,59,7,2,5,34,-6
396,65,66,8888,77,20,9,11,30,-2
397,47,80,9140,58,29,20,9,22,7
398,50,80,9140,73,32,14,18,36,1
399,53,80,9140,26,10,4,6,6,0
400,53,66,9140,11,5,1,4,4,-2
401,56,66,9140,74,14,6,8,31,7
402,59,85,9140,65,22,12,10,26,0
403,62,85,9140,63,20,13,7,14,-2
404,65,85,9140,10,1,0,1,2,0
405,68,85,9140,34,8,2,6,4,-1
406,71,85,9140,25,5,2,3,2,-4
407,71,73,9140,5,0,0,0,0,-3
408,74,70,9140,47,27,14,13,8,12
410,80,70,9140,59,37,21,16,16,-10
411,80,1479,9140,20,14,11,3,8,8
412,83,1479,9140,2,1,1,0,0,0
413,86,1479,9140,7,0,0,0,4,-4
414,50,69,9465,9,1,0,1,0,4
415,59,75,9465,2,0,0,0,0,-2
416,62,71,9465,5,0,0,0,0,-2
417,62,64,9465,4,0,0,0,2,1
418,47,66,9437,10,1,0,1,7,-3
419,47,65,9437,10,0,0,0,18,-3
420,50,65,9437,22,2,0,2,48,-1
421,53,65,9437,7,0,0,0,2,-5
422,53,79,11533,6,1,0,1,5,-1
423,56,79,11533,2,0,0,0,2,1
424,59,71,11533,27,6,0,6,48,2
425,2,77,72768,36,6,0,6,105,1
427,5,79,72768,17,1,0,1,35,-8
428,8,79,72768,1,0,0,0,2,1
429,8,88,72768,17,1,0,1,23,-3
430,11,71,72768,2,0,0,0,0,1
431,50,70,757,59,19,6,13,18,-3
432,53,70,757,69,31,14,17,28,5
433,56,70,757,82,63,36,27,14,14
434,59,70,757,82,71,29,42,26,-4
435,62,70,757,79,73,27,46,8,10
436,65,70,757,82,71,26,45,12,18
437,68,70,757,48,29,12,17,8,-9
438,71,63,757,61,37,10,27,6,14
439,74,63,757,81,47,22,25,14,1
440,77,63,757,82,63,30,33,12,13
441,80,84,757,65,24,11,13,8,-9
442,83,84,757,50,23,10,13,4,0
444,2,85,31637,42,20,3,17,80,0
445,5,85,31637,62,34,10,24,136,22
446,8,85,31637,79,62,12,50,155,14
447,11,85,31637,82,46,13,33,122,17
448,14,62,31637,45,25,2,23,39,10
449,17,62,31637,76,33,8,25,62,3
450,20,62,31637,47,16,5,11,32,-11
452,23,66,31637,66,34,7,27,65,-2
453,26,66,31637,28,9,1,8,16,7
454,23,81,77150,8,1,1,0,10,-1
455,26,81,77150,8,1,0,1,2,0
456,47,73,9502,2,0,0,0,0,-1
457,50,73,9502,3,1,1,0,0,3
458,53,73,9502,13,2,0,2,6,-3
333,56,71,8913,63,20,8,12,23,1
334,59,71,8913,35,14,7,7,21,-4
463,68,73,9502,47,14,3,11,9,-1
464,71,73,9502,47,3,1,2,21,-11
465,71,74,9502,30,6,1,5,0,4
466,74,74,9502,65,26,9,17,25,24
467,77,74,9502,69,26,9,17,19,16
468,80,74,9502,60,14,3,11,31,5
469,50,68,9610,14,2,1,1,6,-1
470,53,68,9610,76,25,8,17,29,10
471,56,68,9610,66,19,4,15,18,2
472,59,68,9610,76,14,5,9,18,-7
473,2,65,9104,77,64,12,52,192,23
474,5,65,9104,80,56,9,47,245,24
475,8,65,9104,84,73,15,58,282,14
476,11,65,9104,76,60,16,44,212,12
477,14,65,9104,48,38,5,33,72,17
478,17,65,9104,81,72,14,58,140,25
480,23,65,9104,81,42,3,39,151,-7
481,26,65,9104,65,34,8,26,89,-4
482,26,85,9104,10,2,1,1,4,5
483,29,85,9104,81,34,3,31,103,48
484,32,85,9104,24,3,0,3,45,4
485,35,85,9104,79,39,6,33,126,40
486,38,85,9104,66,19,2,17,78,4
487,41,85,9104,69,21,2,19,61,12
488,47,85,9104,81,11,4,7,108,22
489,50,85,9104,71,11,0,11,34,11
490,53,85,9104,69,12,3,9,36,11
491,56,85,9104,28,0,0,0,18,1
493,53,81,12024,14,0,0,0,12,-6
494,56,81,12024,43,4,0,4,50,-11
495,59,81,12024,33,2,0,2,27,-4
496,62,81,12024,32,0,0,0,17,2
498,50,80,10416,10,1,1,0,4,0
499,53,80,10416,5,0,0,0,0,-1
500,56,80,10416,1,0,0,0,0,0
501,59,80,10416,4,0,0,0,0,-1
502,65,63,10416,3,0,0,0,2,1
503,5,62,67358,11,0,0,0,6,-9
505,2,74,51054,19,1,1,0,52,1
506,5,74,51054,67,15,3,12,121,11
507,8,74,51054,55,9,3,6,85,1
508,11,68,51054,63,10,1,9,99,8
509,14,68,51054,20,1,0,1,21,-7
510,17,80,51054,6,0,0,0,4,-3
511,41,82,9430,19,1,1,0,12,-5
512,47,82,9430,59,13,6,7,22,-14
513,50,82,9430,59,27,12,15,35,3
514,53,82,9430,69,22,10,12,22,2
516,56,69,9430,34,9,4,5,10,-3
517,47,86,9107,12,6,3,3,14,-2
518,50,86,9107,77,42,11,31,30,9
519,53,86,9107,62,15,2,13,26,-8
520,56,81,9107,12,2,1,1,6,1
521,56,77,9107,64,24,4,20,16,2
522,59,77,9107,80,35,6,29,16,19
523,62,77,9107,82,40,1,39,23,30
524,65,77,9107,82,38,4,34,36,4
525,68,81,9107,48,22,5,17,4,1
526,71,81,9107,82,31,2,29,28,11
527,74,81,9107,59,18,4,14,26,12
528,77,81,9107,64,9,2,7,26,4
529,80,73,9107,6,1,0,1,0,-1
530,41,63,9074,71,39,16,23,22,5
531,47,63,9074,81,73,31,42,22,3
533,53,63,9074,10,7,3,4,2,2
534,56,63,9074,64,39,8,31,16,2
535,59,63,9074,73,52,19,33,28,6
536,62,63,9074,80,57,22,35,26,20
537,65,63,9074,81,64,22,42,20,36
538,68,63,9074,42,32,10,22,18,24
539,71,63,9074,80,62,30,32,43,38
540,74,63,9074,81,55,23,32,44,2
541,77,63,9074,80,68,32,36,49,12
542,80,63,9074,79,53,21,32,24,12
543,83,63,9074,64,63,30,33,26,21
544,86,63,9074,65,79,32,47,30,23
545,47,73,9499,28,10,2,8,42,8
546,50,73,9499,79,40,17,23,60,13
547,53,73,9499,54,20,6,14,49,-6
548,56,73,9499,81,53,23,30,80,1
550,62,73,9499,82,48,16,32,56,7
551,65,73,9499,78,49,19,30,46,21
552,68,73,9499,48,28,9,19,48,-2
553,71,73,9499,79,56,23,33,52,-2
554,74,73,9499,78,45,15,30,72,15
555,77,73,9499,78,51,20,31,27,-7
556,80,75,9499,78,42,17,25,38,20
557,83,75,9499,26,16,6,10,14,-8
558,86,75,9499,58,33,14,19,28,15
559,53,74,9650,1,1,0,1,0,1
560,59,71,13406,2,1,1,0,0,1
561,65,79,13406,5,0,0,0,0,0
562,68,76,13406,45,17,7,10,32,-1
563,71,76,13406,70,18,8,10,34,-22
564,74,76,13406,18,8,2,6,0,-3
565,77,77,13406,5,1,1,0,7,0
567,2,89,21967,54,39,21,18,66,-17
568,5,89,21967,78,76,38,38,78,-10
569,8,85,21967,82,97,41,56,81,12
570,11,85,21967,66,57,28,29,73,10
571,14,85,21967,42,43,16,27,39,12
572,17,85,21967,64,43,22,21,99,14
573,20,81,21967,77,60,35,25,116,-11
574,23,81,21967,34,17,11,6,42,-14
575,23,68,21967,28,16,5,11,28,-2
576,26,68,21967,14,7,6,1,27,-1
580,11,70,52055,69,13,6,7,333,-8
581,14,70,52055,27,4,1,3,186,0
582,17,70,52055,34,7,3,4,168,4
583,17,88,52055,11,3,1,2,37,-9
460,59,73,9502,81,11,1,10,27,-13
461,62,73,9502,81,18,2,16,24,9
588,50,88,352383,44,19,5,14,14,-6
589,53,88,352383,82,53,22,31,36,-8
590,56,88,352383,62,37,14,23,16,1
591,56,71,352383,19,6,2,4,12,-7
592,59,71,352383,73,34,11,23,32,-35
593,62,66,352383,10,1,1,0,2,-1
594,62,69,352383,21,7,1,6,2,-1
596,47,76,9460,19,2,1,1,6,2
597,50,76,9460,1,0,0,0,0,-1
598,53,76,9460,16,0,0,0,8,-4
599,56,76,9460,6,1,0,1,2,-2
600,62,76,9460,15,3,2,1,10,-7
601,86,77,285721,15,2,1,1,2,0
602,47,75,8985,1,0,0,0,0,-1
603,50,75,8985,46,12,6,6,24,-7
604,53,75,8985,53,18,7,11,60,5
606,59,75,8985,76,14,7,7,61,-14
607,62,75,8985,38,8,5,3,63,-7
608,62,1479,8985,21,3,0,3,9,-6
609,62,84,8985,19,1,1,0,8,-1
610,65,84,8985,82,19,9,10,130,-3
611,68,84,8985,48,10,4,6,45,-6
612,71,78,8985,71,15,9,6,78,-3
613,74,78,8985,45,9,2,7,16,-2
614,74,79,8985,35,2,0,2,16,-13
615,2,63,32034,78,53,32,21,41,8
616,5,78,32034,78,44,20,24,41,2
617,8,65,32034,60,18,4,14,12,6
618,11,65,32034,9,3,0,3,0,0
619,47,74,11019,1,0,0,0,2,0
620,50,74,11019,2,0,0,0,7,1
621,62,64,11019,4,1,1,0,17,3
623,5,76,54467,11,1,1,0,23,-3
624,11,76,54467,39,4,0,4,122,3
625,14,76,54467,32,2,0,2,77,9
626,17,76,54467,14,1,0,1,40,-4
627,17,63,54467,35,7,2,5,88,-1
628,20,63,54467,57,3,0,3,171,-12
629,23,63,54467,2,0,0,0,0,-4
630,47,76,3206,1,0,0,0,0,0
631,50,78,11429,49,23,10,13,37,6
632,53,78,11429,72,31,13,18,99,-11
633,56,78,11429,82,54,31,23,165,-3
634,59,78,11429,79,48,17,31,106,-4
635,62,78,11429,82,62,31,31,93,32
636,65,78,11429,82,54,24,30,101,15
637,68,78,11429,48,28,6,22,62,5
638,71,78,11429,74,57,27,30,119,14
640,77,78,11429,79,45,21,24,83,4
641,80,63,11429,74,38,17,21,69,2
642,83,63,11429,57,33,14,19,53,2
643,86,63,11429,70,20,7,13,31,0
644,2,83,21491,63,34,18,16,152,-5
645,5,83,21491,43,40,19,21,123,-14
646,8,83,21491,66,39,17,22,193,2
647,11,83,21491,64,76,46,30,115,10
649,17,76,21491,58,43,24,19,60,-12
650,17,83,21491,13,15,8,7,16,7
651,20,83,21491,65,49,30,19,75,-2
652,23,83,21491,47,19,12,7,80,-21
653,26,81,21491,65,42,28,14,35,-25
654,26,85,21491,12,6,4,2,2,1
655,29,65,21491,13,2,2,0,13,-2
656,29,83,21491,20,4,2,2,21,-3
658,86,80,188843,30,12,4,8,6,3
659,53,79,9453,5,0,0,0,0,-2
660,2,83,53786,25,6,2,4,21,-5
661,5,83,53786,24,7,4,3,12,5
662,86,68,224661,1,0,0,0,0,1
666,56,77,9463,20,4,0,4,80,-2
667,59,77,9463,76,22,12,10,207,5
668,62,77,9463,57,6,4,2,127,-14
669,65,65,9463,28,11,2,9,82,10
670,68,65,9463,23,3,2,1,11,1
671,71,88,9463,26,2,1,1,57,-1
672,71,74,9463,31,3,3,0,43,0
673,74,65,9463,39,8,4,4,54,3
674,50,67,8945,19,7,3,4,4,4
675,53,67,8945,37,15,8,7,20,3
676,56,67,8945,71,31,17,14,56,-4
679,62,83,8945,82,62,21,41,37,-3
680,65,83,8945,73,43,20,23,37,3
681,68,83,8945,40,20,8,12,26,3
682,71,80,8945,79,55,24,31,78,12
683,74,80,8945,62,36,16,20,36,-6
684,77,80,8945,4,0,0,0,0,-1
685,80,80,8945,4,0,0,0,0,-1
686,50,65,9501,1,0,0,0,2,-1
687,53,65,9501,5,0,0,0,7,-2
688,56,65,9501,81,17,6,11,55,3
689,59,65,9501,70,19,7,12,44,6
690,62,71,9501,67,5,3,2,60,-2
691,65,88,9501,67,8,2,6,67,-2
692,68,88,9501,34,7,2,5,25,-4
693,71,88,9501,33,2,0,2,30,-4
694,74,78,9501,1,0,0,0,0,-1
696,50,71,9023,37,0,0,0,33,-11
697,53,71,9023,9,0,0,0,2,-3
698,56,71,9023,7,1,1,0,9,0
699,59,71,9023,49,11,4,7,78,-15
700,62,71,9023,51,5,4,1,63,-6
701,65,1479,9023,6,0,0,0,12,2
702,59,69,11769,2,0,0,0,0,-1
703,53,75,11722,33,7,1,6,45,7
704,56,75,11722,37,5,0,5,58,-7
705,59,75,11722,55,4,1,3,74,-3
706,62,75,11722,3,0,0,0,4,0
707,62,64,11722,64,10,0,10,71,-7
708,65,64,11722,74,7,1,6,57,-5
709,68,64,11722,34,4,1,3,54,-8
585,20,74,52055,45,1,0,1,106,-10
586,86,67,248397,4,0,0,0,0,-5
714,53,77,8679,14,4,1,3,27,5
715,77,79,105883,3,1,0,1,0,0
716,80,79,105883,2,1,0,1,0,-1
717,83,79,105883,33,12,4,8,16,2
718,86,79,105883,71,28,8,20,18,8
719,83,80,166433,2,0,0,0,0,0
720,86,80,166433,61,10,1,9,27,-14
721,47,77,6665,6,0,0,0,4,-2
722,50,77,6665,62,22,3,19,17,-19
723,53,77,6665,4,0,0,0,2,-3
724,53,81,6665,20,6,3,3,8,-9
725,56,80,6665,47,14,6,8,8,-2
726,59,80,6665,45,15,4,11,20,-2
727,59,66,6665,9,0,0,0,6,2
728,62,75,6665,43,8,3,5,17,0
729,65,79,6665,17,4,0,4,4,4
731,47,77,8845,2,1,0,1,0,1
732,50,77,8845,35,12,7,5,22,1
733,53,77,8845,7,1,0,1,4,0
734,56,71,8845,8,3,0,3,0,2
735,59,71,8845,64,32,15,17,28,-21
736,62,65,8845,3,0,0,0,0,-1
737,62,80,8845,7,0,0,0,0,0
738,53,84,11878,1,0,0,0,0,0
739,83,84,203412,5,0,0,0,0,2
740,86,84,203412,56,12,5,7,18,-8
741,83,1479,234104,2,0,0,0,0,0
742,86,1479,234104,32,13,4,9,2,8
743,56,73,12393,2,0,0,0,0,0
744,59,73,12393,20,2,0,2,4,4
745,62,73,12393,31,4,1,3,14,-5
746,62,68,12393,9,1,0,1,0,-3
748,65,67,12393,15,8,3,5,6,2
749,68,67,12393,17,4,3,1,10,3
750,71,67,12393,25,2,0,2,8,-3
751,50,71,11007,29,1,1,0,105,-7
752,53,71,11007,66,12,3,9,201,3
753,56,71,11007,52,11,6,5,181,-3
754,59,71,11007,77,13,4,9,155,3
755,62,71,11007,32,4,0,4,76,-2
756,65,73,11007,1,0,0,0,7,0
757,86,72,204182,51,13,5,8,31,-14
758,2,79,21323,76,93,24,69,128,-18
759,5,79,21323,54,64,10,54,62,4
760,5,88,21323,10,5,1,4,25,-3
761,8,88,21323,50,57,8,49,50,9
762,8,85,21323,30,30,4,26,27,7
763,11,85,21323,80,77,14,63,106,28
765,17,85,21323,76,74,14,60,90,19
767,20,77,21323,37,26,6,20,20,11
768,23,77,21323,57,29,2,27,30,3
769,26,65,21323,10,4,0,4,0,-6
770,26,66,21323,44,10,2,8,28,-1
771,29,66,21323,69,40,11,29,40,-6
772,32,63,21323,18,4,0,4,30,-6
773,56,64,11561,8,0,0,0,4,-1
774,59,64,11561,4,1,0,1,2,1
775,62,64,11561,74,17,6,11,40,-4
776,65,83,11561,30,0,0,0,16,-2
777,50,68,11009,3,1,0,1,0,2
778,53,68,11009,2,0,0,0,0,-1
779,50,71,8368,39,9,1,8,20,-6
780,53,82,8368,81,13,0,13,61,20
781,56,82,8368,82,21,3,18,38,23
783,62,82,8368,77,20,5,15,28,-6
784,65,64,8368,81,19,5,14,24,-17
785,68,64,8368,46,10,1,9,28,-3
786,71,64,8368,78,17,6,11,40,8
787,74,64,8368,81,13,1,12,42,-12
788,56,63,14038,35,7,4,3,18,0
789,59,63,14038,45,9,4,5,31,-9
790,59,68,14038,7,2,1,1,2,1
791,65,84,14038,10,4,1,3,14,2
792,2,78,42512,2,1,1,0,15,1
793,5,78,42512,46,3,1,2,264,-6
794,8,78,42512,49,7,2,5,204,-9
795,11,78,42512,68,7,2,5,278,-5
799,20,83,42512,2,0,0,0,27,0
800,23,78,42512,67,7,4,3,231,10
801,26,78,42512,45,10,3,7,143,2
803,2,88,73573,3,1,0,1,10,1
804,5,88,73573,16,1,0,1,10,0
805,8,88,73573,13,0,0,0,12,-6
808,8,81,31352,67,27,12,15,23,-2
809,11,81,31352,81,43,20,23,32,7
810,14,81,31352,26,6,3,3,6,-1
811,14,72,31352,12,3,1,2,8,0
812,17,76,31352,10,1,1,0,0,0
813,17,65,31352,2,0,0,0,0,0
814,68,63,9462,2,0,0,0,0,0
815,2,72,250333,49,16,5,11,27,9
816,5,72,250333,44,10,7,3,16,0
817,8,88,250333,81,17,9,8,20,-16
818,11,88,250333,77,28,15,13,71,0
819,14,88,250333,48,16,7,9,12,-9
820,17,88,250333,35,7,5,2,18,-8
822,17,76,250333,13,2,1,1,0,-4
823,53,75,10309,1,0,0,0,0,-1
824,59,74,10309,3,0,0,0,0,1
825,62,80,10309,5,1,0,1,0,-1
826,86,547,266970,36,10,3,7,4,9
827,59,84,339489,1,0,0,0,2,0
828,62,84,339489,12,0,0,0,10,-3
829,65,62,339489,10,0,0,0,25,-1
830,2,72,70045,45,25,8,17,8,3
831,5,72,70045,20,11,6,5,10,-2
832,8,72,70045,27,12,4,8,2,-8
833,8,71,70045,37,24,9,15,6,-5
834,11,71,70045,84,57,22,35,8,-11
835,14,71,70045,5,4,2,2,0,-1
711,86,87,177259,47,18,13,5,12,1
712,47,77,8679,1,0,0,0,2,0
845,56,74,9401,5,2,1,1,0,-1
846,59,74,9401,3,0,0,0,2,0
847,62,79,9401,1,0,0,0,0,0
848,65,71,9401,62,21,4,17,24,-16
849,68,71,9401,33,4,3,1,6,8
850,71,71,9401,16,5,0,5,21,0
851,71,63,9401,3,0,0,0,0,-1
852,74,62,9401,6,0,0,0,0,-1
853,77,73,9401,1,0,0,0,0,0
854,80,82,47288,66,7,2,5,6,7
855,83,82,47288,61,23,7,16,14,13
856,86,82,47288,80,21,5,16,6,3
857,29,80,31434,1,0,0,0,0,0
858,56,84,9467,7,1,0,1,4,1
859,59,84,9467,15,0,0,0,13,-3
860,62,84,9467,24,4,2,2,21,1
864,86,88,8922,25,6,2,4,8,-1
865,83,547,92562,1,1,1,0,0,0
866,86,547,92562,30,4,1,3,2,0
867,47,85,10362,1,0,0,0,0,0
868,50,85,10362,6,1,1,0,0,0
869,53,85,10362,6,0,0,0,4,-3
870,56,88,10362,72,38,4,34,63,-5
871,59,64,10362,79,29,6,23,76,9
872,62,64,10362,21,1,0,1,18,-5
873,65,64,10362,54,23,5,18,60,-1
874,65,85,10362,18,3,2,1,29,0
875,68,85,10362,36,3,1,2,18,7
876,71,85,10362,82,13,4,9,88,-5
877,74,85,10362,73,18,3,15,77,10
878,77,85,10362,47,11,4,7,36,1
879,80,72,10362,53,12,4,8,39,4
881,83,69,10362,18,3,0,3,28,-4
882,32,82,8720,1,0,0,0,10,0
883,35,82,8720,52,6,3,3,206,1
884,38,82,8720,68,5,1,4,249,-5
885,41,82,8720,76,6,3,3,228,-10
886,47,82,8720,80,10,3,7,163,-4
887,50,82,8720,72,2,1,1,125,-6
888,53,82,8720,31,0,0,0,44,-2
889,53,86,8720,31,7,1,6,91,-2
890,56,86,8720,70,4,2,2,116,-6
891,59,86,8720,36,3,0,3,78,1
892,59,74,8720,21,6,2,4,37,4
893,62,77,8720,58,4,2,2,127,0
894,65,77,8720,30,1,0,1,64,-6
895,68,77,8720,1,0,0,0,0,0
896,56,78,15415,30,3,0,3,39,8
898,62,78,15415,29,1,0,1,39,-10
899,65,68,15415,15,3,1,2,5,1
900,68,68,15415,38,4,0,4,40,-13
901,71,89,15415,18,2,0,2,28,-2
902,74,67,15415,46,5,0,5,44,-30
903,77,69,15415,2,0,0,0,0,1
904,53,74,9398,6,0,0,0,0,-2
905,59,82,9398,4,0,0,0,0,0
906,77,79,17760,32,2,0,2,20,-3
907,77,87,17760,13,1,0,1,4,0
910,62,79,9405,7,5,3,2,16,1
911,65,78,9405,4,0,0,0,0,-1
914,8,86,70169,20,10,3,7,0,-7
917,47,78,10197,57,27,14,13,22,-10
918,50,78,10197,82,52,27,25,33,-2
919,53,78,10197,80,38,13,25,40,0
921,56,83,10197,61,31,11,20,31,-9
922,59,83,10197,62,30,14,16,18,-10
925,65,62,10197,61,28,14,14,16,-2
926,68,62,10197,47,32,9,23,12,2
927,71,62,10197,52,23,8,15,28,-21
928,71,79,10197,21,11,4,7,4,5
929,74,74,10197,53,18,9,9,18,7
930,74,547,10197,18,10,6,4,2,1
931,77,72,10197,63,41,16,25,34,3
932,77,63,10197,19,10,3,7,4,1
933,80,66,10197,82,40,16,24,32,2
934,83,66,10197,37,9,3,6,4,-8
935,86,63,10197,2,0,0,0,0,-1
936,5,67,31276,20,6,2,4,21,-9
937,8,67,31276,68,10,6,4,38,-3
938,11,1479,31276,76,51,23,28,18,4
940,17,1479,31276,48,12,5,7,26,0
941,17,77,31276,28,7,4,3,8,3
945,29,88,31276,45,11,5,6,14,0
946,32,88,31276,58,10,4,6,18,-12
947,32,72,31276,17,4,3,1,4,4
949,35,67,31276,10,1,0,1,4,-2
950,50,74,9497,8,1,1,0,0,-4
951,53,74,9497,61,29,14,15,10,11
952,56,74,9497,52,19,10,9,15,-2
954,59,62,9497,66,32,14,18,18,1
956,62,75,9497,4,0,0,0,0,0
957,41,65,2713,10,1,0,1,4,-2
958,50,65,2713,54,14,5,9,30,5
959,50,77,2713,20,0,0,0,8,-1
960,53,77,2713,53,5,1,4,38,3
961,56,77,2713,22,2,0,2,10,-2
963,5,75,21892,64,53,17,36,118,15
964,8,71,21892,80,47,16,31,209,-19
965,11,71,21892,64,54,25,29,118,-8
966,14,71,21892,48,36,12,24,86,-17
967,17,78,21892,77,46,18,28,192,3
968,20,78,21892,11,3,2,1,24,-4
969,20,75,21892,47,21,6,15,80,-5
970,23,75,21892,62,55,21,34,108,2
971,26,75,21892,63,32,12,20,147,-10
972,29,75,21892,70,28,8,20,115,-2
973,32,83,21892,77,26,8,18,189,1
974,35,83,21892,74,33,12,21,120,11
975,38,83,21892,46,15,7,8,49,-5
976,41,70,21892,17,10,5,5,29,12
837,35,74,70045,29,13,6,7,16,-3
838,35,81,70045,27,12,6,6,10,-12
981,65,74,11481,63,16,5,11,8,10
982,68,64,11481,47,20,10,10,18,5
983,71,64,11481,75,32,11,21,36,13
984,74,64,11481,68,26,11,15,32,-9
985,77,64,11481,71,21,10,11,52,-7
986,80,64,11481,65,7,3,4,45,-12
987,2,75,105281,28,6,0,6,26,8
988,5,75,105281,13,3,0,3,22,7
989,8,81,105281,2,0,0,0,0,-1
991,47,64,10207,41,13,3,10,12,0
992,50,64,10207,73,22,14,8,28,4
993,53,64,10207,22,5,2,3,8,-3
994,56,88,10207,31,5,0,5,11,-6
995,59,88,10207,81,27,11,16,37,1
996,62,88,10207,68,19,7,12,47,-13
997,65,88,10207,59,8,5,3,30,-6
999,71,84,10207,73,23,11,12,39,1
1000,74,84,10207,45,21,8,13,34,0
1001,77,87,10207,82,31,11,20,46,8
1002,80,87,10207,16,9,5,4,15,-1
1003,83,87,10207,76,15,3,12,45,-24
1004,86,87,10207,66,27,19,8,22,6
1006,5,89,231486,78,40,11,29,31,7
1007,8,89,231486,77,50,21,29,34,28
1008,11,89,231486,84,51,16,35,66,30
1009,14,89,231486,47,19,5,14,53,2
1010,17,89,231486,81,38,5,33,40,5
1011,20,89,231486,57,24,6,18,28,11
1012,23,89,231486,59,16,1,15,36,-5
1013,23,83,231486,12,9,3,6,6,2
1014,26,83,231486,79,29,5,24,28,22
1015,29,83,231486,3,1,0,1,0,1
1017,29,70,231486,28,10,2,8,14,6
1018,32,89,231486,68,18,7,11,18,-3
1019,35,89,231486,70,14,3,11,26,-15
1020,38,89,231486,1,0,0,0,4,0
1021,86,82,234927,2,0,0,0,0,0
1022,50,82,10988,20,4,0,4,12,5
1023,53,82,10988,9,0,0,0,8,-1
1024,56,82,10988,66,17,4,13,55,7
1025,59,82,10988,60,8,2,6,51,-8
1026,62,82,10988,74,15,0,15,58,2
1027,65,82,10988,46,7,1,6,24,-11
1028,68,80,10988,47,11,2,9,31,2
1029,71,80,10988,75,23,6,17,28,0
1030,74,80,10988,45,11,1,10,18,22
1031,77,80,10988,69,12,5,7,34,12
1032,80,80,10988,68,12,0,12,24,13
1034,86,70,10988,9,0,0,0,6,-3
1035,41,88,2708,57,11,3,8,12,-9
1036,77,75,46053,3,0,0,0,0,1
1037,80,75,46053,7,0,0,0,4,-3
1038,47,76,10220,27,7,3,4,8,-1
1039,50,76,10220,51,6,0,6,28,-10
1040,53,76,10220,60,13,0,13,34,-5
1041,56,76,10220,69,19,3,16,33,-15
1042,59,76,10220,71,17,3,14,31,-15
1043,62,76,10220,53,6,0,6,30,-14
1044,65,81,10220,50,13,6,7,8,-4
1045,68,77,10220,37,6,1,5,10,-17
1046,50,63,10262,4,0,0,0,0,0
1047,56,76,10262,43,4,2,2,49,-11
1048,59,76,10262,39,6,1,5,39,-14
1049,59,81,10262,32,4,1,3,17,-3
1051,65,81,10262,68,15,9,6,21,-23
1052,68,81,10262,45,15,7,8,17,-2
1053,71,81,10262,81,16,9,7,27,3
1054,74,1479,10262,80,18,5,13,39,0
1055,77,1479,10262,49,6,3,3,47,-1
1056,80,1479,10262,30,2,1,1,14,4
1057,83,80,10262,43,11,4,7,10,0
1058,83,88,10262,26,6,1,5,10,-1
1059,86,88,10262,53,6,4,2,17,3
1060,86,75,10262,25,7,1,6,0,-4
1061,2,88,73584,3,1,0,1,0,0
1062,5,88,73584,14,4,3,1,2,-3
1063,59,70,13993,5,0,0,0,5,0
1064,62,70,13993,3,0,0,0,0,-2
1065,65,70,13993,1,0,0,0,0,0
1066,68,70,13993,1,0,0,0,0,0
1068,56,1479,11404,27,10,4,6,17,0
1069,59,81,11404,14,0,0,0,2,-3
1070,59,85,11404,66,19,10,9,10,5
1071,62,85,11404,67,18,10,8,13,-2
1072,65,85,11404,80,25,14,11,20,6
1073,68,85,11404,44,8,4,4,2,-8
1074,71,85,11404,82,15,7,8,21,-11
1075,74,85,11404,82,13,5,8,25,-3
1076,77,85,11404,28,2,1,1,2,-5
1077,80,85,11404,55,7,5,2,18,-12
1078,59,76,10394,6,1,0,1,0,-4
1079,65,547,10394,33,7,3,4,10,-1
1080,2,78,27951,66,57,27,30,56,19
1081,2,84,27951,11,8,6,2,8,-3
1082,5,84,27951,70,57,23,34,116,-6
1083,8,84,27951,84,77,31,46,167,27
1085,14,84,27951,45,34,16,18,81,2
1086,17,78,27951,69,40,24,16,101,-9
1087,20,78,27951,82,57,17,40,86,3
1088,23,78,27951,79,62,31,31,94,12
1089,26,78,27951,24,12,5,7,28,2
1090,29,78,27951,6,4,2,2,6,3
1091,2,75,22367,79,76,26,50,29,5
1092,5,75,22367,27,21,7,14,6,6
1094,11,70,22367,84,80,23,57,59,6
1095,14,70,22367,32,17,7,10,13,-8
1096,14,84,22367,13,18,4,14,4,10
1097,17,84,22367,81,65,26,39,40,25
1098,20,84,22367,47,28,9,19,24,4
1099,20,74,22367,14,7,2,5,2,-3
978,56,83,11481,76,29,12,17,33,-16
979,59,83,11481,60,23,6,17,31,-7
1104,5,86,76693,10,2,2,0,19,-4
1105,62,69,12920,2,0,0,0,4,-2
1109,11,70,11575,72,37,13,24,139,-14
1110,14,83,11575,37,10,5,5,12,-21
1111,17,83,11575,70,20,8,12,42,-8
1112,20,83,11575,65,20,7,13,62,-20
1113,26,86,11575,1,0,0,0,0,-1
1114,35,86,11575,2,0,0,0,2,0
1115,32,64,11552,2,0,0,0,0,-2
1116,2,77,31538,77,66,19,47,53,-2
1117,5,77,31538,12,6,3,3,8,2
1120,8,84,31538,10,10,0,10,12,3
1121,11,84,31538,78,55,15,40,30,5
1122,14,65,31538,16,7,4,3,2,2
1123,17,65,31538,66,47,18,29,36,20
1124,20,65,31538,75,35,8,27,12,0
1126,26,86,31538,43,14,4,10,18,-3
1127,29,86,31538,19,2,0,2,4,-2
1128,50,86,10367,46,28,14,14,18,4
1129,53,86,10367,82,40,19,21,28,1
1130,56,86,10367,80,59,25,34,46,5
1131,59,86,10367,67,51,25,26,26,1
1132,62,86,10367,74,66,20,46,24,10
1133,65,86,10367,82,61,31,30,31,18
1134,68,86,10367,48,31,16,15,10,2
1135,71,86,10367,82,79,41,38,32,23
1136,74,86,10367,82,70,37,33,29,12
1137,77,86,10367,82,78,38,40,30,25
1138,80,86,10367,81,68,29,39,34,11
1139,83,86,10367,82,66,22,44,41,0
1140,86,86,10367,75,64,38,26,22,-4
1141,59,76,13407,19,4,2,2,14,4
1143,65,76,13407,28,7,1,6,11,0
1144,68,79,13407,3,0,0,0,0,0
1145,74,87,13407,1,0,0,0,0,-1
1146,5,63,68032,19,3,2,1,9,-6
1147,2,65,70332,72,51,22,29,135,0
1148,5,65,70332,11,12,6,6,16,-1
1149,5,76,70332,66,24,15,9,102,-4
1150,8,81,70332,83,39,19,20,110,-19
1151,11,81,70332,53,20,10,10,37,-7
1152,14,78,70332,48,34,14,20,74,17
1153,17,78,70332,61,21,11,10,78,0
1154,20,65,70332,19,3,1,2,13,-2
1155,47,71,9093,10,0,0,0,4,-4
1156,50,71,9093,6,1,1,0,2,0
1157,53,71,9093,80,31,14,17,33,-6
1158,56,71,9093,79,27,11,16,21,4
1160,62,69,9093,80,37,16,21,56,-4
1161,65,69,9093,82,44,22,22,66,-15
1162,68,69,9093,48,12,8,4,20,-18
1163,71,69,9093,81,24,8,16,61,0
1164,74,69,9093,73,20,9,11,47,-6
1165,77,78,9093,76,11,7,4,37,-1
1166,80,78,9093,69,15,8,7,27,2
1167,83,78,9093,81,33,10,23,33,13
1168,86,71,9093,70,9,6,3,33,-14
1169,47,71,12150,1,0,0,0,0,-1
1170,50,71,12150,16,2,2,0,30,-7
1171,53,71,12150,13,1,0,1,27,0
1172,59,82,12150,31,10,0,10,17,-2
1173,62,81,12150,4,0,0,0,2,-2
1174,68,81,12150,1,0,0,0,0,-1
1175,47,83,11169,1,1,1,0,0,0
1177,53,83,11169,18,2,2,0,4,-3
1178,56,83,11169,11,7,5,2,2,2
1179,62,74,11169,1,0,0,0,0,0
1180,2,76,70264,16,7,1,6,12,-4
1182,2,85,70264,17,7,3,4,17,-6
1183,5,85,70264,26,8,0,8,14,8
1184,8,81,70264,40,29,8,21,18,-4
1185,8,78,70264,19,9,2,7,10,-3
1186,11,78,70264,50,9,2,7,10,1
1187,59,83,8925,15,2,1,1,67,-2
1188,62,83,8925,26,3,1,2,71,-6
1189,65,83,8925,31,0,0,0,60,-4
1190,68,77,8925,11,1,1,0,64,-4
1191,71,77,8925,34,2,2,0,90,-8
1194,8,77,64641,35,3,2,1,37,0
1195,11,86,64641,34,2,0,2,76,2
1197,53,66,11716,6,1,1,0,2,1
1198,35,81,24649,4,0,0,0,5,-2
1199,2,71,72806,5,0,0,0,0,0
1200,5,71,72806,7,1,1,0,0,-1
1201,8,71,72806,5,0,0,0,4,-4
1202,11,88,72806,5,2,1,1,0,-1
1203,2,79,22122,65,94,31,63,83,0
1207,8,83,22122,47,41,13,28,53,-8
1208,11,83,22122,53,30,13,17,67,-2
1209,14,79,22122,46,37,13,24,66,-4
1210,17,81,22122,76,50,16,34,65,1
1211,20,81,22122,70,55,18,37,95,-14
1212,26,81,22122,4,0,0,0,2,-2
1213,2,72,72256,59,9,6,3,182,-10
1214,5,85,72256,7,0,0,0,35,0
1215,14,88,72256,29,3,1,2,99,0
1217,20,84,72256,30,3,1,2,52,-6
1222,65,547,690,62,33,6,27,38,6
1223,68,547,690,22,15,4,11,8,-8
1224,71,547,690,82,30,10,20,56,-9
1225,74,547,690,60,23,4,19,36,13
1226,77,547,690,72,16,2,14,44,8
1227,80,547,690,60,14,1,13,42,-7
1228,83,547,690,43,6,1,5,20,8
1229,86,77,223572,21,2,1,1,2,-5
1230,47,65,10663,25,5,3,2,24,-6
1231,50,65,10663,9,3,1,2,10,-2
1232,53,65,10663,67,36,19,17,59,-7
1233,56,65,10663,77,31,15,16,81,7
1234,59,65,10663,82,34,17,17,94,-7
1101,26,88,22367,57,19,6,13,19,-9
1102,47,81,8937,5,0,0,0,2,0
1240,77,547,10663,81,53,19,34,119,4
1241,80,547,10663,80,52,13,39,117,10
1242,83,547,10663,69,45,8,37,112,15
1243,86,547,10663,42,31,4,27,69,4
1248,11,65,26568,16,7,4,3,13,1
1249,14,80,26568,48,10,5,5,68,-19
1250,17,80,26568,81,36,17,19,130,-31
1251,20,80,26568,76,36,12,24,99,-7
1252,23,80,26568,71,13,2,11,63,-14
1253,26,67,26568,14,4,2,2,0,1
1254,50,86,10211,81,26,3,23,18,13
1255,53,86,10211,82,14,2,12,24,-12
1256,56,86,10211,82,36,6,30,42,15
1257,59,86,10211,64,16,3,13,33,21
1258,62,86,10211,80,18,4,14,18,14
1259,65,86,10211,82,23,4,19,40,11
1261,71,86,10211,81,24,5,19,38,31
1262,74,86,10211,70,23,9,14,23,12
1263,77,86,10211,67,39,8,31,48,15
1264,80,86,10211,75,28,6,22,35,4
1265,83,86,10211,81,32,11,21,34,9
1266,86,86,10211,72,25,3,22,10,-6
1267,2,83,49113,4,0,0,0,7,-2
1268,2,67,49113,17,1,0,1,43,-3
1269,5,67,49113,3,0,0,0,14,0
1270,11,89,49113,26,1,1,0,61,-2
1271,50,1479,10221,62,14,2,12,140,5
1272,50,81,10221,18,2,0,2,36,-8
1273,53,81,10221,77,21,4,17,154,-2
1274,56,81,10221,1,0,0,0,0,-1
1275,56,84,10221,76,10,0,10,196,6
1276,59,84,10221,65,8,2,6,79,15
1278,65,64,10221,76,20,3,17,105,2
1279,68,64,10221,28,4,0,4,60,0
1280,71,62,10221,45,3,0,3,58,-8
1281,74,68,10221,9,1,0,1,5,-4
1282,20,83,71011,5,0,0,0,10,0
1283,65,82,14076,1,0,0,0,0,0
1284,50,84,10350,1,0,0,0,7,-3
1285,53,84,10350,17,0,0,0,52,-8
1286,56,1479,10350,18,1,0,1,36,2
1287,5,78,27217,9,4,1,3,4,5
1288,8,78,27217,54,12,6,6,55,-3
1289,11,78,27217,80,25,9,16,42,4
1290,14,78,27217,1,0,0,0,0,0
1291,47,89,11553,1,0,0,0,0,0
1292,53,88,9731,22,9,5,4,4,2
1293,56,88,9731,7,1,1,0,2,-4
1295,62,76,9731,82,53,31,22,24,-10
1296,65,76,9731,82,69,36,33,6,1
1297,68,76,9731,47,44,15,29,4,-3
1298,71,76,9731,11,9,6,3,6,3
1299,71,67,9731,44,29,11,18,20,-8
1300,71,69,9731,20,13,6,7,8,7
1301,74,67,9731,77,41,13,28,4,-11
1302,77,67,9731,81,21,8,13,16,-5
1303,80,67,9731,81,32,14,18,10,-4
1304,83,67,9731,14,0,0,0,2,-9
1305,53,68,14081,41,2,1,1,39,-5
1306,56,68,14081,3,0,0,0,7,0
1307,59,84,14081,67,11,4,7,115,5
1308,62,84,14081,73,10,3,7,72,-5
1309,65,547,14081,78,16,5,11,73,-12
1310,68,79,14081,48,2,1,1,62,-11
1312,74,74,14081,66,6,1,5,98,-12
1313,77,74,14081,57,7,4,3,66,-3
1314,80,74,14081,11,2,1,1,17,0
1315,83,62,14081,16,0,0,0,19,-4
1316,2,84,26050,62,32,15,17,22,-6
1317,5,86,26050,58,16,8,8,27,-30
1318,2,75,27901,51,19,3,16,31,-2
1319,5,75,27901,79,18,4,14,36,16
1320,8,75,27901,66,18,8,10,57,25
1321,11,75,27901,68,14,2,12,73,16
1322,14,75,27901,45,8,3,5,40,2
1323,17,75,27901,7,1,0,1,6,0
1324,17,78,27901,37,4,1,3,24,-6
1325,17,79,27901,13,6,3,3,23,0
1326,20,79,27901,53,17,3,14,36,-5
1327,20,1479,27901,13,11,2,9,22,5
1329,23,76,27901,18,6,0,6,21,1
1330,26,73,27901,35,4,2,2,38,-4
1333,32,69,27901,1,0,0,0,2,-1
1334,2,79,31452,22,3,1,2,30,0
1337,8,62,31452,74,10,3,7,66,0
1338,11,62,31452,77,12,1,11,52,5
1339,14,80,31452,46,8,1,7,36,-30
1340,17,80,31452,24,2,1,1,14,-7
1341,2,76,31700,41,15,3,12,24,-10
1342,5,76,31700,15,3,2,1,12,-8
1343,8,76,31700,57,32,15,17,62,17
1344,11,76,31700,73,30,11,19,62,14
1345,14,76,31700,22,5,3,2,14,-8
1346,17,76,31700,18,3,1,2,14,-2
1347,56,1479,11719,4,0,0,0,0,0
1348,59,1479,11719,44,7,5,2,80,-8
1350,62,66,11719,50,3,1,2,54,-4
1351,71,83,11719,47,10,3,7,26,6
1352,74,83,11719,5,0,0,0,5,0
1356,11,70,9806,65,57,19,38,10,-1
1357,11,86,9806,13,12,6,6,0,0
1358,14,86,9806,46,34,11,23,11,-2
1359,17,86,9806,59,28,16,12,27,-21
1360,20,86,9806,43,19,8,11,8,-11
1361,20,65,9806,30,14,6,8,10,9
1362,29,89,9806,75,38,15,23,8,11
1363,32,89,9806,73,48,15,33,6,11
1364,35,89,9806,69,52,23,29,8,-5
1365,38,70,9806,63,37,17,20,14,11
1366,5,77,74590,2,0,0,0,5,0
1237,68,547,10663,43,28,8,20,34,-1
1238,71,547,10663,78,56,20,36,86,-20
1371,71,78,14128,22,1,0,1,0,-3
1372,74,78,14128,24,2,1,1,6,-3
1373,77,69,14128,61,7,4,3,6,-6
1374,83,62,76427,7,1,0,1,15,0
1375,86,62,76427,4,0,0,0,17,0
1376,47,81,8840,12,1,0,1,4,-3
1377,50,81,8840,77,9,5,4,80,-6
1378,53,81,8840,80,10,6,4,78,-15
1379,56,73,8840,11,1,0,1,17,1
1380,56,68,8840,34,6,1,5,33,-2
1381,59,68,8840,31,3,1,2,85,-5
1382,53,64,11417,27,6,2,4,8,-5
1383,56,64,11417,40,13,8,5,8,-8
1384,59,64,11417,23,16,10,6,2,1
1385,62,64,11417,77,45,27,18,28,-2
1386,65,64,11417,72,37,20,17,32,-8
1388,71,62,11417,48,17,9,8,10,1
1389,74,62,11417,67,30,14,16,18,-3
1390,77,62,11417,59,15,9,6,10,-8
1391,77,69,11417,16,3,2,1,0,1
1392,2,83,21509,79,73,26,47,65,-31
1393,5,71,21509,80,89,38,51,53,10
1394,8,75,21509,84,97,39,58,98,5
1395,11,75,21509,84,91,40,51,75,0
1396,14,75,21509,48,40,10,30,42,15
1397,17,75,21509,80,94,38,56,158,5
1398,20,75,21509,82,81,27,54,82,-6
1399,23,75,21509,76,59,18,41,58,14
1400,26,75,21509,65,36,12,24,46,-7
1401,26,86,21509,12,13,7,6,4,3
1402,29,86,21509,82,70,21,49,58,4
1403,32,86,21509,45,46,9,37,62,17
1405,38,86,21509,82,61,23,38,66,-13
1406,41,86,21509,82,41,12,29,66,-5
1407,2,79,64822,11,2,0,2,2,0
1408,5,79,64822,2,0,0,0,0,0
1409,8,79,64822,58,9,5,4,14,-5
1410,11,79,64822,63,8,3,5,20,-1
1411,11,68,64822,7,0,0,0,0,0
1412,14,68,64822,3,0,0,0,0,0
1414,23,66,64822,2,0,0,0,0,0
1415,26,73,64822,9,4,1,3,2,-1
1416,29,66,64822,69,7,3,4,10,-8
1417,32,66,64822,67,2,1,1,15,-3
1418,35,66,64822,65,5,4,1,12,-6
1419,38,66,64822,59,4,0,4,8,-9
1420,47,82,9466,15,5,0,5,16,-4
1421,50,82,9466,26,9,4,5,10,1
1423,2,72,31983,80,20,4,16,249,-10
1424,5,72,31983,80,8,1,7,170,7
1425,8,72,31983,84,13,2,11,236,4
1426,11,72,31983,78,10,1,9,176,27
1427,14,72,31983,25,3,1,2,54,4
1428,17,72,31983,80,6,2,4,115,-10
1429,20,72,31983,77,9,2,7,70,24
1430,23,72,31983,37,1,0,1,57,3
1431,26,72,31983,82,11,2,9,63,27
1432,29,72,31983,78,6,0,6,98,13
1433,32,72,31983,77,4,0,4,87,8
1434,35,72,31983,67,6,0,6,60,2
1435,38,72,31983,69,9,2,7,33,6
1436,59,69,11359,8,2,0,2,12,1
1437,62,69,11359,57,9,2,7,96,5
1438,65,69,11359,51,5,1,4,62,3
1440,71,69,11359,63,5,1,4,84,-6
1441,74,1479,11359,69,8,1,7,68,-2
1442,77,1479,11359,50,6,1,5,67,4
1443,80,1479,11359,14,3,1,2,28,0
1444,56,71,14039,22,2,2,0,40,-2
1445,59,71,14039,4,0,0,0,7,0
1446,59,68,14039,18,1,0,1,17,-3
1447,62,71,14039,34,1,0,1,93,-1
1448,65,79,14039,12,0,0,0,6,0
1449,68,79,14039,1,0,0,0,12,0
1450,50,77,10298,8,1,0,1,10,-1
1451,59,73,10298,3,0,0,0,9,-1
1452,41,77,10317,5,0,0,0,0,1
1453,47,77,10317,28,8,0,8,16,-6
1454,50,77,10317,66,22,4,18,38,-14
1455,53,77,10317,71,31,5,26,58,8
1457,59,88,10317,48,21,5,16,28,-3
1458,62,81,10317,61,13,1,12,15,-4
1459,65,547,10317,39,2,1,1,8,4
1460,50,72,11016,7,4,3,1,6,-1
1461,53,72,11016,81,22,9,13,183,1
1462,56,72,11016,82,32,17,15,164,-1
1463,59,72,11016,46,24,11,13,85,3
1464,62,72,11016,82,18,12,6,116,-20
1465,65,72,11016,80,46,30,16,138,-8
1466,68,72,11016,48,24,15,9,78,-6
1467,71,83,11016,60,11,5,6,93,-14
1468,74,83,11016,58,15,10,5,92,-11
1469,74,82,11016,3,0,0,0,14,-1
1470,77,82,11016,23,4,2,2,23,-8
1472,2,83,70461,38,22,10,12,30,-4
1473,5,83,70461,54,19,8,11,39,-3
1477,11,79,72168,7,1,1,0,5,1
1478,50,84,9468,7,1,0,1,4,-6
1479,2,78,53932,41,4,1,3,100,2
1480,2,84,53932,11,1,1,0,20,-7
1481,5,84,53932,72,9,2,7,126,6
1482,8,84,53932,69,12,4,8,150,25
1483,11,84,53932,65,5,2,3,105,18
1484,11,65,53932,6,0,0,0,26,0
1485,14,1479,53932,38,4,1,3,56,-3
1486,17,1479,53932,44,3,1,2,42,8
1487,17,75,53932,3,0,0,0,6,0
1488,47,62,9154,7,1,0,1,8,2
1489,50,62,9154,48,15,7,8,36,7
1490,56,62,9154,58,19,2,17,59,2
1368,62,78,14128,45,7,3,4,16,-4
1369,65,78,14128,47,7,4,3,11,-1
1495,71,62,9154,64,47,14,33,63,12
1496,74,62,9154,61,48,11,37,37,13
1497,77,62,9154,82,56,21,35,54,-5
1498,80,62,9154,81,39,12,27,59,22
1499,83,62,9154,82,38,13,25,63,0
1500,86,62,9154,78,74,17,57,69,39
1501,50,68,10366,16,2,2,0,2,-3
1502,53,68,10366,6,1,0,1,2,1
1503,59,63,10366,4,0,0,0,0,-1
1504,2,75,76440,62,25,7,18,27,7
1505,5,75,76440,77,38,6,32,50,17
1506,8,75,76440,82,45,13,32,98,20
1507,11,75,76440,84,35,12,23,97,-1
1508,14,75,76440,9,6,0,6,2,2
1509,14,77,76440,34,23,5,18,12,10
1510,17,77,76440,80,47,7,40,45,19
1512,23,77,76440,77,33,6,27,36,11
1513,26,77,76440,68,51,15,36,38,18
1514,29,77,76440,81,55,14,41,32,20
1515,32,77,76440,79,48,15,33,50,-3
1516,35,77,76440,65,25,6,19,24,-1
1517,38,77,76440,79,32,8,24,35,30
1518,41,77,76440,48,12,1,11,28,11
1519,47,77,76440,45,24,4,20,56,3
1520,2,76,8756,1,0,0,0,0,0
1521,5,76,8756,50,7,5,2,43,-23
1522,8,81,8756,54,24,9,15,62,0
1523,11,81,8756,39,15,8,7,40,-5
1524,11,77,8756,14,8,3,5,6,1
1525,14,77,8756,36,4,3,1,53,8
1526,17,77,8756,59,21,6,15,58,0
1527,20,63,8756,72,28,13,15,82,-21
1529,26,63,8756,71,21,7,14,95,-14
1530,29,63,8756,50,21,5,16,42,-1
1531,29,74,8756,12,4,1,3,8,-8
1532,32,66,8756,74,24,6,18,54,-14
1533,35,70,8756,61,12,6,6,25,-2
1534,38,70,8756,69,19,10,9,76,18
1535,41,70,8756,69,24,9,15,52,2
1536,47,81,8756,61,17,4,13,30,-7
1537,53,83,14029,1,0,0,0,0,0
1538,62,83,14029,46,13,5,8,33,8
1539,65,83,14029,17,2,1,1,16,-3
1540,65,82,14029,20,3,0,3,19,-5
1541,56,66,15541,8,2,0,2,2,-3
1542,59,66,15541,22,11,1,10,8,-4
1543,62,66,15541,3,0,0,0,2,0
1544,65,71,15541,1,0,0,0,0,-1
1546,5,75,27465,39,34,21,13,10,7
1547,8,75,27465,75,48,20,28,63,5
1548,11,75,27465,74,45,19,26,31,-9
1549,14,75,27465,6,3,0,3,2,-3
1550,14,77,27465,20,6,0,6,2,-1
1551,17,77,27465,2,1,0,1,0,0
1552,17,68,27465,5,3,1,2,0,0
1553,2,75,31697,32,3,1,2,39,3
1554,2,84,31697,31,10,3,7,66,-8
1555,5,84,31697,77,27,6,21,229,-3
1556,8,84,31697,80,20,6,14,171,32
1557,11,84,31697,55,11,1,10,72,2
1558,14,84,31697,22,4,1,3,15,-8
1559,14,65,31697,13,1,1,0,48,3
1565,29,83,31697,26,3,0,3,33,2
1566,32,70,31697,14,0,0,0,18,4
1568,50,71,8896,16,1,0,1,6,-10
1569,56,77,8896,2,0,0,0,0,-1
1570,59,77,8896,21,4,2,2,12,1
1571,62,1479,8896,6,2,1,1,4,-3
1572,62,77,8896,4,0,0,0,2,0
1575,5,77,22692,64,56,26,30,130,1
1576,8,77,22692,83,63,35,28,201,14
1577,11,77,22692,71,42,19,23,113,-9
1578,14,77,22692,40,13,8,5,39,-1
1579,17,77,22692,26,2,0,2,50,-8
1582,23,66,22692,54,23,7,16,105,-7
1583,26,66,22692,67,18,8,10,97,5
1584,29,80,22692,67,12,4,8,57,2
1585,32,82,22692,66,15,8,7,126,2
1586,35,82,22692,59,13,5,8,62,-6
1587,38,82,22692,4,0,0,0,12,0
1589,5,79,31677,1,0,0,0,0,-2
1590,8,80,31677,32,6,2,4,30,-19
1591,11,80,31677,77,21,0,21,89,-52
1592,14,76,31677,9,0,0,0,2,-5
1593,56,64,11733,5,0,0,0,0,1
1594,2,85,41331,56,8,3,5,20,6
1595,5,85,41331,27,4,3,1,20,4
1596,8,85,41331,6,0,0,0,2,-1
1597,11,1479,41331,77,20,9,11,55,20
1598,14,1479,41331,45,20,7,13,12,-3
1599,17,1479,41331,82,30,8,22,64,9
1600,20,1479,41331,79,18,4,14,55,17
1601,23,1479,41331,22,1,0,1,27,-12
1602,23,71,41331,30,7,2,5,22,6
1603,26,79,41331,70,10,2,8,60,-3
1604,29,80,41331,1,0,0,0,0,2
1606,32,86,41331,16,2,1,1,14,4
1607,32,79,41331,5,0,0,0,4,0
1608,53,85,10623,2,0,0,0,0,0
1609,56,70,10623,3,2,0,2,0,0
1613,5,67,18718,67,5,2,3,305,-7
1614,8,67,18718,60,11,3,8,221,5
1615,11,67,18718,7,0,0,0,31,1
1616,11,70,18718,18,1,0,1,66,-4
1617,14,70,18718,16,1,1,0,52,1
1618,83,76,23935,34,7,3,4,8,-3
1619,86,76,23935,8,1,0,1,2,-3
1620,29,89,3581,30,19,6,13,4,5
1621,32,89,3581,15,6,1,5,10,-2
1622,35,81,3581,2,0,0,0,0,-2
1492,62,62,9154,82,43,8,35,67,-8
1493,65,62,9154,61,27,9,18,75,0
1628,56,77,3581,55,14,4,10,15,-1
1629,56,75,3581,21,3,2,1,13,-4
1630,59,75,3581,69,29,16,13,24,-1
1631,20,78,70167,74,32,14,18,24,1
1632,23,78,70167,58,10,4,6,31,0
1633,23,74,70167,2,0,0,0,0,-1
1634,26,74,70167,5,0,0,0,4,-1
1635,26,79,70167,2,0,0,0,0,0
1636,26,84,70167,49,16,7,9,20,-2
1637,29,84,70167,54,17,4,13,20,-4
1638,20,78,24389,5,3,2,1,0,1
1639,2,88,38461,53,12,7,5,41,3
1640,5,88,38461,80,45,29,16,20,5
1641,8,88,38461,84,69,29,40,45,17
1642,11,88,38461,81,42,21,21,34,2
1643,14,88,38461,9,2,1,1,4,-7
1645,17,70,38461,24,7,2,5,10,-2
1646,20,76,38461,3,0,0,0,2,0
1647,5,63,68028,7,1,1,0,22,0
1648,20,62,52006,19,1,0,1,54,-1
1649,23,72,52006,2,0,0,0,5,0
1650,26,72,52006,16,3,0,3,59,0
1651,5,63,32932,10,1,0,1,22,-8
1652,2,74,9131,28,1,1,0,185,-5
1653,5,74,9131,42,6,2,4,246,-4
1654,8,74,9131,12,2,2,0,95,-1
1658,14,83,9131,9,1,0,1,31,1
1659,17,83,9131,72,13,7,6,297,-3
1660,20,83,9131,80,28,11,17,275,-17
1661,23,83,9131,80,14,4,10,365,-5
1662,26,83,9131,72,22,8,14,198,5
1663,29,83,9131,70,14,5,9,198,-5
1665,35,83,9131,74,19,9,10,157,3
1666,38,83,9131,79,29,15,14,171,-1
1667,41,83,9131,80,20,7,13,208,-2
1668,47,83,9131,77,16,5,11,109,-10
1669,2,85,153,26,12,0,12,16,-2
1670,5,74,153,50,19,1,18,40,7
1671,8,74,153,6,2,1,1,2,0
1672,23,79,3716,30,7,5,2,12,-1
1673,29,79,3716,22,7,2,5,0,1
1674,38,62,3716,1,0,0,0,0,0
1675,2,63,47079,39,7,5,2,9,-12
1676,5,63,47079,54,23,10,13,10,9
1677,8,63,47079,19,8,4,4,4,5
1678,11,1479,47079,74,34,12,22,21,-5
1679,14,1479,47079,46,21,10,11,12,4
1680,17,1479,47079,31,15,8,7,9,-3
1682,80,66,109691,2,0,0,0,0,-3
1683,80,72,46020,43,7,4,3,17,-17
1684,83,72,46020,6,1,1,0,4,2
1685,86,72,46020,11,0,0,0,0,-6
1686,2,72,32009,73,45,9,36,62,11
1687,5,72,32009,78,42,7,35,66,5
1688,8,72,32009,83,54,14,40,66,-10
1689,11,72,32009,66,32,8,24,63,29
1690,14,72,32009,41,16,4,12,18,-1
1691,17,74,32009,66,37,3,34,42,2
1692,20,74,32009,79,30,5,25,48,8
1693,23,74,32009,75,20,5,15,46,-3
1697,11,85,9139,39,13,5,8,31,11
1698,14,85,9139,36,8,2,6,22,1
1699,17,85,9139,52,16,7,9,32,2
1700,20,85,9139,76,13,8,5,73,-11
1702,26,85,9139,80,18,4,14,79,2
1703,29,85,9139,51,12,5,7,28,3
1704,32,85,9139,75,25,8,17,38,17
1705,35,85,9139,82,30,15,15,56,26
1706,38,85,9139,82,35,14,21,82,6
1707,41,85,9139,67,40,24,16,31,22
1708,47,85,9139,80,32,10,22,58,3
1709,50,85,9139,81,29,14,15,58,7
1710,53,85,9139,65,17,9,8,68,-2
1711,56,85,9139,79,17,7,10,40,-13
1712,59,85,9139,81,22,7,15,28,-2
1713,62,85,9139,47,11,6,5,12,1
1714,80,85,76952,1,0,0,0,0,0
1715,2,89,73233,80,58,22,36,46,4
1716,5,89,73233,67,37,19,18,39,14
1718,11,88,73233,55,31,14,17,50,16
1720,17,88,73233,64,21,9,12,14,-26
1721,17,77,73233,13,8,4,4,13,6
1722,20,77,73233,43,15,7,8,12,-5
1723,23,77,73233,23,3,1,2,2,0
1724,2,88,21620,78,62,21,41,66,19
1725,5,77,21620,78,56,18,38,86,-7
1727,11,78,21620,36,31,12,19,14,1
1728,14,78,21620,47,38,12,26,36,29
1729,17,80,21620,62,36,12,24,42,-23
1730,20,80,21620,78,47,19,28,38,-9
1731,23,78,21620,80,56,14,42,32,9
1732,26,88,21620,60,23,4,19,22,-6
1733,26,77,21620,11,7,2,5,2,0
1734,29,85,21620,79,41,10,31,42,12
1735,32,85,21620,54,25,6,19,48,9
1736,35,85,21620,64,18,3,15,28,3
1741,14,86,32036,33,9,2,7,16,-6
1742,14,68,32036,13,3,1,2,0,3
1743,77,67,90103,7,4,0,4,8,1
1744,80,67,90103,11,0,0,0,4,-3
1745,83,67,90103,37,8,3,5,8,-14
1746,86,67,90103,38,6,1,5,13,1
1747,2,75,72764,53,15,2,13,55,5
1748,5,75,72764,3,0,0,0,2,2
1749,8,75,72764,32,3,1,2,32,0
1750,11,81,72764,51,8,2,6,48,-2
1751,11,88,72764,9,0,0,0,10,-5
1752,14,78,72764,22,3,0,3,10,2
1753,17,78,72764,3,0,0,0,4,-2
1754,17,71,72764,42,7,1,6,16,-2
1624,38,89,3581,23,5,2,3,6,4
1626,50,78,3581,20,5,2,3,14,0
1760,86,1479,43578,8,1,1,0,4,-1
1761,80,72,180975,4,0,0,0,4,-3
1762,83,72,180975,1,0,0,0,0,0
1763,86,72,180975,41,10,6,4,15,-4
1764,77,547,96528,3,0,0,0,2,0
1765,80,547,96528,51,4,2,2,26,-6
1766,83,547,96528,61,18,8,10,18,13
1767,86,547,96528,80,29,14,15,41,9
1768,83,67,74273,9,0,0,0,4,-4
1769,80,62,233074,76,48,13,35,105,14
1770,83,62,233074,68,49,24,25,61,-1
1771,86,62,233074,80,77,34,43,62,14
1772,86,72,139456,34,7,4,3,6,-7
1773,83,69,245330,19,4,2,2,13,-3
1774,86,69,245330,49,17,6,11,27,-9
1775,80,83,199952,82,69,40,29,14,2
1777,86,83,199952,68,73,37,36,12,-9
1783,14,89,32690,13,4,1,3,8,2
1784,17,89,32690,70,11,4,7,75,-1
1785,20,89,32690,70,8,1,7,42,-4
1786,23,89,32690,36,4,1,3,16,-2
1787,26,89,32690,52,6,4,2,50,-5
1788,29,89,32690,25,2,2,0,15,-7
1789,86,80,161189,56,15,7,8,20,-25
1790,86,74,226489,5,0,0,0,8,-6
1791,83,63,245192,63,32,7,25,53,20
1792,86,63,245192,54,28,7,21,45,14
1793,86,72,213777,1,0,0,0,0,-2
1794,86,74,195076,5,1,1,0,6,1
1795,86,88,113571,15,6,5,1,6,-4
1796,83,65,231324,82,52,28,24,6,6
1797,86,65,231324,82,76,41,35,15,0
1799,83,547,221722,82,70,44,26,24,8
1800,86,547,221722,82,50,30,20,42,-24
1801,80,87,226484,3,2,0,2,0,-3
1802,83,87,226484,82,65,23,42,24,-7
1803,86,87,226484,82,47,14,33,24,-21
1804,80,71,152162,28,8,1,7,10,5
1805,83,71,152162,65,20,12,8,14,-1
1806,86,71,152162,46,9,4,5,16,-14
1807,80,87,243434,68,20,7,13,47,-14
1808,83,87,243434,50,14,4,10,16,2
1809,86,87,243434,53,20,5,15,28,-12
1810,86,62,664121,25,5,1,4,4,2
1811,86,1479,154556,22,11,6,5,8,2
1812,86,74,232763,66,23,6,17,14,-16
1813,86,74,272616,4,0,0,0,0,0
1814,86,63,272273,15,0,0,0,15,-4
1816,86,80,105932,2,0,0,0,0,-2
1817,86,1479,233496,30,5,2,3,14,-1
1818,80,64,148169,6,1,1,0,0,-5
1819,83,64,148169,65,22,12,10,26,-10
1820,86,64,148169,70,26,11,15,14,-2
1821,86,73,247108,4,1,1,0,0,-1
1822,86,1479,166724,17,5,1,4,4,0
1823,83,75,232754,49,7,0,7,4,5
1824,86,75,232754,71,13,0,13,6,17
1825,50,1479,10977,2,1,1,0,2,-1
1826,50,82,10977,7,0,0,0,0,-4
1827,53,82,10977,36,12,6,6,25,3
1828,53,71,10977,26,13,9,4,28,5
1829,56,62,10977,74,40,13,27,42,14
1830,59,62,10977,67,33,15,18,58,11
1831,62,62,10977,79,43,24,19,59,6
1833,68,62,10977,40,26,15,11,18,-8
1834,71,62,10977,38,24,12,12,12,-11
1835,74,62,10977,53,28,9,19,39,3
1836,74,89,10977,18,7,4,3,6,-1
1837,47,85,9443,46,12,3,9,20,9
1838,50,85,9443,74,18,5,13,61,16
1839,53,85,9443,78,14,3,11,48,-1
1840,56,85,9443,65,16,6,10,48,9
1841,59,85,9443,63,8,1,7,24,-2
1842,62,83,9443,41,4,1,3,14,-14
1843,65,82,9443,30,4,1,3,14,-1
1844,47,83,8539,13,1,0,1,13,-8
1845,50,83,8539,15,2,0,2,14,-1
1846,53,83,8539,48,9,2,7,54,5
1847,56,78,8539,1,0,0,0,0,0
1848,59,63,8539,2,0,0,0,0,0
1850,2,77,1469,73,69,19,50,14,-2
1851,5,77,1469,51,23,7,16,4,0
1852,8,77,1469,55,49,11,38,16,12
1853,11,77,1469,48,17,1,16,8,-1
1854,11,70,1469,5,3,2,1,2,-1
1855,2,78,76468,12,3,1,2,14,1
1856,5,86,76468,60,38,22,16,46,-20
1857,8,86,76468,17,5,2,3,33,-14
1858,11,86,76468,2,0,0,0,0,-2
1859,86,68,252517,1,0,0,0,2,0
1860,2,88,11571,74,58,21,37,58,20
1863,8,71,11571,14,10,1,9,8,1
1864,11,71,11571,4,0,0,0,6,0
1865,11,86,11571,75,66,25,41,89,-3
1866,14,86,11571,22,17,7,10,18,3
1867,14,78,11571,13,6,2,4,4,5
1869,20,63,11571,31,16,4,12,16,-12
1870,47,84,12611,1,0,0,0,2,-1
1872,2,83,22717,60,38,8,30,69,-4
1873,5,83,22717,79,51,18,33,95,-13
1874,8,83,22717,70,40,6,34,46,19
1875,11,83,22717,68,43,7,36,42,6
1876,14,83,22717,33,15,5,10,26,-6
1877,17,83,22717,80,22,3,19,59,-10
1878,20,83,22717,56,14,4,10,34,-8
1879,20,72,22717,20,7,2,5,6,2
1880,23,63,22717,82,23,3,20,67,3
1881,26,63,22717,54,6,0,6,25,11
1882,29,78,22717,52,10,2,8,12,-4
1883,86,85,247180,52,16,7,9,16,-20
1757,8,74,73604,3,1,0,1,0,0
1758,80,1479,43578,1,0,0,0,0,0
1888,83,73,251526,5,3,1,2,2,-3
1889,83,64,251526,68,20,3,17,6,-8
1890,86,64,251526,82,27,4,23,6,8
1891,47,1479,8536,19,7,4,3,14,3
1892,50,1479,8536,82,45,29,16,58,-2
1893,53,71,8536,82,47,23,24,45,-12
1894,56,71,8536,78,37,17,20,61,7
1895,59,71,8536,82,63,32,31,38,6
1896,62,71,8536,62,39,21,18,45,-12
1897,62,88,8536,19,6,2,4,2,0
1898,65,88,8536,65,17,7,10,43,-7
1899,68,88,8536,33,14,2,12,18,-2
1900,71,1479,8536,49,32,13,19,28,22
1901,71,89,8536,18,3,1,2,2,3
1902,83,82,252533,82,48,20,28,49,8
1903,86,82,252533,82,61,27,34,64,16
1905,23,62,693192,12,1,1,0,4,-2
1906,26,62,693192,3,1,0,1,0,1
1907,32,75,693192,51,11,4,7,43,-9
1908,35,75,693192,2,1,0,1,0,2
1909,83,68,118378,4,1,1,0,0,-1
1910,86,68,118378,50,18,8,10,4,-14
1911,47,89,4226,81,106,52,54,52,2
1912,50,89,4226,82,92,46,46,52,-19
1913,53,89,4226,82,112,65,47,40,28
1914,56,89,4226,79,110,56,54,72,8
1915,59,89,4226,72,109,50,59,89,45
1916,62,89,4226,79,85,32,53,41,24
1917,65,89,4226,78,65,38,27,26,-8
1918,68,89,4226,48,56,32,24,36,2
1919,71,89,4226,78,79,51,28,48,-35
1920,74,89,4226,81,81,53,28,58,10
1922,80,89,4226,82,69,33,36,50,6
1923,83,89,4226,82,87,49,38,32,3
1924,86,89,4226,81,89,51,38,40,7
1925,83,72,117750,74,35,13,22,18,-16
1926,86,72,117750,51,33,8,25,6,-8
1927,50,79,4229,78,85,33,52,80,2
1928,53,79,4229,82,106,47,59,78,16
1929,56,79,4229,82,113,35,78,80,17
1930,59,79,4229,67,77,28,49,100,-6
1931,62,79,4229,43,37,15,22,18,-4
1932,65,79,4229,75,109,50,59,70,18
1933,68,79,4229,31,33,9,24,36,5
1934,71,79,4229,60,72,23,49,62,10
1935,74,79,4229,69,70,28,42,60,-2
1936,77,79,4229,57,58,27,31,65,1
1937,80,79,4229,62,72,33,39,77,18
1939,86,79,4229,68,72,21,51,89,-25
1940,47,66,6663,29,11,6,5,4,0
1941,50,66,6663,65,21,11,10,46,1
1942,53,66,6663,43,18,9,9,31,9
1943,53,65,6663,20,12,5,7,4,4
1944,56,65,6663,82,49,15,34,28,26
1945,59,65,6663,82,38,17,21,67,2
1947,65,547,6663,82,50,28,22,64,-8
1948,68,547,6663,48,46,18,28,22,10
1949,71,547,6663,78,54,23,31,57,8
1950,74,547,6663,81,62,24,38,72,9
1951,77,547,6663,59,34,17,17,39,-10
1952,77,65,6663,19,12,8,4,6,-3
1953,80,76,6663,78,31,23,8,45,-14
1954,83,76,6663,73,29,12,17,24,11
1955,86,76,6663,26,11,3,8,16,3
1957,59,63,9210,82,38,18,20,53,-4
1958,62,63,9210,58,27,11,16,32,8
1960,65,547,9210,80,64,17,47,55,3
1961,68,547,9210,48,41,19,22,28,-3
1962,71,547,9210,82,69,28,41,63,4
1963,74,547,9210,79,61,26,35,73,26
1964,77,547,9210,82,78,26,52,49,8
1965,80,547,9210,82,74,26,48,47,6
1966,83,547,9210,81,91,23,68,52,13
1967,86,547,9210,82,91,20,71,60,0
1968,47,68,8648,59,21,8,13,24,-4
1969,50,68,8648,75,30,11,19,28,2
1970,53,68,8648,56,26,14,12,16,3
1971,56,68,8648,37,9,4,5,8,-5
1972,59,68,8648,78,29,14,15,28,-4
1973,62,68,8648,44,17,6,11,8,-1
1975,71,72,8648,10,2,0,2,0,-1
1976,80,75,312259,4,0,0,0,0,1
1977,83,81,312259,79,40,9,31,38,11
1978,86,81,312259,75,32,6,26,28,12
1979,86,72,245205,7,3,3,0,10,0
1980,86,72,240866,21,3,0,3,13,-8
1981,86,80,295765,1,0,0,0,0,-3
1982,47,65,9194,1,0,0,0,0,0
1983,50,65,9194,35,8,1,7,44,-12
1984,53,65,9194,45,18,6,12,52,-3
1985,56,65,9194,68,40,6,34,65,-6
1986,59,65,9194,51,14,4,10,58,7
1987,59,69,9194,19,7,1,6,10,-2
1988,62,69,9194,52,5,1,4,34,-10
1989,65,71,9194,25,2,2,0,23,0
1990,68,84,9194,14,2,0,2,4,-3
1992,53,67,9173,64,38,16,22,51,3
1993,56,67,9173,79,45,20,25,29,3
1994,59,67,9173,71,34,14,20,35,4
1995,62,67,9173,62,52,31,21,34,13
1996,65,67,9173,80,50,20,30,46,5
1997,68,67,9173,46,18,6,12,21,-16
1998,71,67,9173,70,34,16,18,39,-19
1999,74,67,9173,50,24,9,15,39,-18
2000,74,547,9173,26,19,9,10,8,6
2001,77,547,9173,78,38,21,17,28,-23
2002,80,547,9173,40,13,4,9,12,-2
2003,80,63,9173,18,8,4,4,12,8
2004,83,72,9173,59,15,8,7,10,-20
2005,86,72,9173,57,13,5,8,18,-7
1885,50,70,11001,1,1,1,0,0,1
1886,53,70,11001,2,0,0,0,2,-1
2010,56,63,4123,33,3,0,3,10,-1
2011,56,1479,4123,17,6,4,2,6,3
2012,59,1479,4123,50,11,4,7,21,-7
2015,65,75,4123,51,6,3,3,37,-5
2016,50,73,8792,64,37,18,19,26,19
2017,53,73,8792,81,58,26,32,44,7
2018,65,73,8792,9,7,3,4,4,3
2019,80,75,8792,76,54,18,36,62,10
2020,83,70,8792,82,72,27,45,72,4
2021,86,70,8792,70,72,29,43,54,22
2022,80,67,212685,4,1,0,1,0,-2
2023,83,67,212685,3,1,1,0,0,-3
2024,86,67,212685,12,4,2,2,4,-4
2025,56,74,4217,68,14,6,8,14,-10
2031,74,87,4217,69,21,6,15,12,-27
2032,77,71,4217,71,22,10,12,10,-17
2034,80,82,4217,9,0,0,0,0,0
2035,50,72,10227,80,42,17,25,16,1
2036,53,72,10227,82,34,14,20,31,-11
2037,56,72,10227,82,62,20,42,29,33
2038,59,72,10227,82,67,25,42,24,22
2039,62,72,10227,82,44,13,31,24,-6
2040,65,72,10227,15,6,2,4,4,-3
2041,68,72,10227,48,20,7,13,22,-5
2042,71,72,10227,80,48,18,30,28,3
2043,74,72,10227,74,25,11,14,29,-3
2044,77,72,10227,74,42,14,28,25,3
2045,80,72,10227,80,45,14,31,33,-8
2046,83,72,10227,63,26,12,14,25,-8
2047,86,72,10227,80,46,19,27,20,-25
2048,47,64,8828,9,6,2,4,4,-5
2049,50,64,8828,76,50,22,28,14,2
2051,56,64,8828,78,42,14,28,28,-13
2052,59,64,8828,62,47,17,30,21,15
2055,62,74,8828,37,19,6,13,8,12
2056,65,74,8828,9,3,0,3,2,-2
2057,65,68,8828,22,9,4,5,0,-3
2058,68,89,8828,27,9,4,5,6,1
2059,53,75,9189,36,11,4,7,10,-1
2060,56,75,9189,13,3,0,3,5,-6
2061,59,75,9189,19,0,0,0,16,-10
2062,59,1479,9189,55,12,6,6,56,-2
2063,62,1479,9189,40,2,0,2,32,1
2067,74,87,9189,70,14,4,10,82,-23
2068,77,87,9189,70,12,4,8,38,-10
2069,47,80,8660,82,39,10,29,61,34
2070,50,80,8660,82,35,7,28,102,-15
2071,53,80,8660,82,36,9,27,50,5
2073,59,81,8660,81,17,6,11,50,-14
2074,62,77,8660,81,32,8,24,42,30
2075,65,77,8660,62,25,7,18,38,6
2076,68,77,8660,11,2,0,2,2,-9
2077,71,77,8660,38,17,5,12,34,1
2078,71,63,8660,14,5,2,3,6,4
2079,74,67,8660,60,14,7,7,36,-13
2080,86,85,191346,46,23,5,18,30,-10
2081,50,71,8874,1,0,0,0,0,0
2082,53,71,8874,2,0,0,0,0,-1
2083,56,71,8874,4,3,0,3,2,2
2084,59,76,8874,44,25,7,18,8,-4
2085,62,76,8874,45,22,10,12,12,-19
2087,50,89,9486,38,3,0,3,16,5
2088,53,89,9486,72,18,5,13,28,12
2089,56,89,9486,64,12,1,11,21,13
2091,62,89,9486,72,10,1,9,12,6
2092,65,89,9486,54,6,1,5,12,-2
2093,68,89,9486,26,3,0,3,12,-6
2094,74,88,9486,9,1,0,1,4,1
2095,77,88,9486,1,0,0,0,0,-1
2096,56,62,11430,2,0,0,0,2,0
2097,47,89,9471,22,3,1,2,18,-8
2098,50,89,9471,70,12,2,10,36,-10
2099,53,89,9471,82,56,18,38,62,6
2100,56,89,9471,68,73,31,42,68,24
2101,59,89,9471,75,76,19,57,54,39
2102,62,89,9471,49,24,8,16,48,6
2103,65,89,9471,32,7,3,4,12,5
2104,68,89,9471,35,26,12,14,20,-3
2105,71,89,9471,70,38,9,29,64,-16
2106,74,89,9471,72,45,10,35,34,15
2108,80,85,9471,72,36,14,22,40,-20
2109,83,85,9471,66,33,8,25,38,-14
2110,86,85,9471,43,26,5,21,28,-1
2111,53,70,8395,37,2,0,2,24,3
2112,56,70,8395,36,4,0,4,42,-1
2113,59,70,8395,67,10,1,9,69,27
2114,62,70,8395,57,5,2,3,44,-10
2115,65,70,8395,60,2,0,2,41,-3
2116,68,71,8395,25,6,0,6,32,6
2117,71,1479,8395,34,5,1,4,28,9
2118,74,1479,8395,9,0,0,0,4,-3
2119,2,88,279806,17,5,1,4,6,-1
2120,5,88,279806,6,1,1,0,30,0
2121,8,88,279806,4,0,0,0,6,-1
2122,50,65,9188,1,0,0,0,0,-1
2123,53,65,9188,39,17,4,13,28,6
2125,59,65,9188,39,16,6,10,28,5
2126,62,65,9188,61,37,15,22,34,11
2127,65,65,9188,76,37,19,18,47,0
2128,68,65,9188,35,14,7,7,22,-7
2129,71,83,9188,23,12,8,4,24,-1
2130,74,68,9188,53,23,6,17,48,4
2131,77,68,9188,25,5,1,4,16,-2
2132,53,89,6661,4,0,0,0,2,0
2133,56,89,6661,8,1,1,0,0,0
2134,59,79,6661,20,3,0,3,10,-4
2135,59,89,6661,1,0,0,0,0,-2
2136,68,63,6661,18,4,1,3,6,-6
2137,86,68,60115,2,1,1,0,0,1
2138,80,84,59095,71,24,3,21,25,-16
2007,86,67,301407,65,12,7,5,20,-22
2008,47,76,4123,15,2,1,1,4,-1
2143,8,78,21563,82,73,22,51,62,2
2148,23,66,21563,81,45,21,24,50,-17
2149,26,66,21563,35,21,8,13,36,1
2150,26,65,21563,27,14,4,10,13,8
2151,26,80,21563,3,2,1,1,2,-1
2153,29,88,21563,5,2,1,1,0,1
2154,32,88,21563,78,22,11,11,54,-13
2155,35,88,21563,41,7,5,2,25,-8
2158,8,89,54948,80,57,22,35,66,3
2159,11,89,54948,4,2,1,1,0,-3
2160,11,81,54948,63,26,12,14,64,-18
2161,14,80,54948,41,10,3,7,51,-11
2162,17,80,54948,29,3,1,2,16,2
2163,50,65,11343,3,2,2,0,0,1
2164,53,65,11343,4,0,0,0,2,-1
2165,59,65,11343,16,4,3,1,5,4
2167,65,65,11343,71,24,9,15,48,-3
2168,68,65,11343,48,23,9,14,25,12
2169,71,65,11343,59,15,11,4,28,-6
2170,74,65,11343,80,28,14,14,38,5
2171,77,65,11343,25,2,0,2,2,-5
2172,80,66,11343,11,1,1,0,4,-4
2173,86,68,91294,1,0,0,0,0,-3
2174,50,67,9478,5,2,0,2,0,2
2175,53,67,9478,4,0,0,0,0,-3
2176,53,82,9411,3,0,0,0,0,-2
2177,50,76,9185,3,0,0,0,0,0
2178,53,76,9185,51,15,8,7,22,1
2179,56,76,9185,53,25,7,18,32,-17
2180,59,76,9185,61,35,17,18,40,-2
2181,62,76,9185,77,46,24,22,43,-17
2182,65,76,9185,16,0,0,0,6,-11
2184,68,62,9185,33,7,4,3,14,-9
2185,68,82,9185,9,5,2,3,6,5
2186,71,82,9185,61,16,5,11,36,-2
2187,74,79,9185,61,31,16,15,65,6
2188,77,64,9185,81,36,12,24,58,-9
2189,80,64,9185,77,20,8,12,58,-19
2190,83,64,9185,79,34,13,21,50,5
2191,86,70,9185,77,18,7,11,42,-7
2192,53,74,9484,1,0,0,0,0,-1
2193,59,74,9484,5,1,1,0,31,1
2194,65,82,9484,8,0,0,0,29,0
2195,68,63,793,6,2,0,2,6,-2
2196,71,63,793,73,48,16,32,36,4
2197,74,63,793,82,44,13,31,26,10
2198,77,64,793,82,51,12,39,32,-7
2199,80,64,793,80,14,6,8,22,-26
2201,86,64,793,82,49,23,26,26,-5
2205,59,74,9252,57,14,6,8,18,-1
2206,56,70,11419,5,1,1,0,0,-1
2207,59,70,11419,5,0,0,0,0,1
2208,62,70,11419,1,0,0,0,0,-1
2209,50,68,9396,48,10,3,7,12,0
2210,53,68,9396,73,40,22,18,26,13
2211,56,68,9396,72,60,31,29,38,10
2212,59,68,9396,28,16,8,8,23,-3
2213,62,68,9396,82,40,23,17,26,-31
2214,65,68,9396,6,1,0,1,2,-6
2215,65,84,9396,56,29,16,13,32,1
2216,68,84,9396,12,3,1,2,4,-3
2217,71,84,9396,66,19,9,10,18,1
2218,74,83,9396,59,13,7,6,25,-8
2219,83,85,9396,28,5,4,1,10,-5
2221,83,83,34785,60,13,5,8,31,8
2222,86,83,34785,81,14,3,11,18,2
2223,59,68,41113,50,6,2,4,26,-8
2224,62,84,41113,16,3,0,3,8,1
2225,65,84,41113,1,0,0,0,7,0
2226,50,70,2435,8,0,0,0,4,-1
2227,53,70,2435,62,7,0,7,22,10
2228,56,70,2435,81,12,2,10,51,-8
2229,59,70,2435,71,7,0,7,32,-3
2230,62,70,2435,59,10,1,9,35,7
2231,65,70,2435,52,5,0,5,26,0
2232,65,77,2435,22,6,0,6,10,5
2233,68,77,2435,30,4,1,3,21,-1
2234,71,77,2435,78,14,1,13,55,-6
2235,74,77,2435,68,14,5,9,32,8
2236,77,87,2435,58,7,3,4,24,-3
2238,50,74,11014,6,0,0,0,2,0
2239,53,74,11014,82,40,14,26,79,8
2240,56,74,11014,82,41,13,28,112,-6
2241,59,74,11014,69,44,20,24,54,9
2242,62,74,11014,77,54,24,30,100,-3
2243,65,74,11014,77,34,10,24,110,16
2244,68,82,11014,29,20,2,18,76,2
2245,71,82,11014,76,50,16,34,98,5
2246,74,82,11014,47,36,13,23,43,11
2247,77,82,11014,75,48,17,31,71,-16
2248,80,82,11014,80,41,12,29,91,16
2249,83,82,11014,62,16,6,10,33,-2
2250,86,82,11014,61,14,6,8,36,-16
2251,53,79,9431,3,2,0,2,2,2
2252,56,79,9431,45,20,6,14,16,5
2253,59,79,9431,69,37,8,29,22,7
2255,62,70,9431,23,15,5,10,12,0
2256,65,70,9431,71,30,9,21,16,0
2257,68,70,9431,47,27,3,24,18,4
2258,71,70,9431,81,42,6,36,28,9
2259,74,70,9431,81,36,4,32,24,0
2260,77,70,9431,82,37,5,32,34,21
2261,80,87,9431,82,36,6,30,28,-9
2262,83,87,9431,78,35,12,23,26,-31
2263,86,87,9431,76,27,3,24,16,-7
2264,80,71,97450,60,18,7,11,16,3
2265,83,71,97450,67,20,13,7,37,-13
2266,86,71,97450,29,11,7,4,16,-8
2267,86,65,97450,26,12,5,7,12,3
2268,50,63,9223,6,0,0,0,2,-3
2140,86,84,59095,78,23,2,21,32,9
2141,2,78,21563,4,3,0,3,2,-2
2273,65,63,9223,79,62,23,39,36,-5
2274,68,63,9223,47,33,10,23,20,1
2275,71,63,9223,80,69,19,50,28,39
2276,74,63,9223,47,31,7,24,22,7
2277,77,63,9223,72,63,17,46,32,4
2278,80,63,9223,82,54,23,31,26,-12
2279,83,63,9223,64,44,17,27,18,10
2280,86,63,9223,81,73,20,53,16,7
2281,56,63,9236,6,1,0,1,0,-3
2282,56,81,9236,18,5,1,4,6,-5
2283,86,71,29192,6,0,0,0,2,0
2284,53,89,4122,7,1,0,1,12,-1
2285,56,89,4122,7,4,0,4,6,-3
2288,62,82,4122,19,5,0,5,18,3
2289,65,65,4122,26,3,1,2,4,3
2290,59,79,17758,6,2,1,1,2,-2
2292,65,69,17758,77,26,8,18,45,-6
2294,71,63,17758,9,0,0,0,0,-4
2295,53,65,9487,2,0,0,0,0,0
2296,53,66,9415,11,3,1,2,4,-3
2297,56,66,9415,3,0,0,0,5,0
2298,59,66,9415,2,0,0,0,0,-1
2299,50,62,8918,10,0,0,0,25,1
2300,56,62,8918,25,2,1,1,79,-4
2302,59,62,8918,43,5,1,4,98,6
2303,59,74,8918,26,9,4,5,65,3
2304,62,74,8918,82,29,13,16,160,2
2305,65,74,8918,82,17,5,12,156,-1
2306,68,75,8918,38,14,5,9,110,11
2307,71,75,8918,52,13,6,7,121,-1
2308,74,75,8918,82,18,4,14,134,6
2309,77,84,8918,35,7,1,6,59,-3
2311,53,67,9243,37,8,2,6,16,5
2312,56,67,9243,69,19,3,16,22,-11
2313,59,67,9243,49,11,4,7,6,-1
2314,62,67,9243,76,29,3,26,34,11
2315,65,67,9243,69,13,3,10,18,3
2316,68,67,9243,37,12,2,10,4,-2
2317,71,66,9243,74,44,11,33,20,4
2318,74,66,9243,57,19,2,17,8,-7
2319,74,88,9243,16,4,1,3,6,4
2320,77,71,9243,81,30,6,24,12,-15
2321,80,71,9243,80,35,8,27,18,14
2322,83,71,9243,36,8,0,8,6,-15
2323,86,71,9243,24,4,0,4,6,3
2324,2,74,1403,53,25,7,18,8,13
2325,5,74,1403,46,17,8,9,4,13
2326,8,74,1403,45,16,5,11,10,11
2328,83,65,18084,31,7,1,6,12,13
2329,83,89,18084,22,3,2,1,14,1
2330,86,89,18084,71,25,6,19,60,24
2331,80,72,11946,25,4,2,2,2,1
2332,83,71,11946,33,9,3,6,8,4
2333,2,79,68552,79,42,20,22,115,11
2334,5,79,68552,78,35,19,16,119,1
2335,8,79,68552,54,14,8,6,76,-2
2336,8,67,68552,8,4,1,3,4,2
2337,11,86,68552,64,30,12,18,126,-11
2338,14,86,68552,13,4,2,2,27,4
2339,14,85,68552,30,17,6,11,31,9
2340,17,85,68552,71,32,11,21,66,30
2341,20,85,68552,36,3,1,2,27,-3
2342,20,86,68552,30,9,3,6,20,-2
2343,23,70,68552,59,11,2,9,46,7
2345,56,69,11770,31,7,2,5,12,1
2346,59,73,11770,1,0,0,0,0,0
2348,5,86,72166,5,1,0,1,25,0
2349,65,75,9249,67,7,3,4,30,-18
2350,68,75,9249,38,12,3,9,33,2
2351,71,75,9249,59,17,3,14,59,-1
2352,74,75,9249,68,14,3,11,59,5
2353,77,75,9249,72,12,0,12,71,-7
2354,80,75,9249,76,10,2,8,71,1
2355,83,73,9249,76,9,1,8,40,9
2356,56,80,4100,11,2,1,1,2,0
2357,59,80,4100,75,29,13,16,20,10
2358,62,80,4100,55,17,3,14,12,-4
2359,65,80,4100,10,4,2,2,2,3
2360,68,80,4100,27,3,0,3,8,-4
2361,71,76,4100,44,7,2,5,18,-10
2363,74,65,4100,4,1,0,1,0,1
2364,50,84,4075,22,3,1,2,6,3
2365,53,84,4075,75,20,8,12,42,6
2366,56,84,4075,80,37,10,27,54,11
2367,59,84,4075,76,42,5,37,40,0
2368,62,84,4075,51,33,8,25,24,13
2369,65,84,4075,82,49,11,38,34,0
2370,68,84,4075,45,22,8,14,37,-5
2371,71,84,4075,63,22,7,15,50,-39
2372,74,84,4075,74,31,8,23,54,13
2373,77,84,4075,52,20,6,14,46,-8
2374,80,84,4075,68,21,6,15,36,-20
2375,83,84,4075,70,34,6,28,68,-18
2376,86,84,4075,56,34,10,24,54,3
2377,2,75,67315,28,5,3,2,128,4
2378,5,75,67315,46,3,1,2,130,3
2380,11,1479,67315,76,18,9,9,272,-7
2381,14,1479,67315,24,0,0,0,93,-2
2382,17,1479,67315,53,7,4,3,285,-5
2383,20,86,67315,51,2,0,2,162,-5
2384,50,62,9187,13,4,2,2,4,5
2385,53,62,9187,48,12,7,5,6,-11
2386,56,62,9187,71,22,11,11,10,-11
2387,59,62,9187,60,19,8,11,15,5
2388,59,73,9187,18,5,3,2,4,1
2389,62,75,9187,10,1,1,0,2,-6
2390,53,79,11538,55,19,10,9,35,2
2391,56,79,11538,67,35,15,20,30,15
2392,59,79,11538,64,25,13,12,31,10
2393,62,79,11538,80,45,21,24,37,1
2270,56,63,9223,82,73,22,51,26,37
2271,59,63,9223,79,52,17,35,26,8
2398,74,76,11538,13,5,2,3,2,-3
2399,77,72,11538,50,16,3,13,14,-14
2402,8,77,74587,65,21,8,13,70,-9
2403,59,75,15057,3,0,0,0,0,-2
2404,65,81,15057,40,11,2,9,8,1
2405,68,81,15057,1,0,0,0,0,-1
2406,53,81,14077,81,6,0,6,16,3
2407,56,81,14077,25,2,0,2,4,-4
2408,59,81,14077,49,13,3,10,18,-4
2409,62,81,14077,69,12,1,11,12,-3
2410,65,69,14077,17,2,0,2,4,-1
2411,68,80,14077,11,1,0,1,0,-2
2412,17,88,2664,51,7,0,7,29,-13
2413,20,88,2664,41,8,2,6,24,-9
2414,23,88,2664,72,8,0,8,61,3
2415,29,88,2664,70,16,3,13,45,-1
2417,32,83,2664,12,3,3,0,2,-6
2418,35,83,2664,81,11,1,10,46,14
2419,38,83,2664,78,11,4,7,28,3
2420,41,83,2664,79,9,2,7,40,-1
2421,47,83,2664,75,8,0,8,56,-5
2422,47,85,415488,80,16,12,4,36,4
2423,50,85,415488,69,30,10,20,37,20
2424,53,85,415488,72,38,27,11,51,12
2425,56,85,415488,71,59,34,25,44,21
2426,59,85,415488,27,21,10,11,22,1
2427,62,85,415488,76,55,28,27,58,5
2428,65,85,415488,77,56,29,27,40,23
2429,68,85,415488,41,31,14,17,41,13
2430,71,85,415488,54,41,16,25,40,6
2431,74,85,415488,33,22,7,15,30,-12
2432,77,85,415488,2,1,0,1,2,0
2434,29,86,10823,1,0,0,0,2,-1
2435,32,86,10823,38,7,3,4,57,2
2436,35,86,10823,17,2,0,2,24,1
2437,38,86,10823,20,1,0,1,9,-2
2438,38,79,10823,27,2,1,1,33,-2
2440,17,1479,9010,45,12,5,7,22,-2
2444,23,65,9010,22,11,3,8,6,2
2445,26,65,9010,64,25,14,11,30,-1
2446,26,71,9010,13,2,1,1,4,-3
2447,29,71,9010,40,5,3,2,18,-6
2448,32,71,9010,34,7,5,2,17,-7
2449,32,75,9010,43,25,9,16,34,-1
2450,35,75,9010,75,23,8,15,27,-7
2451,38,75,9010,60,16,9,7,21,-4
2452,41,75,9010,36,4,2,2,14,2
2453,41,83,9010,5,2,1,1,2,2
2455,50,83,9010,82,28,14,14,58,-5
2456,53,83,9010,53,17,10,7,18,1
2457,83,66,209491,4,0,0,0,0,-3
2458,86,66,209491,7,0,0,0,4,-2
2460,5,86,38468,74,26,11,15,99,-22
2461,8,86,38468,84,31,12,19,132,-35
2462,11,70,38468,80,44,11,33,66,-12
2463,14,70,38468,47,15,8,7,48,3
2464,17,62,38468,67,14,7,7,38,-6
2465,56,66,10401,5,0,0,0,4,-3
2466,59,66,10401,54,12,2,10,12,5
2467,62,66,10401,13,0,0,0,4,7
2468,62,62,10401,6,0,0,0,0,2
2469,65,62,10401,2,0,0,0,0,-2
2470,68,62,10401,10,1,0,1,0,-1
2471,86,73,200018,1,0,0,0,2,0
2473,59,73,11408,41,11,7,4,18,3
2474,59,71,11408,8,1,1,0,8,-3
2475,62,71,11408,81,25,18,7,34,-5
2476,65,71,11408,79,33,17,16,42,-7
2477,68,71,11408,27,7,2,5,17,0
2478,71,71,11408,52,6,2,4,40,0
2479,53,71,9492,1,0,0,0,0,-1
2480,56,71,9492,46,12,5,7,10,-6
2481,59,71,9492,9,2,0,2,4,-2
2482,62,71,9492,44,10,1,9,20,-8
2483,86,70,178992,19,5,2,3,10,2
2484,68,64,12139,46,5,2,3,70,-7
2485,71,64,12139,82,11,6,5,115,-1
2486,74,64,12139,1,0,0,0,0,0
2487,56,64,9477,3,0,0,0,4,-2
2488,59,64,9477,2,0,0,0,2,1
2492,62,64,9208,74,25,14,11,27,-11
2493,65,64,9208,35,7,4,3,17,-2
2494,68,67,9208,31,9,4,5,10,-1
2495,71,67,9208,12,1,0,1,2,-5
2496,77,79,9208,41,3,0,3,0,-2
2497,80,79,9208,2,0,0,0,0,-1
2498,56,70,2017,14,3,1,2,4,-1
2499,59,70,2017,50,15,5,10,14,2
2500,62,70,2017,75,9,7,2,14,-5
2501,65,70,2017,72,15,6,9,16,-5
2502,68,70,2017,18,1,1,0,4,0
2521,74,87,9135,79,36,14,22,65,-29
2522,77,87,9135,72,47,28,19,98,4
2523,80,87,9135,74,27,6,21,48,-3
2524,53,80,12424,2,0,0,0,0,-2
2526,59,77,645326,11,3,2,1,6,1
2528,59,86,11436,56,11,2,9,27,6
2529,62,86,11436,66,23,9,14,46,10
2530,65,86,11436,76,19,9,10,29,-6
2531,68,69,11436,45,8,4,4,21,-8
2532,71,69,11436,58,9,1,8,21,-3
2533,71,67,11436,9,1,1,0,4,0
2534,74,67,11436,51,13,6,7,26,-6
2535,74,75,11436,14,1,0,1,8,-2
2536,77,75,11436,71,19,11,8,51,2
2537,80,75,11436,78,17,8,9,38,5
2538,83,75,11436,11,0,0,0,2,0
2539,83,88,11436,49,11,6,5,28,-5
2540,50,74,9432,14,6,4,2,9,5
2541,53,74,9432,52,13,8,5,31,7
2395,68,79,11538,46,11,6,5,19,-6
2396,71,86,11538,67,17,4,13,34,-10
2546,68,74,9432,45,31,16,15,12,9
2547,71,74,9432,45,25,11,14,16,-3
2548,71,81,9432,20,11,6,5,8,4
2549,74,81,9432,77,54,24,30,41,9
2550,77,81,9432,73,28,10,18,45,-5
2551,80,81,9432,18,4,2,2,23,-4
2552,83,81,9432,67,18,5,13,29,-4
2553,86,81,9432,52,17,7,10,14,7
2554,20,75,73607,3,0,0,0,0,0
2555,23,75,73607,4,0,0,0,31,0
2556,26,75,73607,1,0,0,0,5,0
2557,53,65,9479,13,4,2,2,6,-1
2558,56,65,9479,78,53,22,31,55,15
2559,59,65,9479,79,44,20,24,35,8
2560,62,83,9479,53,35,14,21,29,-13
2561,62,77,9479,27,11,7,4,24,4
2563,68,68,9479,10,4,2,2,8,-8
2564,71,68,9479,18,7,2,5,9,-9
2565,71,65,9479,63,29,10,19,27,9
2566,74,65,9479,61,34,14,20,35,11
2567,77,66,9479,63,33,11,22,36,-6
2568,77,88,9479,14,5,4,1,9,6
2569,80,62,9479,69,37,15,22,46,-3
2570,83,62,9479,24,8,3,5,6,-8
2571,62,78,12248,41,9,1,8,10,1
2572,65,78,12248,7,0,0,0,4,-5
2573,65,82,12248,54,32,7,25,14,-5
2574,68,82,12248,38,9,3,6,17,2
2575,71,82,12248,66,15,2,13,20,9
2576,74,71,12248,42,10,4,6,12,-12
2577,77,71,12248,11,1,0,1,8,-5
2578,53,65,9412,19,3,2,1,10,1
2580,59,65,9412,3,2,1,1,5,1
2581,62,65,9412,79,21,6,15,63,5
2582,65,70,9412,52,7,2,5,53,-3
2583,68,69,9412,2,0,0,0,0,0
2584,71,69,9412,1,0,0,0,0,-1
2585,2,78,67935,68,20,5,15,204,19
2586,5,63,67935,7,1,1,0,20,-2
2587,8,63,67935,34,10,5,5,102,6
2588,11,63,67935,58,9,1,8,152,-5
2589,14,74,67935,6,1,1,0,18,0
2593,20,62,67935,13,4,1,3,19,-1
2594,2,89,31121,8,4,0,4,0,0
2595,50,71,11006,15,0,0,0,10,-8
2596,53,71,11006,2,0,0,0,0,-1
2597,56,81,4275,6,3,1,2,6,0
2598,47,76,10873,9,0,0,0,0,-1
2600,53,76,10873,8,0,0,0,4,-1
2601,56,78,10873,8,4,3,1,4,-1
2602,83,68,15170,26,4,3,1,7,2
2603,86,68,15170,7,0,0,0,5,-2
2604,50,75,9350,3,0,0,0,0,-2
2605,53,75,9350,24,9,3,6,8,-4
2606,56,83,9350,78,48,20,28,92,-8
2607,59,83,9350,59,35,10,25,10,3
2608,62,83,9350,81,58,29,29,60,14
2609,65,83,9350,74,51,23,28,51,0
2610,68,83,9350,48,16,9,7,24,-10
2611,71,89,9350,58,35,13,22,26,6
2612,74,76,9350,51,19,9,10,8,3
2613,77,76,9350,58,25,9,16,33,3
2614,2,85,8613,77,79,31,48,66,11
2615,5,85,8613,80,86,32,54,72,26
2617,11,85,8613,82,120,56,64,34,48
2618,14,85,8613,42,50,20,30,24,6
2619,17,85,8613,78,107,39,68,48,49
2620,20,85,8613,74,63,30,33,30,29
2621,23,85,8613,21,17,6,11,25,10
2622,26,85,8613,77,63,26,37,66,9
2623,29,85,8613,68,62,27,35,22,8
2624,32,85,8613,75,69,32,37,40,12
2625,35,85,8613,81,68,31,37,36,20
2626,38,85,8613,80,83,36,47,52,15
2627,41,1479,8613,80,65,31,34,42,-5
2628,47,1479,8613,5,1,0,1,2,-1
2629,47,82,8613,62,43,12,31,64,-1
2630,50,82,8613,73,42,18,24,56,-7
2631,53,82,8613,50,28,9,19,30,-3
2632,53,89,8613,18,13,2,11,8,-2
2634,2,72,21361,67,19,3,16,62,5
2635,5,72,21361,70,26,3,23,108,11
2636,8,72,21361,76,27,4,23,158,7
2637,11,72,21361,52,15,1,14,30,14
2638,14,72,21361,4,1,0,1,0,-2
2639,14,85,21361,14,14,3,11,2,3
2640,17,85,21361,69,42,7,35,96,37
2641,20,85,21361,64,28,5,23,76,26
2642,23,85,21361,58,14,2,12,72,4
2643,59,86,15051,3,0,0,0,0,-2
2644,65,72,15051,7,0,0,0,0,-2
2645,2,85,31458,67,35,16,19,38,20
2646,5,85,31458,61,13,5,8,42,-5
2647,8,77,31458,74,59,21,38,48,14
2648,11,77,31458,72,38,20,18,74,-14
2649,14,77,31458,30,12,8,4,14,-2
2651,17,70,31458,41,19,10,9,30,-17
2652,26,74,31458,67,10,4,6,30,-11
2653,62,80,17885,7,0,0,0,0,-4
2654,2,89,67345,7,1,0,1,4,-2
2655,11,1479,67345,50,8,3,5,30,-16
2656,14,1479,67345,14,1,0,1,6,-4
2657,14,85,67345,3,0,0,0,0,0
2658,53,84,9417,19,1,1,0,55,-2
2659,56,84,9417,20,1,0,1,85,-5
2660,56,1479,9417,28,3,2,1,60,-2
2661,59,1479,9417,75,7,6,1,106,1
2662,62,83,9417,50,8,3,5,69,1
2663,65,83,9417,50,4,2,2,74,-8
2664,68,83,9417,12,1,0,1,70,1
2543,59,74,9432,77,37,19,18,48,-12
2544,62,74,9432,60,48,23,25,46,-7
2669,77,86,9417,44,3,1,2,63,-3
2670,77,75,9417,14,2,1,1,27,-2
2671,47,63,10979,6,0,0,0,4,2
2672,50,63,10979,4,0,0,0,0,0
2673,53,76,10979,8,1,1,0,0,-1
2674,56,76,10979,4,0,0,0,0,-2
2675,59,72,10979,2,0,0,0,2,0
2676,2,77,53988,40,5,1,4,28,1
2678,2,83,70457,30,15,5,10,0,-3
2679,2,62,70457,31,12,5,7,10,2
2680,5,86,70457,60,15,11,4,33,-39
2681,20,83,29034,13,0,0,0,6,2
2682,23,83,29034,2,0,0,0,0,1
2683,26,68,29034,6,1,0,1,6,-6
2684,2,83,26141,14,9,5,4,8,-5
2685,5,83,26141,11,4,1,3,4,-11
2687,8,84,26141,36,14,5,9,20,1
2688,23,89,52956,2,0,0,0,0,0
2689,56,62,11738,60,10,1,9,69,3
2690,59,62,11738,57,9,2,7,48,-3
2691,62,62,11738,30,7,1,6,24,3
2692,65,70,11738,36,3,0,3,16,-5
2693,68,67,11738,17,4,0,4,14,4
2694,71,547,11738,60,6,0,6,38,4
2695,74,547,11738,55,9,0,9,40,9
2696,77,547,11738,14,1,0,1,8,-3
2697,77,71,11738,9,3,0,3,6,-4
2698,80,73,11738,4,0,0,0,6,-1
2699,59,88,11412,59,24,11,13,22,13
2700,62,88,11412,5,4,1,3,0,5
2701,65,88,11412,9,2,2,0,14,1
2702,50,67,10982,7,2,0,2,21,3
2704,56,67,10982,51,9,4,5,89,1
2705,59,67,10982,55,15,10,5,89,2
2706,62,67,10982,51,9,4,5,78,-4
2707,65,67,10982,63,10,5,5,116,-5
2708,68,67,10982,34,1,1,0,67,-4
2709,71,67,10982,5,0,0,0,5,-1
2710,74,67,10982,42,3,0,3,36,-11
2711,83,86,192352,3,0,0,0,0,-1
2712,86,86,192352,8,0,0,0,2,1
2713,56,73,11414,7,0,0,0,2,-5
2714,59,73,11414,25,3,2,1,8,-8
2715,62,68,11414,82,41,20,21,20,-17
2716,65,68,11414,60,11,9,2,18,-10
2717,68,68,11414,24,3,2,1,2,-7
2718,68,547,11414,10,1,0,1,0,-5
2719,71,84,11414,49,28,10,18,6,9
2721,74,73,11414,22,4,1,3,6,-7
2722,77,1479,11414,70,18,9,9,8,-4
2723,50,78,243137,19,0,0,0,6,-3
2724,53,78,243137,6,1,0,1,0,1
2725,56,78,243137,69,15,1,14,45,-15
2726,59,78,243137,78,21,4,17,59,7
2727,62,78,243137,55,12,3,9,33,-4
2728,65,78,243137,77,11,0,11,57,6
2729,68,78,243137,48,6,1,5,48,-2
2730,71,78,243137,72,13,4,9,71,3
2731,74,83,243137,56,9,5,4,48,-22
2732,77,83,243137,55,13,1,12,56,8
2733,77,86,243137,24,3,0,3,16,-2
2734,80,83,243137,75,11,4,7,65,10
2735,83,83,243137,54,12,2,10,46,5
2736,86,70,243137,77,9,1,8,69,6
2738,59,64,12365,3,0,0,0,0,0
2740,2,76,13933,61,35,19,16,52,-11
2741,5,76,13933,80,80,40,40,92,25
2742,8,76,13933,46,27,14,13,40,0
2743,11,76,13933,82,53,21,32,83,1
2744,14,76,13933,47,43,22,21,30,1
2745,17,74,13933,65,54,25,29,82,13
2746,17,88,13933,11,6,4,2,10,-13
2747,20,88,13933,81,46,25,21,112,-22
2748,23,88,13933,40,15,6,9,42,-10
2749,26,88,13933,65,31,13,18,59,0
2753,35,78,13933,15,10,6,4,8,2
2754,53,83,9408,9,1,0,1,0,-2
2755,59,69,9408,32,6,6,0,6,1
2756,62,69,9408,6,0,0,0,0,-3
2762,17,81,71089,16,0,0,0,24,-6
2764,20,88,71089,54,5,2,3,84,-8
2765,2,76,44038,11,0,0,0,4,-1
2766,5,76,44038,51,11,1,10,26,-6
2767,11,77,44038,55,9,1,8,24,16
2770,23,74,44038,63,7,1,6,55,-3
2771,26,74,44038,2,0,0,0,0,-1
2772,26,78,44038,30,3,1,2,20,12
2773,29,78,44038,74,10,2,8,38,26
2774,32,78,44038,72,10,2,8,38,7
2775,35,78,44038,78,6,0,6,30,12
2776,38,78,44038,64,4,1,3,46,-2
2777,41,78,44038,53,1,0,1,34,-9
2778,83,65,248408,4,1,1,0,0,-1
2779,2,76,9150,41,10,5,5,24,-9
2780,5,76,9150,45,17,6,11,28,-3
2781,8,76,9150,77,27,9,18,34,-2
2783,14,68,9150,48,16,3,13,31,-3
2784,17,68,9150,82,34,13,21,75,-3
2785,20,68,9150,71,24,10,14,64,7
2786,23,68,9150,69,15,10,5,57,-4
2787,23,64,9150,11,3,2,1,22,0
2788,26,73,9150,80,32,13,19,48,-18
2789,29,73,9150,82,22,13,9,66,-18
2790,32,73,9150,82,18,9,9,71,-5
2791,35,73,9150,63,16,7,9,33,-4
2792,35,65,9150,15,4,1,3,6,-3
2793,38,83,9150,66,17,4,13,57,10
2794,41,83,9150,69,17,7,10,52,-2
2795,47,63,9150,71,10,4,6,40,-10
2796,2,77,73027,2,0,0,0,0,0
2666,71,71,9417,8,0,0,0,19,1
2667,71,86,9417,48,5,2,3,75,-10
2802,62,74,9428,4,1,0,1,2,-1
2803,56,89,11448,1,0,0,0,0,0
2804,59,89,11448,2,0,0,0,0,-2
2805,62,89,11448,9,2,1,1,0,-2
2806,65,1479,11448,37,5,2,3,6,-10
2807,68,84,11448,6,0,0,0,0,-1
2808,56,64,11585,12,0,0,0,8,-5
2809,62,81,11585,10,1,0,1,2,-2
2810,2,76,31694,56,45,20,25,74,-2
2811,5,76,31694,38,36,8,28,31,14
2812,8,76,31694,80,60,13,47,63,5
2813,11,76,31694,64,42,12,30,40,12
2814,14,76,31694,45,27,7,20,12,9
2815,17,76,31694,56,17,8,9,21,-24
2816,20,74,31694,68,22,10,12,26,6
2817,53,65,4276,12,5,0,5,6,5
2819,56,67,8952,7,2,1,1,4,-4
2820,59,67,8952,6,2,1,1,4,3
2821,62,67,8952,20,8,1,7,12,-1
2822,65,84,8952,6,0,0,0,0,0
2823,83,1479,156144,1,0,0,0,0,-1
2824,2,62,21308,79,104,51,53,136,48
2825,5,62,21308,80,73,33,40,133,0
2826,8,62,21308,83,100,34,66,88,14
2827,11,62,21308,83,85,40,45,186,30
2828,14,62,21308,47,58,29,29,112,6
2829,17,62,21308,80,96,46,50,112,17
2830,20,62,21308,81,67,29,38,104,-12
2831,23,62,21308,82,78,27,51,197,0
2832,26,62,21308,60,69,30,39,68,18
2833,26,64,21308,15,24,10,14,18,8
2834,29,74,21308,80,64,15,49,68,-4
2836,35,74,21308,82,63,24,39,216,0
2837,38,65,21308,54,33,12,21,77,-7
2838,32,85,20543,25,3,1,2,23,-1
2839,35,85,20543,39,3,1,2,40,0
2840,38,85,20543,53,3,0,3,54,0
2841,38,88,20543,3,0,0,0,0,1
2842,41,88,20543,16,1,0,1,20,-5
2843,50,65,10666,10,0,0,0,7,-7
2844,53,65,10666,2,1,0,1,0,1
2845,56,65,10666,69,26,10,16,50,7
2846,59,65,10666,78,40,22,18,66,9
2847,62,65,10666,79,36,17,19,38,-2
2848,65,89,10666,82,33,18,15,61,-15
2849,68,89,10666,47,33,19,14,28,-5
2850,71,89,10666,82,43,25,18,92,-6
2851,74,89,10666,82,43,21,22,53,11
2853,80,62,10666,74,25,13,12,31,-11
2854,83,62,10666,76,22,6,16,53,-7
2855,86,68,10666,75,21,12,9,47,-6
2856,56,72,15204,8,1,0,1,22,3
2857,59,72,15204,27,2,0,2,48,-4
2858,62,72,15204,2,0,0,0,21,-2
2859,65,62,15204,3,0,0,0,10,1
2860,71,79,15204,1,0,0,0,0,0
2861,59,72,11916,3,1,0,1,4,0
2862,62,72,11916,4,0,0,0,0,-1
2863,26,64,28894,1,0,0,0,0,0
2864,32,82,28894,2,0,0,0,4,0
2865,53,63,9426,13,1,0,1,4,-1
2866,56,63,9426,53,27,6,21,31,15
2867,59,63,9426,76,14,6,8,32,-16
2868,62,63,9426,22,3,1,2,9,4
2870,65,64,9426,33,6,3,3,8,-3
2871,68,64,9426,43,6,0,6,16,4
2872,71,64,9426,1,0,0,0,0,0
2873,74,74,9426,55,11,2,9,16,17
2874,77,83,9426,60,10,2,8,32,-17
2875,80,83,9426,72,19,1,18,18,8
2876,83,79,9426,42,10,4,6,21,-4
2877,86,67,9426,14,2,0,2,4,-7
2880,8,79,38469,12,4,0,4,4,-3
2881,11,75,38469,13,3,1,2,10,-4
2882,14,75,38469,21,7,5,2,34,-3
2883,59,64,11884,32,19,11,8,22,5
2884,62,64,11884,71,22,12,10,54,-22
2885,65,64,11884,10,0,0,0,8,1
2886,65,73,11884,25,7,3,4,20,0
2887,68,73,11884,34,8,3,5,26,-3
2890,35,1479,8545,45,9,4,5,10,2
2891,38,1479,8545,70,7,3,4,40,-9
2892,41,69,8545,45,21,11,10,17,4
2893,47,69,8545,74,30,14,16,34,1
2894,50,84,8545,42,4,2,2,10,-2
2895,2,67,21397,31,9,4,5,42,4
2896,2,83,21397,37,15,8,7,65,-3
2897,5,83,21397,33,14,6,8,50,-3
2898,8,83,21397,55,18,13,5,84,2
2899,11,83,21397,4,0,0,0,4,0
2900,11,68,21397,39,9,4,5,49,7
2901,50,67,10352,4,0,0,0,0,0
2902,59,70,9498,2,0,0,0,0,0
2903,62,70,9498,19,2,0,2,0,-3
2904,65,547,9498,7,0,0,0,0,-1
2905,68,547,9498,10,3,3,0,2,2
2907,80,77,42447,47,6,4,2,8,-2
2908,53,75,14192,1,0,0,0,5,0
2909,56,75,14192,20,1,0,1,32,-4
2910,59,75,14192,5,0,0,0,11,-3
2911,83,20120,19539,3,1,1,0,2,3
2912,86,65,131662,24,6,3,3,2,-6
2913,5,86,76695,1,0,0,0,0,0
2914,8,86,76695,1,0,0,0,0,-1
2915,62,70,11447,3,0,0,0,0,0
2916,71,70,11447,4,1,0,1,0,2
2917,74,70,11447,6,0,0,0,0,1
2921,62,64,11479,80,26,11,15,35,-2
2922,65,64,11479,63,18,5,13,42,-11
2923,65,86,11479,21,5,3,2,10,0
2799,20,83,39323,3,0,0,0,0,0
2800,29,89,2703,2,1,0,1,2,1
2928,77,83,11479,56,14,4,10,16,-3
2929,77,89,11479,20,5,2,3,22,7
2930,80,89,11479,72,25,12,13,49,15
2931,83,69,11479,81,23,6,17,27,5
2932,56,66,9613,2,1,0,1,0,1
2933,56,79,4281,7,0,0,0,0,-3
2934,59,82,15050,11,3,1,2,6,0
2935,62,82,15050,31,19,4,15,16,2
2936,65,82,15050,51,14,4,10,24,-6
2937,65,547,15050,12,3,0,3,8,-3
2938,68,547,15050,44,16,4,12,18,10
2939,71,547,15050,32,12,2,10,18,-5
2940,74,547,15050,24,4,0,4,8,4
2941,86,83,87902,25,8,2,6,2,1
2942,59,89,11748,2,2,0,2,0,1
2943,62,82,11748,32,11,4,7,12,-3
2945,62,78,14458,24,7,3,4,8,1
2946,65,78,14458,2,1,1,0,0,1
2947,68,78,14458,20,6,2,4,4,3
2948,71,78,14458,19,2,0,2,0,0
2949,74,82,14458,17,1,0,1,2,-8
2950,77,84,14458,44,10,5,5,14,1
2951,77,71,14458,8,0,0,0,6,-2
2952,80,70,14458,69,16,10,6,12,9
2953,83,70,14458,1,0,0,0,0,0
2954,83,74,14458,4,0,0,0,0,-1
2955,86,1479,14458,2,0,0,0,0,-1
2956,53,84,2364,5,0,0,0,2,0
2957,56,84,2364,55,21,6,15,37,5
2958,59,84,2364,47,15,9,6,18,-5
2959,62,84,2364,82,29,9,20,32,13
2960,65,84,2364,82,39,16,23,34,18
2962,71,84,2364,71,20,11,9,43,-9
2963,74,84,2364,81,33,16,17,27,-6
2964,77,84,2364,67,38,22,16,32,16
2965,80,84,2364,28,13,6,7,27,2
2966,80,86,2364,15,7,2,5,7,0
2967,83,86,2364,46,14,2,12,15,2
2968,23,89,14735,2,0,0,0,2,0
2969,26,68,14735,9,0,0,0,0,-1
2970,29,68,14735,6,0,0,0,2,-2
2977,59,62,9087,73,58,27,31,88,7
2978,62,62,9087,80,50,27,23,42,-17
2979,65,62,9087,38,16,13,3,41,-3
2980,65,75,9087,38,8,5,3,27,-16
2981,68,75,9087,27,13,7,6,32,-1
2982,71,75,9087,63,16,9,7,32,-1
2983,74,75,9087,13,2,0,2,6,-9
2984,74,1479,9087,30,8,2,6,12,-4
2985,74,82,9087,8,4,4,0,4,-2
2986,77,82,9087,49,8,3,5,38,-9
2987,80,64,9087,65,18,12,6,56,-19
2988,62,72,11347,18,0,0,0,4,-4
2991,8,80,27897,10,1,0,1,6,-7
2992,8,88,27897,6,0,0,0,5,-2
2993,5,77,53464,25,7,3,4,20,-14
2994,17,79,53464,11,4,2,2,2,-2
2995,20,76,53464,7,0,0,0,2,-2
2996,50,73,11018,13,1,0,1,0,-1
2997,53,73,11018,33,10,5,5,8,4
2998,56,73,11018,27,9,2,7,15,-3
3002,62,63,11018,23,7,4,3,2,-1
3003,65,63,11018,57,42,11,31,22,20
3004,68,63,11018,47,18,6,12,16,-9
3005,71,70,11018,62,30,7,23,15,-3
3006,56,86,10618,2,0,0,0,2,-1
3007,56,86,10639,35,3,1,2,76,0
3008,59,86,10639,47,6,3,3,110,0
3009,62,69,10639,71,9,4,5,173,-5
3010,65,69,10639,43,0,0,0,73,-7
3011,65,75,10639,19,1,1,0,48,2
3012,68,1479,10639,15,2,1,1,41,0
3013,47,88,14329,12,1,0,1,2,-4
3015,2,79,21345,14,11,2,9,21,0
3016,5,79,21345,70,54,21,33,30,-7
3017,8,79,21345,84,100,24,76,68,6
3018,11,79,21345,82,93,27,66,62,-3
3019,14,79,21345,44,59,11,48,18,30
3020,17,79,21345,77,119,27,92,56,25
3021,20,79,21345,81,90,27,63,20,7
3022,23,79,21345,81,87,25,62,20,12
3023,26,66,21345,82,52,21,31,34,-2
3024,29,66,21345,78,73,23,50,18,10
3025,32,66,21345,82,65,15,50,32,-15
3026,35,66,21345,80,77,27,50,18,4
3027,38,66,21345,82,57,22,35,30,-22
3028,41,66,21345,68,30,10,20,14,-12
3029,41,83,21345,12,10,3,7,0,3
3030,2,83,68601,16,2,1,1,30,-2
3031,2,67,68601,35,8,1,7,28,2
3032,5,67,68601,1,0,0,0,0,0
3033,14,88,27906,32,9,2,7,20,-6
3034,17,88,27906,46,10,5,5,32,-16
3036,2,62,23302,67,21,7,14,160,12
3037,5,62,23302,78,12,4,8,103,12
3038,8,62,23302,80,16,6,10,131,28
3039,11,62,23302,75,9,1,8,50,38
3040,14,62,23302,35,5,0,5,61,6
3041,17,80,23302,65,4,1,3,85,-10
3042,20,80,23302,57,5,0,5,58,6
3043,23,71,23302,17,3,1,2,8,1
3044,26,71,23302,39,3,0,3,34,0
3045,32,71,23302,13,2,0,2,4,-2
3046,26,88,7283,29,16,4,12,6,0
3047,29,88,7283,3,0,0,0,0,-1
3048,38,88,7283,2,0,0,0,0,-1
3049,41,88,7283,2,2,1,1,0,1
3050,2,88,70559,57,11,3,8,182,14
2925,71,1479,11479,76,30,6,24,23,6
2926,74,83,11479,58,25,7,18,19,15
3055,5,77,68890,50,13,6,7,18,-1
3056,8,80,68890,63,24,10,14,39,-35
3057,11,62,68890,2,0,0,0,4,0
3058,23,64,8557,1,0,0,0,0,0
3059,32,64,8557,9,0,0,0,0,1
3060,35,64,8557,50,9,2,7,47,4
3061,38,64,8557,6,3,0,3,2,3
3062,41,64,8557,26,4,2,2,11,2
3067,83,67,47522,47,10,0,10,18,-9
3068,20,1479,8989,5,2,1,1,0,2
3069,23,1479,8989,7,0,0,0,6,-6
3070,26,1479,8989,7,0,0,0,4,-2
3071,29,1479,8989,69,19,8,11,70,-15
3072,32,1479,8989,54,35,15,20,26,-1
3073,35,1479,8989,82,44,20,24,107,-12
3074,38,1479,8989,57,28,9,19,34,-8
3077,47,62,8989,15,5,1,4,8,0
3078,5,86,52005,48,12,6,6,326,-27
3079,5,67,53794,9,1,0,1,2,-1
3083,11,70,12589,76,61,32,29,83,13
3084,14,70,12589,48,42,14,28,42,2
3085,17,70,12589,45,27,14,13,44,-17
3086,17,83,12589,28,22,7,15,59,-2
3087,20,62,12589,82,60,27,33,48,2
3088,23,68,12589,78,48,20,28,55,-21
3089,26,68,12589,36,14,4,10,39,-7
3090,26,84,12589,33,14,2,12,24,-9
3091,2,85,72251,45,26,10,16,111,6
3092,5,85,72251,69,36,14,22,187,16
3093,8,85,72251,67,30,10,20,188,20
3094,11,81,72251,51,13,4,9,74,-6
3095,14,81,72251,1,0,0,0,0,0
3097,5,63,32088,38,14,2,12,83,-3
3098,5,77,32088,39,18,3,15,34,1
3099,8,77,32088,83,62,13,49,115,18
3100,11,77,32088,81,70,10,60,91,-11
3101,14,77,32088,33,22,2,20,20,0
3102,14,67,32088,14,10,1,9,10,4
3103,17,67,32088,78,54,10,44,81,-2
3104,20,67,32088,71,38,4,34,102,10
3105,23,88,32088,74,37,9,28,63,-5
3106,26,88,32088,60,16,4,12,30,-9
3107,29,88,32088,70,30,9,21,52,9
3108,32,76,32088,56,20,6,14,59,-4
3109,23,85,42468,2,0,0,0,0,0
3110,26,85,42468,3,0,0,0,0,0
3111,29,85,42468,30,6,0,6,10,-2
3112,86,84,223526,4,1,0,1,5,-4
3114,26,70,29041,2,0,0,0,2,0
3118,35,62,29041,32,4,1,3,14,4
3119,38,62,29041,44,8,3,5,14,-6
3120,86,547,222180,5,1,0,1,0,0
3121,23,70,707610,9,0,0,0,2,-5
3122,26,70,707610,22,5,1,4,6,5
3123,26,81,707610,14,3,0,3,10,-8
3124,29,81,707610,28,5,2,3,6,-9
3125,32,81,707610,16,1,1,0,10,-3
3126,47,84,11024,5,1,1,0,4,1
3127,50,84,11024,2,0,0,0,5,0
3128,53,84,11024,22,3,1,2,41,-5
3129,56,84,11024,12,3,3,0,19,-3
3130,59,84,11024,69,8,4,4,126,-3
3131,62,84,11024,9,1,0,1,31,-5
3132,50,1479,9442,53,11,2,9,10,-2
3134,56,80,9442,35,20,8,12,2,-1
3135,59,80,9442,66,16,5,11,20,-12
3136,62,80,9442,79,27,11,16,24,3
3137,65,81,9442,45,12,4,8,10,-11
3138,56,71,9742,1,0,0,0,0,0
3139,59,72,9742,9,1,0,1,2,-2
3140,62,72,9742,36,2,0,2,9,-5
3141,65,72,9742,18,0,0,0,7,-5
3142,68,72,9742,6,0,0,0,2,1
3143,71,72,9742,16,3,0,3,2,1
3144,74,72,9742,15,2,0,2,33,-1
3145,53,86,10619,1,0,0,0,0,-1
3146,56,76,10619,11,5,1,4,4,-3
3147,2,74,22101,79,69,49,20,53,-9
3148,5,74,22101,76,81,40,41,55,11
3149,8,74,22101,84,68,45,23,59,-4
3151,11,83,22101,10,12,6,6,4,9
3152,14,83,22101,38,20,12,8,6,0
3153,17,83,22101,82,54,35,19,52,5
3156,2,85,189,71,40,18,22,18,-4
3157,5,85,189,16,2,1,1,4,2
3158,5,86,189,12,11,5,6,4,-2
3159,8,86,189,79,66,22,44,56,-26
3160,11,86,189,80,53,18,35,28,9
3161,14,86,189,13,2,1,1,2,-3
3162,14,68,189,27,12,3,9,0,4
3163,17,68,189,82,51,23,28,36,-10
3164,20,68,189,53,36,11,25,47,10
3165,23,68,189,39,5,2,3,8,-6
3166,26,68,189,64,17,8,9,42,-9
3168,2,75,73767,3,0,0,0,2,1
3169,53,64,10407,49,9,4,5,120,-6
3171,59,64,10407,74,18,7,11,138,-13
3172,62,64,10407,71,8,5,3,189,-7
3173,65,64,10407,75,11,6,5,164,0
3174,68,64,10407,48,12,8,4,83,4
3175,71,64,10407,71,13,5,8,122,2
3176,74,64,10407,82,12,7,5,191,-2
3177,77,64,10407,82,13,8,5,138,1
3178,80,64,10407,28,1,1,0,52,-2
3179,80,73,10407,31,5,4,1,93,-1
3180,83,73,10407,23,2,1,1,72,0
3181,83,74,10407,25,2,0,2,39,-11
3182,86,74,10407,31,1,1,0,60,-10
3183,86,73,10407,7,0,0,0,7,-3
3184,50,65,9192,9,0,0,0,10,-5
3052,5,65,70559,42,4,0,4,80,-12
3053,8,65,70559,4,0,0,0,26,2
3189,68,75,9192,5,0,0,0,4,-1
3190,71,75,9192,7,0,0,0,5,-2
3191,74,81,9192,2,0,0,0,2,-1
3192,77,81,9192,20,5,3,2,34,3
3193,80,80,9192,2,0,0,0,4,0
3194,83,80,9192,1,0,0,0,0,0
3195,53,84,11354,49,21,9,12,2,1
3196,56,84,11354,72,23,11,12,24,2
3197,59,84,11354,82,53,25,28,48,0
3198,62,84,11354,70,39,15,24,10,8
3199,65,84,11354,55,20,10,10,18,4
3200,68,84,11354,46,22,10,12,16,2
3201,71,83,11354,82,45,19,26,22,-6
3202,74,62,11354,57,23,12,11,8,-8
3203,77,62,11354,29,5,4,1,8,-3
3204,80,1479,11354,4,0,0,0,0,-2
3206,35,73,14736,3,0,0,0,5,-1
3207,2,71,233743,73,40,20,20,34,-7
3208,5,71,233743,68,29,11,18,62,14
3209,8,71,233743,65,23,11,12,30,3
3211,11,84,233743,33,16,8,8,26,-6
3212,14,84,233743,46,23,13,10,36,8
3213,17,84,233743,81,56,30,26,59,8
3214,20,84,233743,74,68,35,33,42,6
3215,23,84,233743,24,8,4,4,10,-6
3216,23,66,233743,40,26,12,14,30,1
3217,26,66,233743,76,28,13,15,67,3
3218,29,66,233743,81,30,14,16,40,-10
3219,32,66,233743,79,52,23,29,59,-4
3220,35,66,233743,72,29,13,16,30,-1
3221,38,62,233743,81,52,21,31,51,-3
3222,41,62,233743,76,35,17,18,70,10
3224,50,68,233743,82,44,14,30,36,7
3225,53,73,233743,57,20,9,11,20,5
3226,53,85,2047,2,1,0,1,0,0
3227,59,85,2047,5,0,0,0,0,0
3228,62,81,2047,31,8,4,4,11,-5
3229,65,81,2047,5,0,0,0,6,-2
3230,50,64,10208,82,78,28,50,42,4
3231,53,64,10208,66,71,24,47,24,22
3232,56,64,10208,45,36,11,25,22,-9
3233,59,64,10208,81,79,20,59,50,2
3234,62,64,10208,74,57,22,35,56,-7
3235,65,64,10208,79,53,21,32,34,-8
3236,68,64,10208,40,24,9,15,14,-7
3237,71,64,10208,71,60,25,35,22,9
3238,74,78,10208,74,46,16,30,40,5
3239,77,78,10208,64,49,10,39,26,3
3241,83,78,10208,63,40,12,28,14,-5
3242,83,547,10208,19,13,4,9,4,6
3243,86,20120,10208,50,42,13,29,30,14
3244,50,75,9190,80,29,16,13,47,-20
3245,53,75,9190,73,27,16,11,41,-2
3246,56,75,9190,56,26,14,12,45,4
3247,59,75,9190,23,3,2,1,4,-4
3248,59,69,9190,55,37,25,12,12,1
3249,62,69,9190,11,6,3,3,8,2
3250,65,69,9190,16,9,5,4,20,6
3251,68,80,9190,27,10,6,4,8,-2
3252,59,76,10430,22,4,0,4,4,-2
3253,47,79,6142,81,102,39,63,110,-1
3254,50,79,6142,79,120,36,84,60,10
3255,53,79,6142,53,72,24,48,39,18
3256,56,79,6142,77,103,33,70,76,3
3258,62,79,6142,41,66,32,34,31,20
3259,65,79,6142,22,37,8,29,14,15
3260,68,79,6142,36,56,15,41,16,26
3261,71,79,6142,80,104,36,68,46,18
3262,74,79,6142,77,84,28,56,47,5
3263,77,79,6142,80,85,36,49,42,19
3264,80,79,6142,75,89,44,45,24,17
3265,83,79,6142,82,89,29,60,46,0
3266,86,79,6142,79,100,35,65,36,18
3267,53,1479,9206,23,10,5,5,6,-1
3268,56,1479,9206,64,57,31,26,33,13
3269,59,1479,9206,81,64,35,29,81,9
3270,62,1479,9206,82,71,34,37,61,15
3271,65,1479,9206,82,57,31,26,53,1
3272,68,1479,9206,46,30,11,19,17,3
3273,71,80,9206,70,48,23,25,45,7
3275,77,80,9206,81,56,22,34,28,-9
3276,80,80,9206,62,25,13,12,24,-3
3277,83,80,9206,62,33,11,22,14,-12
3278,86,80,9206,78,42,15,27,35,-29
3279,50,88,9203,5,0,0,0,18,-5
3280,53,88,9203,74,11,3,8,76,-19
3281,56,88,9203,41,11,6,5,46,-18
3282,59,88,9203,80,36,8,28,48,-15
3283,62,88,9203,82,42,5,37,44,-21
3284,65,88,9203,61,24,8,16,24,-12
3285,65,82,9203,21,14,4,10,15,5
3286,68,82,9203,44,19,5,14,12,-5
3287,71,82,9203,82,33,5,28,48,-7
3288,74,82,9203,79,40,8,32,44,-13
3289,77,82,9203,60,14,6,8,25,-16
3290,80,82,9203,82,23,5,18,32,23
3292,86,79,9203,82,13,1,12,41,-4
3293,50,69,4223,3,0,0,0,0,-1
3294,53,69,4223,11,3,2,1,0,-1
3295,56,69,4223,37,11,5,6,18,1
3296,59,69,4223,14,4,2,2,12,0
3297,59,75,4223,39,24,15,9,31,8
3298,62,75,4223,79,30,13,17,87,2
3299,65,63,4223,74,32,16,16,38,18
3300,68,81,4223,34,20,8,12,15,8
3301,71,74,4223,80,36,15,21,56,10
3302,74,71,4223,58,34,19,15,28,-1
3303,77,71,4223,55,36,14,22,30,-6
3304,80,71,4223,67,14,8,6,34,-5
3305,83,67,4223,74,19,13,6,22,-8
3186,59,82,9192,40,4,2,2,59,3
3187,62,82,9192,1,0,0,0,0,-1
3310,59,65,9213,6,2,1,1,0,-3
3311,62,65,9213,49,17,7,10,25,3
3312,62,68,9213,13,2,1,1,4,-12
3313,65,68,9213,46,10,4,6,28,-9
3314,68,68,9213,40,12,3,9,11,-9
3315,71,82,9213,16,4,4,0,6,2
3316,74,82,9213,45,8,6,2,16,-18
3317,77,64,9213,74,14,8,6,11,-4
3318,80,84,9213,55,9,5,4,12,0
3319,53,80,8991,6,1,0,1,4,1
3320,56,80,8991,53,13,2,11,33,-2
3321,59,80,8991,23,3,2,1,12,-5
3322,62,80,8991,50,3,0,3,24,-10
3323,65,80,8991,35,8,1,7,27,-2
3324,65,81,8991,20,8,0,8,8,-6
3325,68,81,8991,22,0,0,0,16,-13
3327,56,86,9358,81,65,31,34,25,16
3328,59,86,9358,70,36,20,16,19,0
3329,62,86,9358,72,41,22,19,37,-2
3330,65,69,9358,69,36,19,17,28,-17
3331,68,69,9358,48,27,13,14,20,5
3332,71,547,9358,75,27,11,16,22,-7
3333,74,62,9358,12,0,0,0,4,-7
3334,80,88,9358,45,12,4,8,14,-5
3335,47,82,10231,7,4,2,2,0,-2
3336,50,82,10231,78,19,9,10,28,-21
3337,53,82,10231,61,9,1,8,24,-4
3338,56,71,10231,11,3,2,1,12,-3
3339,59,71,10231,65,37,17,20,38,-8
3340,62,71,10231,41,9,7,2,41,-7
3343,53,74,9179,80,10,2,8,42,2
3344,56,74,9179,82,15,3,12,64,-7
3346,62,74,9179,77,29,7,22,50,8
3347,65,74,9179,46,5,2,3,16,-7
3348,68,74,9179,21,11,2,9,14,4
3349,71,74,9179,72,14,3,11,24,-1
3350,74,74,9179,80,20,5,15,42,18
3351,77,74,9179,77,15,2,13,36,2
3352,80,74,9179,72,10,3,7,34,9
3353,83,74,9179,72,8,1,7,18,11
3354,86,74,9179,79,13,3,10,32,-9
3355,50,84,9180,9,0,0,0,4,-1
3356,53,84,9180,27,2,2,0,20,7
3357,50,88,4227,72,61,20,41,24,-12
3358,53,88,4227,82,77,32,45,22,-15
3359,56,88,4227,82,66,27,39,32,-17
3360,59,88,4227,82,81,34,47,16,6
3361,62,88,4227,75,73,25,48,20,25
3363,68,88,4227,47,42,10,32,16,14
3364,71,88,4227,82,70,29,41,24,34
3365,74,88,4227,79,64,16,48,10,-2
3366,77,88,4227,81,74,25,49,16,34
3367,80,88,4227,76,52,12,40,28,-10
3368,83,88,4227,82,92,35,57,20,21
3369,86,88,4227,81,60,22,38,30,-20
3370,59,71,9196,3,1,0,1,0,0
3371,62,71,9196,21,5,1,4,13,-2
3372,65,71,9196,7,1,0,1,4,0
3373,65,1479,9196,2,0,0,0,0,-1
3381,74,87,9231,37,24,8,16,31,-1
3382,77,87,9231,64,41,13,28,77,-5
3383,80,87,9231,51,26,16,10,43,-15
3384,80,69,9231,20,13,4,9,10,-2
3385,83,70,9231,38,10,5,5,23,-14
3387,50,77,9181,1,0,0,0,0,0
3388,53,77,9181,22,0,0,0,6,-4
3389,56,77,9181,31,4,0,4,10,3
3390,59,77,9181,48,3,1,2,20,-14
3391,62,84,9181,4,0,0,0,0,-3
3392,59,85,9225,3,0,0,0,0,-2
3393,62,85,9225,48,4,2,2,36,-6
3394,65,85,9225,55,13,1,12,25,7
3395,68,85,9225,41,13,4,9,28,15
3396,71,85,9225,66,19,2,17,24,-4
3397,74,85,9225,35,13,5,8,22,2
3398,77,85,9225,25,6,2,4,14,3
3399,77,68,9225,19,2,0,2,4,10
3400,80,68,9225,39,4,0,4,28,-11
3401,56,68,10437,3,0,0,0,2,-1
3402,59,68,10437,19,3,1,2,29,-4
3404,65,547,10437,9,0,0,0,4,-3
3405,50,63,10297,12,2,0,2,12,-6
3406,53,63,10297,18,5,1,4,0,-2
3407,56,63,10297,16,1,0,1,10,1
3408,56,81,10297,12,7,0,7,10,-7
3409,59,81,10297,5,0,0,0,21,-2
3410,62,83,10297,11,1,0,1,6,1
3411,53,72,2043,1,0,0,0,0,-1
3412,56,72,2043,8,1,1,0,0,-1
3413,59,72,2043,54,27,13,14,10,-7
3416,62,68,2043,20,7,1,6,2,2
3417,65,73,2043,11,2,1,1,2,-2
3418,56,78,9204,57,39,14,25,30,16
3419,59,78,9204,76,48,18,30,36,-1
3420,62,78,9204,49,34,12,22,15,10
3421,65,78,9204,80,54,19,35,50,15
3423,71,78,9204,79,60,21,39,42,19
3424,74,78,9204,72,55,19,36,51,17
3425,77,89,9204,80,51,26,25,34,16
3426,80,89,9204,68,56,33,23,36,28
3427,83,89,9204,74,47,18,29,31,2
3428,86,89,9204,69,54,25,29,36,5
3429,47,78,13955,5,3,1,2,10,0
3430,56,62,11244,5,3,0,3,9,1
3431,68,86,11244,2,0,0,0,7,0
3432,71,86,11244,6,1,1,0,22,1
3433,65,67,12203,5,0,0,0,12,-3
3434,68,76,12203,16,1,0,1,20,-5
3435,53,70,9211,78,26,7,19,36,22
3436,56,70,9211,80,35,6,29,52,-11
3307,47,68,8731,3,0,0,0,0,0
3308,53,65,9213,16,5,3,2,0,1
3441,68,79,9211,40,14,4,10,12,4
3442,71,79,9211,81,46,10,36,51,33
3443,74,89,9211,82,31,4,27,47,7
3444,77,89,9211,82,32,5,27,38,10
3445,80,89,9211,78,39,5,34,32,20
3446,83,89,9211,68,29,7,22,36,24
3447,86,89,9211,80,25,8,17,41,-3
3448,53,77,9183,32,12,6,6,73,2
3449,56,77,9183,6,0,0,0,11,-4
3450,56,81,9183,23,6,3,3,54,2
3451,59,81,9183,79,46,22,24,208,14
3452,62,81,9183,57,32,10,22,171,8
3453,65,81,9183,55,28,12,16,121,-15
3454,65,64,9183,20,13,2,11,16,9
3455,68,64,9183,2,1,0,1,6,1
3456,71,64,9183,11,7,1,6,36,4
3458,74,79,9183,72,28,14,14,238,2
3459,77,87,9183,26,6,3,3,53,1
3460,56,81,9246,11,3,0,3,6,-3
3461,59,81,9246,4,0,0,0,2,-4
3462,56,1479,9347,34,2,0,2,17,0
3463,59,1479,9347,28,2,0,2,14,-5
3464,62,1479,9347,5,1,0,1,7,-1
3465,62,62,9347,19,1,0,1,2,-5
3466,65,81,9347,41,3,1,2,13,-4
3467,68,81,9347,4,1,0,1,6,1
3468,53,71,9182,82,45,18,27,20,1
3469,56,71,9182,82,38,18,20,22,-6
3470,59,71,9182,82,28,10,18,31,-5
3471,62,71,9182,82,35,11,24,64,-12
3472,65,1479,9182,82,26,13,13,15,-4
3473,68,1479,9182,48,23,13,10,6,14
3475,74,1479,9182,82,29,15,14,14,5
3476,77,1479,9182,82,32,9,23,28,2
3477,80,1479,9182,82,35,16,19,26,11
3478,83,1479,9182,80,35,12,23,41,18
3479,86,1479,9182,46,11,3,8,14,2
3480,86,70,9182,32,6,3,3,8,-1
3481,56,70,9360,77,37,24,13,51,-11
3482,59,70,9360,78,55,27,28,64,-5
3483,62,70,9360,59,39,21,18,60,8
3484,62,79,9360,20,6,1,5,6,-1
3485,65,79,9360,80,81,40,41,87,6
3486,68,79,9360,40,36,21,15,26,5
3487,71,79,9360,59,61,27,34,55,15
3488,74,73,9360,67,37,23,14,57,12
3489,77,73,9360,82,58,31,27,65,27
3490,80,73,9360,70,41,23,18,35,-10
3492,86,62,9360,63,19,7,12,28,-5
3493,59,64,9371,12,3,2,1,0,-3
3494,62,64,9371,25,4,2,2,20,-4
3495,71,89,9371,3,0,0,0,0,-1
3496,35,84,10634,27,8,3,5,14,-4
3497,56,71,9202,2,0,0,0,0,-4
3498,59,71,9202,42,3,0,3,12,-21
3499,62,71,9202,12,4,1,3,4,-5
3500,65,78,9202,2,0,0,0,0,0
3501,65,71,9202,3,0,0,0,0,-1
3502,74,79,9202,7,0,0,0,0,-1
3503,77,89,9202,55,6,1,5,21,8
3504,80,89,9202,18,5,1,4,11,8
3505,83,89,9202,24,4,1,3,8,8
3506,83,82,9202,1,0,0,0,0,2
3507,59,81,11614,1,0,0,0,0,0
3509,59,69,9229,2,0,0,0,0,0
3510,56,74,12382,3,0,0,0,0,-1
3511,62,74,12382,76,15,3,12,75,20
3512,65,74,12382,19,3,1,2,21,9
3513,53,85,10461,2,0,0,0,2,0
3514,56,85,10461,2,0,0,0,0,0
3515,59,85,10461,50,6,3,3,35,-11
3516,62,85,10461,74,19,7,12,61,15
3517,65,85,10461,81,22,8,14,62,4
3518,68,85,10461,48,13,10,3,34,6
3519,71,85,10461,70,28,10,18,31,2
3520,74,85,10461,71,44,23,21,72,3
3521,77,85,10461,82,42,19,23,120,-16
3522,80,85,10461,64,21,7,14,50,-20
3523,83,85,10461,75,35,13,22,78,-11
3524,86,85,10461,71,19,6,13,38,-14
3526,62,63,11320,67,15,3,12,96,30
3527,65,63,11320,72,10,2,8,99,16
3528,68,63,11320,32,4,1,3,60,0
3529,71,63,11320,30,6,1,5,69,12
3530,74,63,11320,63,7,1,6,85,-2
3531,77,63,11320,64,9,1,8,89,6
3532,80,63,11320,77,10,2,8,71,4
3533,83,63,11320,38,4,1,3,62,-1
3534,86,74,11320,36,5,2,3,33,3
3535,86,82,11320,14,2,1,1,9,-1
3536,59,88,10435,1,0,0,0,0,1
3537,71,64,10435,76,7,1,6,17,-11
3538,74,64,10435,74,7,2,5,17,-2
3539,62,69,12384,4,0,0,0,12,-1
3540,65,69,12384,24,2,2,0,55,-2
3541,68,80,12384,15,1,1,0,47,0
3546,47,69,168391,60,18,3,15,32,-11
3547,50,71,168391,37,15,3,12,30,3
3548,56,64,168391,37,4,2,2,8,1
3549,50,79,9184,7,2,2,0,4,-3
3550,53,79,9184,63,17,6,11,23,-1
3551,56,79,9184,74,33,10,23,24,-7
3552,59,79,9184,73,27,3,24,51,1
3553,62,79,9184,82,50,8,42,101,15
3554,65,79,9184,51,42,10,32,34,21
3555,68,79,9184,35,38,5,33,8,16
3556,71,79,9184,37,22,11,11,16,-8
3557,74,79,9184,69,54,11,43,79,12
3558,77,79,9184,71,67,16,51,66,9
3559,80,79,9184,41,34,5,29,32,2
3438,62,70,9211,45,6,0,6,30,-1
3439,62,79,9211,18,4,1,3,20,-2
3564,83,547,177730,76,57,31,26,16,8
3565,86,547,177730,82,66,34,32,18,-7
3566,2,88,73256,45,4,0,4,92,7
3567,5,88,73256,37,7,0,7,92,-2
3568,8,88,73256,22,2,0,2,18,-3
3569,11,88,73256,60,10,1,9,67,-11
3570,14,88,73256,1,0,0,0,0,1
3571,62,74,11445,1,0,0,0,0,0
3572,53,82,9186,67,10,2,8,14,-12
3573,56,82,9186,66,21,2,19,28,-10
3574,59,82,9186,70,22,7,15,32,3
3575,62,82,9186,73,23,5,18,37,-9
3576,65,82,9186,12,3,2,1,13,-1
3577,65,78,9186,43,9,4,5,12,13
3578,68,78,9186,33,7,1,6,9,6
3579,71,62,9186,68,29,7,22,15,-11
3581,77,62,9186,51,15,4,11,8,-4
3582,77,70,9186,11,4,0,4,2,-1
3583,80,71,9186,68,13,1,12,23,5
3584,83,71,9186,78,21,4,17,8,-7
3585,86,71,9186,72,16,3,13,27,5
3586,62,65,11104,1,0,0,0,0,0
3587,65,64,11104,3,0,0,0,0,0
3588,59,88,9356,14,2,0,2,26,1
3589,68,73,9356,47,9,4,5,113,3
3590,71,73,9356,58,7,3,4,166,-7
3591,74,73,9356,1,0,0,0,0,0
3592,77,83,9356,19,4,0,4,22,1
3601,74,87,10236,63,41,4,37,32,-32
3602,74,74,10236,21,11,2,9,8,6
3603,77,74,10236,82,47,5,42,40,-4
3604,80,68,10236,82,41,5,36,39,-6
3606,86,68,10236,82,62,9,53,50,-17
3607,56,81,9621,6,1,0,1,10,1
3608,59,65,9621,1,0,0,0,5,0
3609,2,84,78152,14,3,0,3,20,-1
3610,59,70,6420,1,0,0,0,0,0
3611,59,73,4412,7,0,0,0,2,-2
3612,62,73,4412,1,0,0,0,0,0
3613,65,73,4412,9,0,0,0,8,-1
3614,59,73,10428,61,21,6,15,16,15
3615,62,73,10428,80,29,8,21,30,10
3616,65,83,10428,57,21,5,16,22,-1
3617,68,83,10428,45,29,4,25,8,4
3618,71,83,10428,79,33,5,28,30,-20
3619,74,83,10428,55,32,6,26,26,-7
3620,74,73,10428,23,4,1,3,2,0
3621,77,67,10428,59,17,4,13,26,-5
3623,83,65,10428,23,7,1,6,8,-1
3624,53,63,9222,48,7,1,6,24,1
3625,56,63,9222,25,5,1,4,10,-10
3626,59,63,9222,61,10,4,6,30,-7
3627,62,78,9222,65,29,7,22,69,-4
3628,65,78,9222,73,20,5,15,42,12
3629,68,78,9222,48,19,8,11,35,-4
3630,71,78,9222,61,33,9,24,72,14
3631,80,78,9222,1,1,1,0,0,0
3632,83,78,9222,81,31,11,20,50,-6
3633,86,67,9222,69,13,5,8,26,-20
3634,2,65,26580,72,25,10,15,58,6
3635,5,65,26580,50,12,7,5,35,-4
3636,8,65,26580,77,32,13,19,57,5
3637,11,74,26580,76,15,4,11,29,-3
3638,14,78,26580,46,25,11,14,11,22
3640,56,83,11261,10,2,1,1,21,-2
3641,56,63,3242,1,0,0,0,0,0
3642,59,63,3242,1,0,0,0,0,-1
3643,50,72,11015,7,0,0,0,7,-1
3644,59,72,11015,61,6,3,3,36,3
3645,62,72,11015,26,2,0,2,29,2
3646,65,72,11015,4,0,0,0,14,-2
3647,68,83,11015,45,8,0,8,85,18
3648,71,83,11015,19,1,0,1,33,-8
3649,71,71,11015,23,1,1,0,43,-7
3650,74,72,11015,34,4,0,4,55,2
3651,17,68,9029,70,21,10,11,137,-3
3652,20,68,9029,61,23,7,16,172,-1
3653,23,68,9029,81,23,9,14,158,-12
3654,26,68,9029,41,16,3,13,82,-4
3655,26,84,9029,31,11,2,9,44,-5
3657,32,84,9029,79,47,12,35,102,-1
3658,35,84,9029,82,48,17,31,101,-7
3659,38,84,9029,67,46,6,40,113,19
3660,41,84,9029,56,23,7,16,64,2
3661,47,84,9029,44,33,8,25,58,-8
3667,65,68,9029,66,13,3,10,31,-11
3668,68,68,9029,6,1,0,1,0,-4
3669,71,68,9029,37,5,1,4,39,-6
3670,53,67,9352,2,0,0,0,4,-2
3671,56,67,9352,4,0,0,0,2,2
3672,62,67,9352,9,3,1,2,2,0
3673,65,67,9352,44,12,1,11,20,10
3674,65,84,9352,14,3,1,2,6,-4
3675,68,66,9352,1,0,0,0,0,0
3676,77,72,9352,4,0,0,0,2,-2
3677,83,79,98121,16,6,4,2,2,2
3679,2,75,69533,51,15,6,9,10,-3
3680,5,75,69533,79,50,23,27,57,29
3681,8,71,69533,60,20,10,10,47,-10
3683,11,70,69533,76,31,17,14,31,0
3684,14,70,69533,32,13,9,4,16,-3
3685,17,70,69533,77,42,20,22,36,-11
3686,20,70,69533,67,30,10,20,24,6
3687,23,85,69533,61,27,13,14,40,4
3688,26,85,69533,5,1,1,0,0,-1
3689,29,85,69533,24,6,4,2,24,1
3690,32,85,69533,60,9,1,8,41,-8
3691,35,85,69533,19,2,1,1,8,-3
3692,35,70,69533,26,7,2,5,6,-6
3693,38,73,69533,41,3,1,2,14,-11
3561,86,79,9184,65,56,16,40,48,13
3562,65,69,9364,9,2,2,0,0,-1
3699,5,74,70098,40,14,7,7,14,5
3700,8,74,70098,33,5,3,2,8,-8
3701,8,81,70098,11,2,0,2,6,-6
3702,11,68,70098,20,8,4,4,16,1
3706,59,77,10447,53,9,1,8,28,-12
3707,62,77,10447,13,0,0,0,4,-4
3708,14,71,7111,1,1,1,0,0,-1
3709,17,71,7111,20,2,0,2,4,-6
3710,23,81,7111,35,10,2,8,22,-11
3711,26,81,7111,23,3,0,3,8,-4
3712,53,64,9406,31,11,6,5,2,-4
3713,56,64,9406,61,21,4,17,14,-7
3714,59,64,9406,7,3,1,2,0,0
3715,62,78,9406,13,3,1,2,2,-5
3716,53,80,9354,21,4,2,2,19,-1
3717,56,80,9354,12,0,0,0,15,-2
3719,65,82,9354,14,1,0,1,32,0
3720,71,82,9354,1,0,0,0,5,0
3721,77,73,9354,17,0,0,0,17,-1
3722,80,73,9354,9,0,0,0,19,-1
3723,56,67,9201,47,6,2,4,18,11
3724,59,67,9201,59,21,1,20,22,-15
3725,62,67,9201,49,9,2,7,26,8
3726,65,62,9201,68,15,2,13,34,-9
3727,68,62,9201,44,8,1,7,19,-10
3728,71,62,9201,82,16,2,14,39,-23
3729,74,78,9201,33,9,3,6,23,8
3730,77,78,9201,5,0,0,0,4,-1
3731,80,78,9201,1,0,0,0,0,0
3732,83,78,9201,6,0,0,0,2,1
3733,86,78,9201,13,2,1,1,0,3
3734,62,71,14866,12,2,0,2,12,-6
3736,68,71,14866,11,0,0,0,4,-3
3737,71,77,14866,18,1,0,1,6,-3
3738,74,77,14866,72,15,9,6,28,-6
3739,77,77,14866,79,14,2,12,27,-7
3740,80,77,14866,81,15,6,9,16,-5
3741,53,80,9253,1,0,0,0,0,0
3742,56,80,9253,10,2,0,2,0,-1
3743,56,72,10295,1,0,0,0,0,0
3744,59,72,10295,8,1,1,0,0,-2
3745,50,63,9480,1,0,0,0,4,-2
3746,2,83,69468,72,24,2,22,113,-4
3747,5,83,69468,74,17,2,15,91,-22
3748,8,83,69468,69,43,11,32,66,4
3749,11,83,69468,45,28,4,24,44,8
3750,14,83,69468,47,32,7,25,64,-8
3751,17,83,69468,74,25,7,18,116,-15
3759,32,85,69468,68,11,3,8,53,17
3760,35,64,69468,36,4,0,4,25,3
3761,38,65,69468,5,1,0,1,0,3
3762,50,81,11037,20,3,1,2,2,0
3763,53,81,11037,4,0,0,0,0,0
3764,59,81,11037,14,0,0,0,10,-5
3765,62,81,11037,18,3,1,2,2,-2
3766,65,81,11037,22,4,2,2,10,-3
3767,65,62,11037,21,4,1,3,8,2
3768,68,62,11037,15,1,0,1,10,-6
3769,71,62,11037,14,2,2,0,21,0
3770,74,77,11037,4,0,0,0,2,-4
3771,59,75,9193,40,5,2,3,10,-5
3772,62,75,9193,61,7,2,5,9,-1
3773,65,81,9193,74,19,12,7,8,-19
3774,68,81,9193,43,16,8,8,12,5
3775,71,81,9193,27,7,3,4,4,-2
3776,80,80,9193,82,23,9,14,16,9
3777,83,80,9193,81,22,7,15,10,-12
3778,86,80,9193,37,2,0,2,2,-16
3781,23,66,8933,74,39,19,20,67,-8
3782,26,66,8933,75,31,16,15,66,3
3783,29,66,8933,80,63,25,38,72,-9
3784,32,66,8933,82,67,41,26,106,-18
3785,35,66,8933,76,64,31,33,63,-5
3786,38,66,8933,82,61,30,31,38,-21
3787,41,66,8933,67,34,14,20,60,-12
3788,47,83,8933,74,38,19,19,64,-19
3789,50,83,8933,74,42,20,22,54,1
3791,2,65,70185,13,5,0,5,53,1
3792,5,65,70185,2,0,0,0,6,-3
3795,53,65,2639,13,1,0,1,13,-2
3796,56,65,2639,21,3,1,2,0,4
3797,59,65,2639,77,17,2,15,20,9
3798,62,65,2639,80,10,3,7,39,13
3799,65,65,2639,69,15,1,14,14,9
3800,68,65,2639,46,10,2,8,22,15
3801,71,65,2639,81,26,4,22,34,11
3802,74,65,2639,82,19,3,16,44,25
3803,77,65,2639,81,24,2,22,32,13
3804,80,65,2639,73,18,5,13,20,12
3805,83,87,2639,48,9,1,8,18,-3
3806,86,87,2639,82,10,0,10,44,8
3807,53,82,14085,75,10,5,5,226,-4
3808,56,82,14085,75,14,4,10,180,-6
3809,59,82,14085,68,7,4,3,149,-8
3810,62,82,14085,73,12,7,5,182,-2
3811,65,82,14085,54,3,2,1,126,-8
3812,68,82,14085,43,6,2,4,100,1
3813,71,82,14085,28,2,1,1,62,-6
3814,74,82,14085,72,5,1,4,109,-13
3815,77,82,14085,30,3,1,2,61,-3
3816,80,1479,14085,51,3,0,3,87,-3
3817,83,1479,14085,10,1,1,0,16,0
3818,83,74,118707,19,5,1,4,0,-12
3819,86,74,118707,27,3,1,2,14,-7
3820,80,84,212932,5,0,0,0,0,-2
3821,86,71,133891,15,3,0,3,2,2
3822,2,62,20597,78,81,20,61,144,27
3823,5,62,20597,38,38,11,27,46,12
3696,8,78,42495,48,4,0,4,40,-2
3697,2,79,70098,72,25,15,10,51,3
3828,17,83,20597,81,72,32,40,77,-5
3829,20,83,20597,61,60,15,45,46,-5
3830,20,72,20597,20,22,7,15,22,7
3831,23,72,20597,63,53,13,40,68,10
3832,26,65,20597,72,56,16,40,56,-16
3833,29,65,20597,63,56,22,34,51,-12
3834,29,67,20597,11,17,3,14,12,3
3835,32,67,20597,71,38,7,31,70,3
3836,35,75,20597,70,41,10,31,48,-7
3837,38,75,20597,61,30,11,19,36,-6
3838,38,83,20597,1,0,0,0,0,0
3839,83,77,201330,73,30,13,17,30,1
3840,86,77,201330,72,31,13,18,27,-8
3841,86,62,165327,24,3,1,2,12,-2
3842,83,71,247963,9,3,0,3,2,-2
3843,86,71,247963,17,2,1,1,2,-6
3845,62,64,13618,2,0,0,0,2,-1
3846,11,85,40993,59,8,4,4,38,-1
3847,14,71,40993,21,1,0,1,2,-2
3848,17,76,40993,12,1,0,1,6,-6
3849,53,85,10436,7,0,0,0,2,-2
3850,56,85,10436,16,1,0,1,4,-7
3851,59,85,10436,75,24,11,13,18,-2
3852,62,85,10436,82,32,12,20,16,9
3853,65,85,10436,68,26,9,17,12,5
3854,68,85,10436,1,0,0,0,2,0
3855,71,85,10436,42,20,12,8,14,2
3856,74,85,10436,75,33,15,18,12,7
3857,77,85,10436,77,26,13,13,32,-2
3858,80,85,10436,50,17,8,9,20,-6
3859,83,85,10436,75,31,13,18,39,3
3860,86,85,10436,61,17,7,10,20,-11
3862,23,84,486196,77,30,7,23,76,3
3863,26,84,486196,74,35,9,26,83,-19
3864,29,84,486196,42,20,4,16,24,6
3865,32,84,486196,65,28,8,20,46,-16
3866,35,84,486196,81,36,10,26,56,16
3867,38,84,486196,59,29,2,27,42,1
3868,41,84,486196,82,34,14,20,73,14
3869,47,84,486196,78,33,13,20,92,-6
3870,50,84,486196,77,31,11,20,80,-3
3871,53,84,486196,53,24,9,15,79,-1
3872,56,84,486196,82,25,6,19,105,14
3873,59,81,486196,67,13,0,13,59,-8
3874,62,81,486196,72,5,0,5,70,-7
3875,56,1479,11402,2,1,0,1,0,2
3876,56,67,9212,10,1,0,1,4,3
3877,59,67,9212,10,5,2,3,4,1
3879,65,67,9212,62,25,6,19,32,2
3880,68,67,9212,42,10,5,5,14,-3
3881,71,66,9212,81,31,16,15,36,-6
3882,74,66,9212,78,28,10,18,34,-14
3883,77,66,9212,47,7,3,4,14,-15
3884,83,82,9212,2,0,0,0,0,-1
3885,86,88,278913,5,1,0,1,0,-2
3886,80,86,95970,34,6,3,3,10,1
3887,83,86,95970,81,36,21,15,51,2
3888,86,86,95970,78,66,30,36,55,9
3889,83,67,300877,6,5,1,4,2,1
3890,86,67,300877,77,25,12,13,10,-19
3891,17,65,8698,8,1,0,1,4,1
3892,20,65,8698,82,31,15,16,123,13
3893,23,65,8698,54,18,9,9,73,0
3894,26,65,8698,66,15,9,6,84,-5
3896,29,71,8698,73,27,17,10,62,8
3897,32,71,8698,68,19,9,10,90,-6
3898,35,71,8698,80,16,11,5,81,4
3899,38,71,8698,78,31,14,17,112,-7
3900,41,71,8698,81,32,20,12,96,7
3901,47,71,8698,74,27,11,16,87,6
3902,50,71,8698,7,1,1,0,12,-4
3903,53,71,8698,25,9,5,4,39,-4
3904,56,71,8698,77,26,14,12,133,0
3905,59,71,8698,76,18,9,9,62,-18
3906,62,82,8698,37,6,1,5,24,-9
3907,65,88,8698,28,4,1,3,20,-3
3908,86,63,180602,2,0,0,0,0,-1
3909,83,72,116316,82,52,20,32,26,10
3910,86,72,116316,69,47,17,30,24,0
3911,56,73,11353,11,5,3,2,2,2
3913,62,73,11353,38,18,6,12,2,4
3914,65,73,11353,5,1,0,1,2,-2
3916,65,79,11353,6,1,0,1,0,-4
3917,77,67,11353,20,7,3,4,2,-1
3918,80,67,11353,11,1,0,1,0,-6
3919,83,69,11353,1,0,0,0,0,0
3920,86,63,112446,2,0,0,0,0,0
3921,5,74,9064,79,69,35,34,55,12
3922,8,74,9064,83,76,33,43,49,0
3923,11,74,9064,72,38,16,22,31,5
3924,11,65,9064,7,4,1,3,6,-5
3925,14,65,9064,48,35,15,20,41,7
3926,17,65,9064,81,63,31,32,62,10
3927,20,65,9064,81,77,41,36,64,35
3928,23,65,9064,82,73,31,42,66,21
3929,26,65,9064,82,75,44,31,60,0
3931,32,65,9064,82,64,35,29,54,-22
3932,35,65,9064,82,66,27,39,67,11
3934,38,77,9064,13,15,7,8,2,12
3935,41,77,9064,80,53,20,33,38,13
3936,47,62,9064,80,42,14,28,43,3
3937,50,62,9064,81,30,10,20,40,-4
3938,56,86,11389,12,0,0,0,6,-3
3939,59,86,11389,24,3,0,3,12,1
3940,62,86,11389,17,4,1,3,8,-2
3941,62,66,11389,17,5,1,4,2,7
3942,65,66,11389,44,4,2,2,35,-15
3943,68,84,11389,2,0,0,0,0,-2
3944,86,81,166434,58,16,5,11,58,25
3945,62,72,18017,57,14,4,10,27,10
3825,8,83,20597,83,127,32,95,100,32
3826,11,83,20597,83,111,27,84,105,25
3950,77,71,18017,69,7,2,5,18,-6
3951,80,71,18017,4,2,0,2,0,1
3952,62,78,13997,28,4,2,2,78,-1
3953,65,78,13997,60,4,3,1,124,0
3954,68,78,13997,43,6,4,2,79,3
3955,71,78,13997,63,8,2,6,126,-1
3956,74,78,13997,81,12,6,6,116,-3
3957,77,78,13997,64,4,3,1,68,-6
3958,80,78,13997,80,13,7,6,104,4
3959,83,79,13997,58,8,4,4,84,-9
3960,83,20120,13997,21,2,0,2,10,2
3961,86,20120,13997,80,20,9,11,74,1
3962,83,73,249794,3,0,0,0,0,0
3963,86,73,249794,4,2,1,1,0,2
3964,86,84,38908,71,66,28,38,12,3
3965,62,88,15477,76,14,7,7,141,-10
3967,68,88,15477,48,14,7,7,51,1
3968,71,88,15477,71,8,3,5,81,6
3969,74,88,15477,80,15,6,9,87,5
3970,77,88,15477,56,9,3,6,55,-1
3971,80,88,15477,73,12,6,6,92,-2
3972,83,88,15477,50,10,6,4,48,-4
3973,86,88,15477,72,21,11,10,96,4
3974,2,83,27471,18,3,0,3,16,-3
3975,5,83,27471,31,9,3,6,59,-12
3976,5,62,27471,6,1,0,1,4,-2
3977,8,62,27471,27,7,3,4,19,6
3978,11,68,27471,26,10,0,10,35,5
3983,83,68,201709,7,1,1,0,0,-6
3984,8,74,304,31,15,4,11,18,4
3985,11,74,304,8,2,1,1,2,-3
3986,11,68,304,8,2,1,1,0,-5
3988,74,1479,31572,7,1,0,1,6,2
3989,23,62,924,12,3,2,1,8,-4
3990,17,71,4314,5,0,0,0,6,-4
3991,23,71,4314,7,0,0,0,17,0
3992,26,72,4314,1,0,0,0,0,0
3993,26,65,4314,53,5,1,4,50,1
3994,29,65,4314,11,5,2,3,13,-1
3995,29,81,4314,30,2,1,1,32,-8
3996,32,81,4314,10,3,0,3,15,-7
3997,32,64,4314,8,0,0,0,4,0
3998,35,64,4314,22,2,1,1,9,1
3999,38,64,4314,32,2,0,2,19,3
4000,41,88,4314,2,1,0,1,2,1
4001,47,89,4314,72,26,8,18,72,-9
4002,50,89,4314,26,7,3,4,42,3
4004,17,76,1246,47,26,14,12,12,-3
4006,23,86,1246,5,0,0,0,2,-1
4007,29,76,1246,17,10,3,7,8,-3
4008,29,73,1246,7,1,0,1,0,0
4009,32,62,1246,11,1,0,1,4,0
4010,62,78,11634,3,0,0,0,0,-3
4011,68,82,11634,8,0,0,0,4,-2
4012,71,79,11634,1,0,0,0,2,-1
4013,23,62,9132,70,6,3,3,149,-11
4014,26,62,9132,2,0,0,0,17,-2
4015,26,64,9132,1,0,0,0,7,0
4016,29,64,9132,68,11,8,3,132,-2
4017,32,64,9132,41,2,1,1,108,-3
4018,35,66,9132,30,1,0,1,77,-2
4019,35,81,9132,14,4,0,4,26,-8
4020,38,81,9132,51,3,2,1,91,-11
4021,41,81,9132,74,6,1,5,140,-9
4023,86,78,149432,70,33,9,24,14,-2
4024,59,64,9373,9,2,1,1,0,2
4025,11,79,27413,3,0,0,0,2,-1
4026,14,79,27413,7,4,0,4,6,-1
4027,17,79,27413,2,0,0,0,0,-1
4028,26,79,27413,7,1,0,1,4,4
4029,29,83,27413,9,1,0,1,4,1
4030,83,80,273675,1,0,0,0,0,0
4031,86,80,273675,9,1,1,0,6,-2
4032,77,64,50144,9,0,0,0,2,-7
4033,80,64,50144,75,38,20,18,22,-25
4034,83,64,50144,81,84,29,55,34,0
4035,86,64,50144,74,87,31,56,54,13
4036,56,62,11627,4,1,1,0,2,-2
4037,59,62,11627,10,0,0,0,5,-1
4038,62,62,11627,4,1,0,1,5,-1
4040,65,66,11627,15,3,0,3,11,-1
4041,68,66,11627,3,0,0,0,4,-1
4042,71,66,11627,17,2,1,1,9,-4
4043,74,69,11627,6,3,0,3,4,1
4044,80,64,151197,5,1,0,1,4,-2
4045,83,64,151197,17,3,0,3,29,2
4046,86,64,151197,15,2,1,1,14,-2
4047,56,67,11407,1,0,0,0,0,0
4048,59,67,11407,78,26,10,16,50,-3
4049,62,68,11407,6,1,0,1,0,0
4050,65,68,11407,27,2,1,1,4,-11
4051,68,86,11407,13,2,2,0,2,-3
4053,86,65,277099,38,12,0,12,16,-7
4054,86,1479,201597,10,7,2,5,7,3
4055,86,70,250120,82,33,12,21,16,-14
4056,47,65,9007,81,21,9,12,79,-11
4058,53,65,9007,82,32,12,20,56,30
4059,56,65,9007,77,44,8,36,60,33
4060,59,65,9007,82,69,14,55,51,21
4061,62,65,9007,82,45,7,38,22,-1
4062,65,65,9007,74,40,4,36,42,15
4063,68,65,9007,47,27,3,24,31,16
4064,71,65,9007,79,61,6,55,28,22
4065,74,65,9007,80,45,10,35,20,12
4066,77,65,9007,67,43,9,34,26,13
4067,80,65,9007,80,53,6,47,16,22
4068,83,65,9007,82,32,2,30,28,-29
4069,86,65,9007,82,40,6,34,70,13
4070,83,66,237119,1,0,0,0,0,0
4071,86,66,237119,7,2,1,1,2,0
3947,68,72,18017,31,6,1,5,16,6
3948,71,72,18017,72,11,4,7,30,-5
4076,59,78,11718,7,0,0,0,2,-3
4077,62,78,11718,82,46,21,25,40,8
4078,65,78,11718,55,18,9,9,27,12
4079,68,78,11718,16,2,1,1,2,-4
4080,68,72,11718,13,4,2,2,6,-1
4081,71,79,11718,8,1,0,1,4,-1
4082,71,67,11718,49,11,5,6,22,-14
4083,68,66,11302,9,0,0,0,20,-2
4084,23,85,6496,12,2,0,2,6,1
4085,26,85,6496,17,1,0,1,16,4
4086,29,85,6496,21,3,1,2,8,3
4087,32,68,6496,6,2,0,2,2,3
4088,62,79,15068,9,2,1,1,13,-1
4089,65,79,15068,68,14,4,10,56,-5
4090,68,79,15068,33,5,2,3,17,-7
4091,71,79,15068,53,14,1,13,29,-1
4093,77,87,15068,1,0,0,0,5,1
4094,53,75,9652,52,27,9,18,51,9
4095,56,75,9652,56,23,8,15,64,-3
4096,59,75,9652,47,18,7,11,8,4
4097,62,73,9652,77,50,23,27,20,10
4098,65,73,9652,75,43,17,26,34,8
4099,68,73,9652,46,15,3,12,11,-5
4100,11,67,27316,1,0,0,0,0,-1
4101,14,67,27316,14,3,2,1,12,-2
4102,17,67,27316,60,20,2,18,80,-12
4103,8,80,69503,4,1,0,1,0,-3
4104,23,78,69503,61,26,11,15,10,5
4105,26,73,69503,53,14,8,6,16,-10
4106,26,78,69503,12,4,2,2,2,2
4107,29,65,69503,47,12,5,7,6,-8
4108,32,65,69503,19,3,1,2,2,-7
4110,65,80,15304,82,37,17,20,46,-4
4111,68,80,15304,47,19,8,11,11,5
4112,71,80,15304,76,17,6,11,41,-15
4113,74,80,15304,26,1,1,0,29,-5
4114,77,80,15304,1,0,0,0,0,0
4115,77,83,15304,30,15,7,8,13,-2
4116,59,84,11597,2,0,0,0,0,-2
4117,62,84,11597,4,1,1,0,0,1
4118,65,82,11053,41,2,2,0,2,-7
4119,80,66,67261,82,49,24,25,26,-1
4120,83,66,67261,78,65,29,36,24,4
4121,86,66,67261,82,83,30,53,26,25
4122,53,83,4155,50,9,3,6,18,-10
4123,56,83,4155,38,13,1,12,20,-2
4124,59,82,4155,73,34,6,28,37,-17
4125,62,82,4155,51,18,1,17,22,-11
4127,68,74,4155,48,7,4,3,16,14
4128,71,74,4155,81,13,1,12,26,9
4129,74,81,4155,82,39,9,30,26,22
4130,77,81,4155,73,34,9,25,20,16
4131,80,81,4155,73,22,5,17,20,1
4132,83,81,4155,80,18,4,14,18,29
4133,86,81,4155,47,17,2,15,8,12
4138,74,87,7690,82,43,23,20,40,-18
4139,77,87,7690,75,55,21,34,96,-6
4140,80,87,7690,79,39,12,27,48,-25
4141,83,87,7690,82,42,14,28,44,-28
4142,86,87,7690,81,44,14,30,52,-16
4143,86,75,288093,1,3,3,0,0,3
4144,50,64,10398,9,2,1,1,2,0
4145,53,64,10398,38,5,0,5,16,-3
4146,56,64,10398,6,0,0,0,0,-2
4148,62,64,10398,18,8,1,7,10,-3
4149,74,65,10398,7,0,0,0,0,-1
4150,83,74,214370,7,2,1,1,0,1
4151,86,74,214370,42,6,2,4,29,-13
4152,86,80,36840,2,0,0,0,0,0
4153,86,82,296946,2,1,1,0,0,3
4154,65,70,13795,1,0,0,0,2,0
4155,83,74,236864,9,3,1,2,4,-5
4156,86,74,236864,75,23,11,12,8,-22
4157,56,73,3678,28,7,2,5,16,-3
4158,59,73,3678,80,51,30,21,40,18
4159,62,73,3678,79,48,21,27,47,11
4160,65,73,3678,76,43,27,16,28,9
4161,68,73,3678,24,14,4,10,14,-1
4162,71,73,3678,76,53,22,31,28,1
4163,74,79,3678,64,51,25,26,38,12
4165,80,79,3678,70,44,21,23,28,16
4166,83,79,3678,70,49,29,20,58,2
4167,86,79,3678,69,37,18,19,26,-3
4168,2,65,22086,74,65,27,38,65,27
4169,5,65,22086,75,63,22,41,69,20
4170,8,65,22086,63,44,23,21,43,10
4171,11,65,22086,56,30,16,14,26,1
4172,80,72,121959,5,0,0,0,0,-1
4173,8,63,67937,16,3,2,1,64,5
4174,11,63,67937,4,1,0,1,9,0
4175,80,67,151065,2,1,0,1,0,-1
4176,86,67,151065,11,2,2,0,0,0
4179,11,83,677,12,4,2,2,14,4
4180,8,65,54634,1,0,0,0,0,0
4181,35,86,54634,5,1,0,1,2,-2
4182,80,85,168738,2,0,0,0,0,0
4184,80,77,98898,2,0,0,0,0,-1
4185,83,69,113374,1,0,0,0,2,0
4186,86,1479,113374,1,0,0,0,0,0
4187,80,87,226952,7,3,3,0,0,0
4188,83,87,226952,79,33,15,18,14,-17
4189,86,87,226952,71,18,11,7,27,-13
4193,11,68,9072,59,38,18,20,30,5
4194,14,68,9072,41,29,10,19,8,7
4195,17,68,9072,72,44,19,25,46,-12
4196,20,68,9072,19,10,2,8,10,-3
4197,20,79,9072,62,39,17,22,16,-20
4198,23,79,9072,78,65,30,35,30,15
4199,26,79,9072,64,32,20,12,20,-12
4200,26,67,9072,17,4,0,4,10,1
4073,53,75,11718,1,0,0,0,2,0
4074,56,75,11718,53,21,12,9,16,-17
4205,38,70,9072,13,7,2,5,8,2
4206,41,70,9072,77,29,11,18,18,7
4207,47,70,9072,78,36,15,21,44,9
4208,50,70,9072,82,25,13,12,40,-2
4209,53,70,9072,79,23,12,11,26,-3
4210,53,68,14080,9,1,0,1,4,-1
4211,14,88,37820,14,1,1,0,102,0
4212,17,88,37820,1,0,0,0,5,0
4213,20,88,37820,52,4,1,3,194,-4
4214,23,88,37820,66,6,2,4,249,-8
4215,26,88,37820,49,3,2,1,131,-5
4217,32,69,37820,50,2,1,1,137,-6
4218,35,69,37820,60,4,4,0,183,-13
4219,38,69,37820,60,8,3,5,201,-8
4220,41,69,37820,57,8,7,1,177,4
4222,11,68,72079,2,0,0,0,0,-2
4224,53,78,10201,61,6,3,3,100,-4
4225,56,78,10201,1,1,0,1,0,0
4226,59,78,10201,12,0,0,0,33,-4
4227,62,89,10201,16,2,0,2,30,-3
4228,65,89,10201,1,0,0,0,0,0
4229,68,73,24096,4,1,1,0,0,-1
4230,50,71,11335,2,0,0,0,0,-1
4231,65,81,14037,6,1,1,0,5,-1
4232,68,81,14037,1,0,0,0,0,0
4233,74,81,14037,3,0,0,0,12,0
4234,77,81,14037,4,1,1,0,5,2
4235,17,64,10819,2,1,0,1,0,1
4236,20,64,10819,6,1,0,1,0,0
4237,23,64,10819,11,7,2,5,4,0
4238,23,1479,10819,12,11,7,4,0,4
4239,26,1479,10819,10,1,0,1,0,-4
4241,29,65,10819,81,22,10,12,18,-10
4242,32,65,10819,15,3,0,3,6,-4
4243,11,78,41707,6,0,0,0,7,1
4244,14,78,41707,10,0,0,0,21,-5
4245,2,65,70512,80,45,24,21,88,12
4246,5,65,70512,80,47,17,30,89,-5
4247,8,65,70512,84,37,20,17,139,0
4248,11,65,70512,67,33,15,18,45,13
4249,14,65,70512,40,13,4,9,42,2
4250,83,88,121912,75,25,9,16,12,10
4251,86,88,121912,82,33,15,18,22,-17
4252,2,88,21431,68,64,30,34,154,22
4253,5,88,21431,80,68,39,29,187,4
4254,8,88,21431,81,82,37,45,171,-1
4255,11,88,21431,50,21,7,14,150,-2
4256,14,88,21431,33,24,13,11,68,9
4258,20,86,21431,76,40,25,15,159,-7
4259,23,86,21431,59,25,16,9,70,3
4260,26,86,21431,35,12,6,6,54,4
4261,29,86,21431,48,13,6,7,39,2
4262,32,86,21431,60,9,4,5,65,-1
4263,80,87,228157,7,1,0,1,0,-5
4264,83,87,228157,21,9,4,5,8,4
4265,86,87,228157,20,6,3,3,6,-10
4266,86,65,228157,58,51,17,34,14,2
4267,26,84,77870,4,0,0,0,2,0
4273,17,64,21401,65,20,5,15,56,29
4274,20,64,21401,58,14,2,12,28,4
4275,23,64,21401,72,14,4,10,42,9
4276,26,64,21401,54,13,3,10,24,12
4277,29,64,21401,34,4,2,2,10,-8
4278,32,64,21401,9,1,0,1,6,2
4280,32,78,21401,16,4,0,4,6,-3
4281,2,71,9664,76,25,7,18,127,-21
4282,5,74,9664,80,59,26,33,139,19
4283,8,74,9664,84,65,36,29,148,-4
4284,11,74,9664,84,79,52,27,127,27
4285,14,74,9664,47,31,17,14,51,9
4286,17,74,9664,82,58,22,36,100,18
4287,20,74,9664,82,61,33,28,66,10
4288,23,74,9664,72,35,23,12,41,-30
4289,26,74,9664,82,53,38,15,47,-12
4290,29,74,9664,77,40,23,17,14,-15
4291,32,74,9664,82,26,10,16,77,-16
4292,35,86,9664,81,31,17,14,51,11
4293,38,86,9664,82,18,9,9,32,-14
4294,59,68,18616,10,0,0,0,50,-3
4295,62,68,18616,2,0,0,0,10,-1
4297,86,71,248382,6,0,0,0,0,-1
4298,5,75,10903,4,0,0,0,0,-1
4299,8,75,10903,19,6,4,2,4,1
4300,11,68,10903,70,50,17,33,16,-4
4301,14,68,10903,47,29,15,14,18,-5
4302,17,68,10903,63,38,17,21,10,-5
4303,17,84,10903,9,3,3,0,4,0
4304,20,71,10903,6,0,0,0,0,-3
4305,29,75,10903,16,9,3,6,2,2
4306,32,76,10903,12,0,0,0,2,-5
4307,83,75,33056,25,4,1,3,6,-1
4308,83,89,33056,11,4,1,3,0,-1
4309,86,78,33056,1,0,0,0,2,-3
4310,56,66,10405,13,1,1,0,0,-2
4311,59,66,10405,58,12,7,5,6,-3
4312,62,66,10405,80,18,8,10,12,-6
4314,68,66,10405,46,16,8,8,12,-7
4315,71,66,10405,75,22,8,14,14,-2
4316,74,66,10405,71,12,5,7,10,-12
4317,83,74,196632,28,14,1,13,12,-1
4318,86,74,196632,73,26,6,20,35,-16
4319,83,65,160554,46,11,4,7,12,-9
4320,86,65,160554,63,19,4,15,14,-6
4321,83,88,13738,27,9,2,7,11,2
4322,86,88,13738,46,3,2,1,10,-2
4323,86,62,13738,15,1,0,1,7,5
4324,5,65,54518,5,0,0,0,12,1
4325,8,65,54518,16,2,0,2,8,-2
4326,11,71,54518,48,9,3,6,49,-8
4327,62,86,14618,17,3,1,2,4,-1
4202,32,67,9072,75,43,19,24,26,-2
4203,35,67,9072,68,48,17,31,26,6
4332,74,65,14618,13,2,0,2,7,1
4333,77,65,14618,77,13,8,5,30,-8
4334,80,65,14618,46,1,0,1,22,-6
4335,50,74,11023,34,6,0,6,8,7
4336,53,74,11023,82,28,10,18,14,0
4337,56,74,11023,82,22,4,18,53,-14
4338,59,74,11023,82,24,6,18,53,-2
4339,62,74,11023,80,31,4,27,37,7
4340,65,74,11023,82,29,5,24,20,13
4341,68,74,11023,46,14,2,12,16,-1
4342,71,74,11023,81,24,5,19,16,6
4343,74,74,11023,82,20,4,16,22,12
4344,77,74,11023,74,17,2,15,20,18
4345,80,74,11023,63,15,4,11,16,8
4346,83,81,11023,77,18,6,12,27,18
4347,86,81,11023,62,16,4,12,12,6
4349,8,71,10861,26,8,2,6,28,-7
4350,8,77,10861,40,25,13,12,50,-1
4351,11,77,10861,80,49,28,21,85,-2
4352,14,77,10861,14,10,5,5,2,3
4353,14,84,10861,37,21,8,13,28,-10
4354,17,84,10861,61,20,6,14,60,-11
4355,20,79,10861,8,4,3,1,4,-1
4356,26,71,10861,66,49,19,30,23,6
4357,29,71,10861,58,17,9,8,39,-6
4358,29,79,10861,13,8,4,4,18,-6
4359,32,79,10861,70,23,9,14,43,-7
4364,11,83,54636,13,4,2,2,10,1
4365,14,62,54636,8,2,1,1,2,1
4366,26,77,54636,7,4,1,3,2,1
4367,29,77,54636,11,5,3,2,6,0
4368,32,77,54636,7,2,1,1,4,-2
4370,83,65,29353,6,1,0,1,0,-1
4371,2,65,43451,35,1,0,1,183,-3
4372,5,65,43451,54,4,2,2,234,-2
4373,8,65,43451,78,2,1,1,193,2
4374,11,1479,43451,77,6,1,5,199,-6
4375,14,1479,43451,31,1,0,1,110,-7
4376,14,85,43451,11,0,0,0,37,-4
4377,17,85,43451,56,1,0,1,128,-10
4378,20,85,43451,1,0,0,0,0,-1
4380,23,66,43451,82,7,3,4,204,0
4381,26,1479,43451,73,3,3,0,158,0
4382,29,1479,43451,50,3,1,2,116,0
4383,32,88,43451,72,5,3,2,235,-2
4384,35,73,43451,30,2,1,1,76,0
4385,38,78,657,22,6,2,4,10,1
4386,83,83,316113,4,1,0,1,4,-3
4388,83,83,85740,48,11,3,8,28,4
4389,2,89,73037,10,2,2,0,10,1
4390,5,89,73037,5,1,0,1,34,-1
4391,8,89,73037,16,2,1,1,18,-3
4392,11,68,73037,4,1,0,1,2,-1
4393,47,68,9386,18,1,1,0,6,0
4394,50,68,9386,19,1,0,1,0,-3
4395,53,68,9386,9,0,0,0,2,-3
4396,86,85,115762,6,0,0,0,6,-4
4397,83,84,11067,1,0,0,0,0,-2
4398,59,80,11768,6,0,0,0,0,-1
4399,83,68,60791,5,1,0,1,0,0
4400,5,84,66302,21,5,1,4,24,-3
4401,86,86,160625,41,9,1,8,8,7
4402,2,88,9669,78,163,41,122,16,30
4403,5,88,9669,74,121,31,90,34,-12
4405,11,88,9669,81,130,38,92,20,-25
4406,14,88,9669,48,48,11,37,6,-20
4407,17,88,9669,62,81,15,66,32,-7
4408,17,78,9669,18,21,8,13,2,-6
4409,20,74,9669,82,97,25,72,28,12
4410,23,74,9669,82,90,23,67,28,-11
4411,26,74,9669,70,62,9,53,14,-23
4412,59,75,11117,6,1,0,1,0,-1
4413,62,75,11117,43,22,8,14,12,-3
4414,65,75,11117,81,60,16,44,24,10
4415,68,75,11117,48,28,10,18,26,-2
4416,71,75,11117,79,52,16,36,24,11
4417,74,75,11117,82,48,14,34,24,22
4418,77,75,11117,65,29,11,18,20,-6
4419,80,75,11117,31,10,4,6,6,5
4420,80,71,11117,18,4,2,2,6,-1
4422,2,85,56205,65,16,2,14,24,10
4423,5,76,56205,4,0,0,0,0,-1
4424,56,1479,14079,40,5,0,5,18,5
4425,59,1479,14079,42,3,0,3,15,1
4426,62,1479,14079,1,0,0,0,0,-2
4427,65,547,14079,5,0,0,0,2,-1
4428,83,65,18092,57,20,6,14,24,-1
4429,86,65,18092,23,6,2,4,12,0
4430,86,81,18092,14,2,0,2,4,4
4431,86,70,92167,58,22,9,13,24,-11
4432,17,85,8759,34,12,5,7,6,6
4433,20,85,8759,65,12,3,9,28,-10
4434,23,85,8759,68,17,5,12,43,5
4435,26,85,8759,75,14,4,10,59,17
4436,29,85,8759,81,18,6,12,20,-12
4437,32,85,8759,73,25,10,15,38,11
4439,38,85,8759,74,19,4,15,64,25
4440,41,85,8759,65,12,3,9,40,9
4441,47,75,8759,82,20,5,15,83,8
4442,50,75,8759,68,8,2,6,40,-8
4443,53,75,8759,61,14,9,5,34,-11
4444,56,75,8759,41,12,4,8,17,7
4445,83,71,197616,18,4,1,3,10,-11
4446,50,1479,10975,1,0,0,0,0,-1
4447,53,82,10975,17,2,1,1,33,-4
4448,56,82,10975,8,1,0,1,0,1
4449,59,84,10975,49,4,0,4,24,-2
4450,62,84,10975,56,5,1,4,53,1
4451,65,84,10975,43,10,4,6,46,-4
4452,68,70,10975,27,5,0,5,18,-2
4329,68,86,14618,42,3,2,1,61,-6
4330,71,86,14618,81,17,3,14,86,-8
4457,77,76,11544,2,1,0,1,4,1
4458,80,76,11544,2,0,0,0,2,-1
4459,86,71,199955,17,6,1,5,6,-9
4460,56,76,11810,4,1,1,0,0,1
4461,2,76,74364,3,2,0,2,2,2
4462,2,76,3328,3,1,0,1,2,-2
4463,2,84,68900,39,7,1,6,39,-6
4464,2,62,68900,4,0,0,0,4,1
4465,5,62,68900,3,0,0,0,2,2
4468,14,88,1447,4,1,0,1,0,2
4469,17,88,1447,2,1,0,1,0,1
4470,86,88,161168,62,21,12,9,16,2
4471,86,80,195245,20,9,3,6,6,-2
4472,2,85,27904,46,17,9,8,22,-10
4473,5,62,27904,46,18,7,11,42,-11
4474,2,71,68895,5,1,1,0,0,-2
4476,80,547,226362,1,0,0,0,0,-1
4477,83,547,226362,31,14,5,9,2,5
4478,86,547,226362,77,24,9,15,4,-2
4479,83,76,152165,22,4,1,3,6,-5
4480,5,77,53474,58,18,5,13,187,-2
4481,8,77,53474,30,9,5,4,76,-5
4482,11,77,53474,26,2,1,1,57,-11
4483,11,80,53474,15,1,1,0,38,-6
4484,14,80,53474,3,1,0,1,6,-1
4485,20,83,11031,5,0,0,0,0,-4
4486,23,83,11031,38,6,2,4,6,-6
4487,26,83,11031,35,9,2,7,16,0
4493,50,84,11031,12,3,1,2,12,-6
4494,2,88,70659,34,4,1,3,133,8
4495,5,83,70659,46,6,3,3,145,-9
4496,11,85,70659,28,5,1,4,93,-1
4498,14,81,70659,27,4,1,3,40,-12
4499,17,81,70659,3,0,0,0,7,-1
4500,17,76,70659,5,0,0,0,30,-3
4501,74,1479,33768,1,0,0,0,0,-2
4502,80,82,186363,78,47,11,36,14,17
4503,83,82,186363,77,37,16,21,16,8
4504,86,82,186363,82,44,11,33,18,-12
4505,23,72,25147,43,6,1,5,8,11
4506,26,72,25147,56,8,1,7,16,-4
4507,29,72,25147,32,4,3,1,6,-6
4508,32,69,25147,70,15,0,15,42,-6
4509,35,69,25147,28,3,1,2,14,-6
4510,38,69,25147,58,15,1,14,16,15
4511,41,69,25147,56,3,1,2,21,-10
4512,41,73,25147,13,0,0,0,4,1
4513,17,88,16744,80,53,19,34,16,-3
4515,23,88,16744,4,1,0,1,4,1
4516,26,73,16744,55,17,7,10,10,-10
4517,29,73,16744,68,32,16,16,12,5
4518,32,73,16744,78,34,15,19,10,-5
4519,35,73,16744,75,27,11,16,14,-16
4520,38,73,16744,62,20,5,15,12,7
4521,83,66,151421,1,0,0,0,0,-1
4522,86,66,151421,6,0,0,0,2,0
4523,17,67,53937,31,1,0,1,104,3
4524,20,67,53937,77,8,1,7,225,12
4525,23,67,53937,69,4,1,3,165,5
4526,26,73,53937,79,13,3,10,137,-6
4527,29,73,53937,62,6,2,4,97,-13
4528,29,79,53937,11,1,1,0,69,2
4529,32,79,53937,58,4,1,3,147,18
4530,35,62,53937,79,6,2,4,170,9
4532,41,66,53937,43,5,0,5,80,-9
4533,41,64,53937,11,0,0,0,8,-1
4534,47,64,53937,41,7,1,6,54,2
4535,2,67,54621,21,9,1,8,20,9
4536,5,67,54621,58,21,6,15,75,-13
4537,5,75,54621,8,4,2,2,17,4
4538,8,75,54621,73,25,11,14,117,7
4539,11,75,54621,68,13,4,9,118,3
4540,14,77,54621,36,10,2,8,48,16
4541,17,77,54621,69,14,5,9,92,18
4542,20,77,54621,27,5,0,5,37,-1
4544,23,66,54621,65,8,3,5,94,-5
4545,26,1479,54621,82,7,1,6,122,-1
4546,29,1479,54621,67,8,3,5,61,-8
4547,32,76,54621,30,6,1,5,56,5
4548,35,76,54621,1,0,0,0,2,-1
4550,86,84,58487,8,0,0,0,0,-4
4551,2,63,68082,1,1,1,0,2,2
4552,5,86,68082,46,15,5,10,82,-17
4553,8,80,68082,62,8,4,4,104,-42
4554,20,83,729588,76,13,6,7,24,-14
4555,23,83,729588,74,32,16,16,32,-5
4556,26,83,729588,67,31,16,15,35,14
4557,29,81,729588,80,48,22,26,18,-26
4558,32,81,729588,76,56,32,24,48,-1
4559,35,81,729588,54,31,14,17,27,0
4560,38,81,729588,76,40,17,23,43,7
4561,41,81,729588,82,57,29,28,32,31
4562,47,81,729588,77,54,31,23,56,5
4563,50,82,729588,79,42,22,20,50,-3
4564,53,82,729588,23,12,6,6,20,1
4565,56,82,729588,50,25,9,16,28,2
4567,59,88,729588,20,5,3,2,14,-2
4569,62,62,729588,4,0,0,0,2,-3
4570,17,86,14588,9,5,3,2,2,-5
4571,20,86,14588,2,1,0,1,0,1
4572,2,83,68095,74,34,11,23,82,-9
4573,5,83,68095,35,4,2,2,16,-10
4574,5,67,68095,12,6,2,4,48,1
4575,8,67,68095,55,20,5,15,43,8
4576,11,67,68095,83,21,6,15,53,10
4577,14,67,68095,42,16,4,12,32,3
4578,17,67,68095,57,16,6,10,30,2
4579,17,64,68095,4,1,1,0,2,1
4580,20,80,68095,34,4,2,2,8,-1
4581,86,81,227693,70,26,13,13,26,5
4454,65,68,11544,5,0,0,0,10,0
4455,68,86,11544,1,0,0,0,0,0
4586,56,69,2695,82,44,15,29,32,-1
4587,59,69,2695,79,42,20,22,44,-2
4588,62,69,2695,73,35,16,19,38,-3
4589,65,547,2695,45,13,5,8,0,-5
4590,68,547,2695,22,5,3,2,2,-3
4591,80,87,205210,72,12,5,7,48,-20
4592,83,87,205210,11,1,1,0,7,-6
4593,86,87,205210,81,25,11,14,67,5
4594,65,69,32818,1,0,0,0,0,0
4595,83,87,225241,1,0,0,0,0,-1
4596,86,87,225241,2,0,0,0,0,-2
4597,11,80,609,23,5,2,3,6,-7
4598,5,84,16136,65,60,34,26,30,0
4599,8,84,16136,83,110,60,50,69,35
4600,11,84,16136,76,107,60,47,86,1
4601,14,84,16136,44,43,20,23,47,-8
4603,20,84,16136,63,55,23,32,40,-14
4604,23,84,16136,82,90,51,39,48,5
4605,26,68,16136,11,16,13,3,4,3
4606,29,68,16136,74,94,58,36,16,25
4607,32,68,16136,82,92,59,33,58,-2
4608,35,68,16136,56,49,22,27,56,-14
4609,35,74,16136,12,20,12,8,6,9
4610,38,74,16136,39,30,19,11,16,4
4611,86,80,206840,12,4,2,2,0,-5
4612,71,82,41784,66,21,4,17,10,4
4613,74,82,41784,12,3,1,2,8,1
4614,77,82,41784,82,25,4,21,40,-10
4615,80,82,41784,60,11,2,9,24,3
4616,83,82,41784,44,12,1,11,8,4
4617,86,82,41784,56,29,1,28,10,20
4618,86,64,97673,40,6,3,3,26,-7
4620,11,77,1634,47,21,12,9,58,2
4621,11,86,1634,12,2,0,2,10,-2
4622,14,86,1634,6,2,2,0,0,-2
4623,17,1479,1634,7,1,1,0,0,-4
4624,26,68,1634,1,0,0,0,2,-1
4625,26,80,1634,2,1,0,1,2,0
4626,29,81,1634,2,0,0,0,0,-2
4627,29,80,1634,3,0,0,0,0,-2
4628,83,62,107437,4,2,2,0,0,1
4629,32,69,3672,80,34,11,23,52,-8
4630,35,69,3672,69,24,4,20,38,-7
4631,38,69,3672,60,11,2,9,30,-12
4632,41,70,3672,4,2,1,1,2,0
4633,2,74,31214,70,6,1,5,89,-1
4634,5,74,31214,52,9,1,8,65,33
4635,8,74,31214,44,11,1,10,85,2
4637,11,88,31214,16,3,0,3,27,-5
4638,86,88,160840,39,10,3,7,8,-8
4639,17,88,32598,4,0,0,0,0,0
4640,20,88,32598,79,9,3,6,32,-15
4641,23,88,32598,65,12,3,9,33,9
4642,26,88,32598,8,0,0,0,2,-1
4643,29,88,32598,64,9,3,6,55,-2
4644,32,1479,32598,82,10,1,9,22,-12
4645,35,1479,32598,77,17,8,9,28,5
4646,38,1479,32598,39,5,1,4,12,-1
4647,41,1479,32598,11,0,0,0,0,-3
4648,86,79,44354,6,2,0,2,0,2
4649,8,75,406,6,0,0,0,2,-4
4650,11,1479,406,73,23,12,11,54,-8
4651,14,1479,406,41,21,6,15,32,-8
4652,17,1479,406,34,18,6,12,34,3
4654,8,67,9102,30,6,2,4,55,3
4655,11,67,9102,7,4,1,3,4,-1
4656,11,65,9102,30,8,3,5,35,15
4657,14,65,9102,18,1,1,0,11,-1
4658,17,65,9102,82,19,5,14,94,31
4659,20,65,9102,81,18,3,15,62,26
4660,23,65,9102,60,15,2,13,73,-7
4665,35,1479,9102,60,14,5,9,30,14
4666,38,1479,9102,81,22,4,18,65,8
4667,41,1479,9102,69,7,2,5,42,-5
4668,47,1479,9102,61,18,2,16,48,13
4669,47,84,9102,18,2,0,2,14,-5
4670,50,69,9102,80,17,4,13,58,22
4671,53,69,9102,61,11,1,10,42,8
4672,80,1479,13767,4,0,0,0,2,-1
4673,86,1479,13767,49,5,0,5,16,-4
4675,80,69,139681,15,7,3,4,4,1
4676,83,69,139681,75,16,6,10,22,2
4677,86,69,139681,58,14,7,7,20,-7
4680,5,71,68990,25,8,2,6,6,11
4681,8,71,68990,64,16,4,12,60,-13
4682,11,80,68990,48,15,2,13,41,-15
4683,11,84,68990,16,0,0,0,12,-4
4687,80,1479,90400,1,0,0,0,0,1
4688,83,1479,90400,2,0,0,0,0,0
4689,80,70,264020,1,0,0,0,0,-1
4690,86,70,264020,21,4,1,3,0,-3
4691,77,84,76336,20,1,1,0,2,-9
4692,80,84,76336,57,5,0,5,33,-2
4693,83,84,76336,37,6,4,2,10,0
4694,86,84,76336,3,3,1,2,0,3
4695,56,86,4335,10,0,0,0,4,-2
4697,74,87,33227,3,0,0,0,2,-2
4698,8,75,53791,3,0,0,0,2,0
4699,11,81,53791,4,0,0,0,2,0
4700,14,81,53791,45,5,1,4,26,1
4701,17,81,53791,14,0,0,0,18,-6
4702,17,89,53791,4,1,0,1,4,3
4703,20,89,53791,25,2,1,1,20,1
4704,23,62,53791,2,0,0,0,4,0
4705,26,62,53791,12,1,0,1,14,-6
4706,29,62,53791,21,0,0,0,37,-3
4707,11,78,24168,3,1,0,1,15,1
4708,14,78,24168,47,16,7,9,133,12
4709,17,78,24168,42,3,3,0,108,-9
4710,17,89,24168,3,0,0,0,5,-1
4583,47,70,2695,79,31,11,20,46,0
4584,50,70,2695,74,25,11,14,38,-5
4716,56,77,13411,10,0,0,0,2,-4
4717,59,77,13411,3,0,0,0,0,-1
4718,2,67,60228,60,12,9,3,204,-10
4720,8,81,60228,58,8,4,4,154,-7
4721,8,74,60228,3,0,0,0,6,0
4722,11,74,60228,35,2,1,1,70,-5
4723,14,74,60228,1,0,0,0,4,0
4724,86,65,267447,1,0,0,0,2,0
4725,77,68,76384,3,0,0,0,2,1
4726,80,68,76384,81,17,7,10,36,-5
4727,83,68,76384,81,27,10,17,61,-1
4728,86,68,76384,75,27,8,19,44,-24
4729,5,72,253514,2,0,0,0,2,0
4730,14,79,253514,1,0,0,0,0,0
4731,17,79,253514,3,0,0,0,2,0
4732,20,79,253514,11,4,2,2,13,-3
4735,5,89,21393,79,54,17,37,105,18
4736,8,89,21393,83,79,34,45,114,-7
4737,11,89,21393,72,40,16,24,108,-13
4738,14,70,21393,47,29,10,19,66,-4
4739,17,70,21393,74,41,15,26,58,-24
4740,20,79,21393,80,54,15,39,103,11
4741,23,79,21393,74,48,19,29,66,-3
4742,26,79,21393,66,38,11,27,24,11
4743,29,74,21393,74,23,4,19,38,-10
4744,32,66,21393,57,18,4,14,38,2
4745,5,67,1842,2,0,0,0,0,1
4746,8,67,1842,3,0,0,0,0,0
4749,11,89,26597,46,2,1,1,174,-2
4750,11,81,26597,11,1,0,1,52,-2
4751,14,81,26597,41,6,2,4,225,3
4752,17,81,26597,55,5,2,3,258,-4
4754,20,65,26597,67,4,2,2,233,-1
4755,23,66,26597,14,3,0,3,83,3
4756,23,84,26597,13,1,0,1,47,-2
4757,23,81,26597,12,0,0,0,45,-3
4758,26,81,26597,16,2,1,1,24,-1
4759,26,89,26597,43,2,2,0,103,-6
4760,32,75,26597,3,0,0,0,14,-1
4761,2,67,21402,80,89,31,58,32,2
4762,5,67,21402,77,98,23,75,27,-22
4763,8,67,21402,81,96,16,80,52,-17
4764,11,67,21402,81,86,35,51,91,10
4765,14,67,21402,23,16,5,11,2,-2
4766,17,78,21402,66,41,13,28,22,5
4767,17,77,21402,16,20,4,16,4,10
4768,20,77,21402,51,34,12,22,32,9
4769,53,82,11398,7,2,1,1,2,3
4772,59,68,11398,2,0,0,0,0,-5
4773,62,68,11398,15,5,3,2,6,4
4774,65,62,11398,5,0,0,0,4,0
4775,80,78,50301,9,2,0,2,4,0
4776,83,78,50301,13,1,0,1,6,0
4777,86,78,50301,20,2,0,2,2,-7
4778,56,64,11547,2,0,0,0,0,0
4779,59,64,11547,41,8,4,4,47,3
4780,2,71,8485,6,1,0,1,6,-2
4781,5,71,8485,20,13,2,11,22,19
4782,8,71,8485,29,18,5,13,35,-1
4783,8,77,8485,40,28,6,22,39,-7
4784,11,77,8485,19,15,3,12,19,2
4785,11,68,8485,33,16,2,14,9,8
4786,11,79,8485,12,3,1,2,8,-1
4787,14,79,8485,21,5,1,4,25,2
4789,29,84,8485,79,22,5,17,26,5
4790,32,84,8485,16,7,2,5,6,8
4791,35,70,8485,2,0,0,0,2,0
4792,80,82,63080,2,1,0,1,0,-2
4793,83,82,63080,14,2,0,2,4,0
4794,86,82,63080,1,0,0,0,2,-1
4795,5,83,70658,2,0,0,0,0,0
4796,2,88,73596,4,0,0,0,5,0
4797,71,89,98716,82,10,3,7,151,1
4798,74,89,98716,67,17,4,13,172,-1
4799,77,89,98716,82,23,7,16,163,3
4800,80,89,98716,82,19,7,12,133,9
4801,83,89,98716,78,35,14,21,187,10
4802,86,89,98716,63,40,22,18,128,11
4803,71,86,49212,37,25,15,10,4,11
4804,74,86,49212,82,31,13,18,16,-5
4806,80,86,49212,49,22,10,12,14,-8
4807,83,86,49212,79,46,22,24,41,-2
4808,86,86,49212,77,74,35,39,18,5
4809,71,65,44577,3,0,0,0,0,0
4810,74,65,44577,34,9,4,5,2,4
4811,77,65,44577,78,35,13,22,20,-2
4812,80,66,44577,81,42,15,27,16,-6
4813,83,66,44577,82,64,23,41,14,8
4814,86,66,44577,82,76,21,55,12,30
4815,59,71,11736,5,0,0,0,2,-5
4816,5,86,60930,15,1,0,1,32,-8
4817,32,81,12658,5,0,0,0,0,-2
4818,14,75,9114,6,1,1,0,0,-1
4819,17,75,9114,7,0,0,0,2,-4
4820,20,78,9114,61,17,6,11,43,0
4821,23,78,9114,81,43,14,29,46,20
4823,29,78,9114,79,27,12,15,36,5
4824,32,78,9114,69,25,11,14,46,2
4825,32,62,9114,14,7,3,4,14,0
4826,35,62,9114,81,75,27,48,32,24
4827,38,62,9114,79,59,22,37,36,-4
4828,41,62,9114,63,47,8,39,44,13
4829,47,88,9114,78,66,22,44,78,13
4830,50,88,9114,52,16,5,11,38,-13
4831,50,62,9114,28,21,8,13,18,10
4832,53,62,9114,79,34,12,22,71,6
4833,56,62,9114,82,48,12,36,28,20
4834,59,62,9114,63,15,3,12,25,-6
4835,62,62,9114,18,2,2,0,8,-1
4836,5,77,74537,31,11,2,9,74,1
4713,80,62,146598,1,0,0,0,0,0
4714,83,62,146598,72,25,17,8,33,-7
4841,77,547,90399,81,21,6,15,62,10
4842,80,547,90399,60,33,8,25,54,4
4843,83,547,90399,55,24,3,21,34,9
4844,86,547,90399,82,50,8,42,58,8
4845,74,81,84773,3,0,0,0,2,0
4846,77,81,84773,9,1,0,1,2,-1
4847,80,81,84773,29,4,0,4,8,-4
4848,83,81,84773,35,8,4,4,18,4
4849,86,81,84773,9,1,1,0,4,0
4850,86,65,84773,22,5,1,4,10,4
4851,68,73,29640,5,1,0,1,0,-5
4852,71,73,29640,13,5,1,4,4,-8
4853,74,73,29640,82,63,26,37,24,15
4854,77,73,29640,82,64,33,31,47,1
4855,80,73,29640,82,58,31,27,32,-4
4856,83,73,29640,67,64,26,38,38,27
4858,77,70,98351,45,12,5,7,16,9
4859,80,70,98351,80,33,12,21,67,-6
4860,83,70,98351,79,33,17,16,36,21
4861,86,70,98351,81,30,15,15,54,-3
4862,32,63,18310,10,0,0,0,4,-2
4863,35,63,18310,13,0,0,0,6,0
4864,5,63,161471,16,1,0,1,55,-5
4865,8,81,161471,17,4,0,4,38,-6
4866,5,86,15088,5,0,0,0,0,-6
4867,8,86,15088,39,20,7,13,10,-15
4868,53,83,11556,3,0,0,0,0,0
4869,56,83,11483,23,2,0,2,18,-4
4870,59,69,11483,14,0,0,0,6,1
4871,77,78,89464,79,33,9,24,29,28
4872,80,78,89464,81,35,4,31,32,7
4873,83,78,89464,82,35,6,29,13,-7
4875,32,65,10820,19,4,3,1,4,-4
4876,77,83,89229,6,3,1,2,2,-1
4877,83,20120,89229,44,13,2,11,4,-1
4878,83,84,89229,14,9,3,6,10,-3
4879,86,84,89229,17,5,2,3,2,-10
4880,86,88,89229,45,18,5,13,22,-4
4881,50,72,11012,9,0,0,0,0,-3
4882,53,72,11012,58,6,2,4,19,-3
4883,59,72,11012,63,10,2,8,40,-4
4884,62,72,11012,74,10,3,7,27,-9
4885,65,72,11012,7,0,0,0,7,0
4886,65,1479,11012,45,3,2,1,9,-3
4888,26,64,70171,7,1,0,1,2,-1
4889,26,76,70171,6,2,1,1,0,0
4893,56,79,8847,16,3,2,1,2,-4
4894,62,68,8847,24,7,4,3,6,1
4896,74,63,10499,3,0,0,0,14,0
4897,5,85,20592,1,0,0,0,7,0
4898,8,85,20592,7,2,1,1,58,0
4899,11,77,20592,22,3,1,2,71,0
4900,11,81,20592,4,0,0,0,13,-1
4901,14,81,20592,10,1,1,0,41,-3
4902,14,65,20592,27,4,3,1,117,-3
4903,17,65,20592,52,6,2,4,180,-1
4904,20,65,20592,65,12,6,6,199,4
4905,23,65,20592,55,2,0,2,178,-9
4908,29,75,20592,47,8,3,5,92,-5
4909,32,1479,20592,79,11,5,6,167,-11
4910,35,1479,20592,2,0,0,0,0,-1
4911,35,76,20592,10,0,0,0,31,-5
4912,41,64,20592,55,3,1,2,147,-5
4913,50,70,10992,11,3,1,2,4,-3
4915,56,70,10992,38,13,3,10,10,-5
4916,59,79,10992,8,3,2,1,0,-1
4917,62,79,10992,60,16,7,9,10,5
4918,65,85,10992,8,3,1,2,0,2
4920,71,79,10992,19,5,4,1,2,-3
4921,74,89,10992,2,0,0,0,4,1
4922,53,65,11346,40,4,1,3,22,0
4923,56,65,11346,9,0,0,0,4,-1
4924,59,65,11346,43,8,2,6,10,5
4925,62,65,11346,37,1,1,0,4,-2
4926,68,1479,11346,2,0,0,0,0,0
4927,50,89,9052,1,0,0,0,0,-1
4928,56,83,9702,4,1,1,0,0,-3
4931,65,547,9702,63,27,11,16,10,-2
4932,50,72,9163,23,6,1,5,6,-1
4933,53,72,9163,59,10,2,8,22,0
4935,59,72,9163,78,37,6,31,14,9
4936,62,72,9163,82,23,4,19,22,-23
4937,65,72,9163,56,16,1,15,16,3
4938,68,72,9163,48,16,4,12,20,12
4939,71,72,9163,82,32,8,24,32,3
4940,74,72,9163,82,22,3,19,20,1
4941,77,72,9163,82,13,4,9,26,7
4942,80,72,9163,66,13,4,9,8,-16
4943,83,72,9163,81,13,3,10,21,-9
4944,86,72,9163,82,25,5,20,16,-9
4945,8,62,42489,61,11,2,9,56,9
4946,11,62,42489,33,3,0,3,23,-2
4947,14,62,42489,34,12,4,8,38,8
4948,17,62,42489,32,2,1,1,26,-2
4950,23,62,42489,19,1,0,1,6,-3
4951,26,83,42489,3,0,0,0,2,0
4953,77,70,50033,4,0,0,0,0,-3
4954,80,70,50033,73,18,6,12,22,8
4955,83,70,50033,80,27,7,20,24,19
4956,86,70,50033,82,32,11,21,33,14
4957,2,77,24324,2,1,0,1,0,-2
4958,5,77,24324,25,2,1,1,4,-4
4962,20,77,69163,56,8,5,3,237,2
4963,23,72,69163,26,3,0,3,102,1
4964,26,72,69163,1,0,0,0,0,0
4965,50,88,9039,12,2,0,2,8,0
4966,53,88,9039,25,5,2,3,2,3
4967,56,88,9039,69,12,4,8,28,-13
4968,59,88,9039,39,3,1,2,8,-2
4969,62,88,9039,19,4,1,3,4,3
4838,11,77,74537,62,7,4,3,65,-12
4839,71,547,90399,65,29,10,19,43,4
4974,2,79,26585,31,4,2,2,32,-3
4975,5,76,26585,8,0,0,0,11,-3
4976,5,67,26585,28,1,0,1,48,-14
4979,11,68,1588,21,8,2,6,8,-3
4980,11,80,1588,40,12,5,7,38,-6
4981,14,80,1588,3,3,1,2,0,2
4982,77,89,60777,9,0,0,0,2,-3
4983,80,89,60777,4,0,0,0,0,0
4984,83,89,60777,67,18,6,12,8,13
4985,86,89,60777,64,11,5,6,0,-13
4988,11,76,177596,24,0,0,0,30,-7
4989,14,72,32604,17,1,0,1,4,6
4990,17,72,32604,41,6,0,6,28,4
4991,20,72,32604,28,6,2,4,6,2
4992,23,72,32604,50,9,1,8,12,12
4993,26,72,32604,62,11,1,10,22,4
4996,29,65,32604,27,10,2,8,12,9
4997,32,65,32604,69,11,0,11,30,-16
4998,62,72,9392,12,0,0,0,6,-3
4999,65,72,9392,1,1,1,0,0,1
5000,68,72,9392,48,14,4,10,14,2
5001,71,72,9392,66,11,4,7,18,-8
5002,74,72,9392,61,13,5,8,12,4
5003,77,72,9392,82,11,1,10,43,-13
5004,80,76,9392,26,6,1,5,2,9
5005,86,76,9392,5,0,0,0,0,-4
5006,5,71,69451,25,3,2,1,124,4
5007,8,71,69451,51,10,8,2,205,-16
5008,11,71,69451,48,10,4,6,185,-9
5009,14,71,69451,34,2,2,0,93,-4
5010,17,71,69451,38,4,1,3,96,-7
5011,20,71,69451,32,2,2,0,94,-6
5016,38,65,69451,4,0,0,0,7,0
5017,86,78,183561,29,5,3,2,10,0
5018,35,82,9673,7,2,0,2,2,-3
5019,38,82,9673,12,1,0,1,4,-6
5020,41,82,9673,9,2,2,0,6,0
5021,65,83,11760,2,1,0,1,2,-1
5022,68,83,11760,10,2,0,2,0,1
5023,71,71,11760,2,0,0,0,0,-2
5024,74,71,11760,16,2,1,1,6,-8
5025,77,547,91320,8,3,0,3,2,1
5026,77,70,149999,3,0,0,0,0,2
5027,80,70,149999,82,33,13,20,14,-4
5028,83,70,149999,82,32,11,21,14,-30
5029,86,70,149999,42,17,5,12,7,0
5030,86,1479,149999,34,12,5,7,6,-12
5031,77,71,93624,15,2,0,2,13,-2
5033,83,71,93624,69,21,11,10,47,-7
5034,86,71,93624,60,18,3,15,43,-12
5035,5,75,10649,33,10,4,6,25,5
5036,8,75,10649,29,17,4,13,14,11
5037,11,75,10649,70,33,13,20,37,-2
5038,14,75,10649,22,9,4,5,4,-3
5039,14,83,10649,12,2,1,1,6,-6
5040,17,83,10649,20,8,4,4,4,-3
5041,20,88,10649,6,1,1,0,6,-2
5042,2,63,39283,70,59,30,29,20,11
5043,5,63,39283,42,17,6,11,10,-8
5044,8,81,39283,25,9,2,7,2,-6
5045,5,63,32204,10,3,1,2,8,-1
5046,8,63,32204,82,35,15,20,61,2
5047,11,63,32204,84,54,22,32,59,0
5048,14,63,32204,47,20,10,10,10,3
5050,20,63,32204,67,51,25,26,37,-9
5051,23,63,32204,79,39,16,23,54,6
5052,26,63,32204,14,4,1,3,4,0
5053,26,76,32204,55,18,7,11,27,-10
5054,26,80,32204,13,5,3,2,10,2
5055,29,1479,32204,81,30,11,19,26,-3
5056,32,70,32204,65,25,8,17,26,6
5057,35,76,32204,1,0,0,0,0,-1
5058,35,88,32204,2,0,0,0,2,-2
5059,35,78,32204,2,0,0,0,2,-2
5060,38,74,32204,49,3,2,1,6,-1
5061,41,63,32204,63,11,6,5,18,2
5062,74,86,92726,43,21,6,15,6,3
5063,77,86,92726,79,20,7,13,20,-16
5064,80,86,92726,80,23,11,12,6,0
5065,83,86,92726,82,40,17,23,8,0
5067,5,72,8736,1,0,0,0,0,0
5068,8,72,8736,1,0,0,0,0,-1
5069,11,72,8736,15,15,5,10,0,8
5070,14,72,8736,10,5,1,4,0,-5
5071,17,72,8736,28,13,4,9,17,-1
5072,17,84,8736,38,7,1,6,6,-8
5073,20,76,8736,3,0,0,0,0,-1
5074,23,62,8736,48,14,6,8,12,10
5075,26,71,8736,1,0,0,0,0,0
5076,29,71,8736,69,23,5,18,45,10
5077,32,69,8736,68,29,7,22,80,-6
5078,35,69,8736,82,43,13,30,54,-14
5079,38,69,8736,78,25,8,17,31,-1
5080,41,69,8736,55,24,4,20,38,6
5081,41,75,8736,14,5,3,2,6,6
5082,47,65,8736,60,15,3,12,38,-5
5084,50,72,8736,66,8,4,4,20,-5
5085,53,77,8736,73,10,5,5,41,0
5086,74,87,44281,8,1,0,1,0,-3
5087,77,87,44281,81,24,9,15,18,-9
5088,80,87,44281,77,25,11,14,40,-8
5089,83,87,44281,81,15,6,9,45,-24
5090,86,66,44281,82,25,15,10,38,1
5091,8,85,9138,72,44,18,26,93,15
5092,11,85,9138,47,32,10,22,37,5
5100,32,78,9138,82,41,12,29,71,18
5101,35,78,9138,80,26,11,15,87,8
5102,38,78,9138,80,30,20,10,66,-7
5103,41,78,9138,79,35,13,22,65,10
5104,47,78,9138,62,26,2,24,59,-13
4971,68,72,9039,23,5,2,3,6,-8
4972,71,72,9039,33,4,0,4,14,-2
5109,80,66,56084,2,0,0,0,0,-3
5110,83,85,56084,68,25,11,14,14,-14
5111,86,85,56084,30,6,1,5,4,-9
5112,8,81,70162,24,3,2,1,10,1
5113,29,81,70162,68,33,11,22,24,-18
5114,32,81,70162,34,6,2,4,18,-11
5115,11,62,10690,34,12,5,7,26,-5
5118,17,80,10690,42,16,9,7,54,-19
5119,20,1479,10690,73,18,9,9,54,-9
5120,23,1479,10690,73,16,6,10,82,-10
5121,26,1479,10690,75,11,5,6,83,2
5122,29,1479,10690,11,2,1,1,6,-1
5123,29,76,10690,55,3,2,1,31,-8
5124,32,82,10690,1,0,0,0,0,-3
5125,11,79,76333,4,0,0,0,0,0
5126,11,65,25914,27,8,2,6,16,1
5128,17,65,25914,43,5,2,3,14,3
5129,20,65,25914,5,0,0,0,0,2
5130,23,65,25914,82,18,5,13,57,-6
5131,26,65,25914,1,0,0,0,0,0
5132,26,62,25914,61,14,4,10,14,-7
5133,29,62,25914,23,1,0,1,4,-12
5134,32,65,25914,60,10,6,4,33,-4
5135,35,65,25914,3,1,1,0,4,1
5136,35,73,25914,26,7,5,2,10,-2
5137,38,78,25914,28,6,0,6,4,3
5138,71,73,48408,17,4,1,3,4,0
5139,77,73,48408,34,6,4,2,12,5
5140,80,73,48408,58,10,8,2,12,11
5141,83,73,48408,81,27,9,18,42,2
5142,86,73,48408,75,30,15,15,23,20
5143,5,65,54635,6,4,1,3,4,-1
5145,14,77,54635,33,8,2,6,37,7
5146,17,77,54635,82,20,5,15,101,12
5147,20,77,54635,62,19,4,15,35,6
5148,23,81,54635,78,14,5,9,110,-8
5149,26,81,54635,33,3,2,1,18,-21
5150,26,77,54635,45,6,2,4,32,-2
5151,29,77,54635,5,1,0,1,6,-2
5152,29,75,54635,67,19,7,12,40,-3
5153,32,75,54635,67,17,8,9,44,9
5154,35,75,54635,80,12,5,7,32,16
5155,38,75,54635,65,5,1,4,34,-5
5156,41,75,54635,9,0,0,0,2,-2
5159,8,72,8541,61,39,20,19,76,-6
5160,11,72,8541,70,33,13,20,72,28
5161,14,72,8541,48,20,10,10,18,9
5162,17,72,8541,63,30,13,17,58,9
5164,23,72,8541,82,65,29,36,100,23
5165,26,72,8541,78,64,27,37,119,16
5166,29,72,8541,79,46,23,23,106,7
5167,32,72,8541,80,50,15,35,97,19
5168,35,72,8541,81,54,25,29,97,7
5169,38,74,8541,64,35,16,19,52,-1
5170,41,74,8541,82,56,25,31,96,4
5174,56,72,8541,62,9,4,5,66,-2
5175,2,74,1924,29,7,1,6,12,2
5176,17,79,27416,69,10,5,5,68,-5
5177,20,79,27416,59,18,9,9,63,-4
5179,2,77,1851,50,13,3,10,22,1
5180,5,77,1851,5,1,0,1,2,-1
5182,11,68,47281,1,0,0,0,0,0
5183,14,68,47281,17,1,0,1,35,2
5184,17,78,47281,16,1,0,1,34,-2
5188,23,68,47281,23,1,0,1,44,1
5189,26,83,47281,18,2,0,2,24,3
5190,29,76,47281,2,1,0,1,2,3
5191,32,62,47281,17,1,0,1,11,-1
5192,35,62,47281,3,0,0,0,4,1
5193,2,77,70515,34,9,3,6,49,6
5194,5,77,70515,34,4,1,3,51,-9
5195,5,65,70515,12,5,1,4,21,2
5196,11,65,70515,7,0,0,0,53,1
5197,14,65,70515,19,1,0,1,25,-4
5198,5,83,69465,9,2,0,2,4,-4
5199,8,83,69465,12,7,1,6,21,-2
5200,11,83,69465,54,18,8,10,28,2
5201,14,83,69465,36,10,5,5,32,-12
5205,20,74,69465,27,8,1,7,10,2
5206,23,74,69465,48,10,5,5,16,-2
5208,26,78,69465,82,30,9,21,36,6
5209,29,78,69465,79,34,19,15,32,5
5210,32,78,69465,77,23,6,17,28,4
5211,35,78,69465,71,17,7,10,41,-2
5212,38,78,69465,17,4,1,3,8,1
5213,38,65,69465,53,12,2,10,24,-6
5214,41,79,69465,82,19,4,15,40,-18
5215,2,63,68087,15,4,4,0,31,0
5216,5,78,68087,1,0,0,0,0,0
5217,83,20120,202844,1,0,0,0,0,3
5218,77,62,22762,27,5,2,3,6,-5
5219,80,66,22762,3,0,0,0,0,-4
5220,11,84,31541,13,4,1,3,21,0
5221,14,62,31541,3,0,0,0,0,0
5222,2,67,67352,7,2,0,2,4,-2
5223,5,67,67352,10,1,1,0,8,-2
5225,11,1479,67352,80,39,14,25,40,-18
5226,14,78,67352,41,18,5,13,20,16
5227,17,81,67352,61,28,5,23,22,1
5228,20,81,67352,79,25,4,21,30,16
5229,23,86,67352,82,32,7,25,48,13
5230,26,86,67352,76,32,9,23,40,8
5231,29,81,67352,14,3,1,2,2,-3
5232,29,73,67352,57,14,2,12,24,-6
5233,32,73,67352,81,16,4,12,40,-7
5234,35,73,67352,82,8,0,8,40,-1
5235,38,73,67352,82,6,2,4,46,-2
5236,86,1479,196675,50,12,6,6,8,1
5237,2,85,67306,22,4,0,4,43,-2
5242,11,88,67306,54,8,2,6,165,-15
5106,53,85,9138,65,6,3,3,41,-12
5107,11,65,28796,12,1,0,1,12,2
5247,23,1479,67306,24,3,1,2,52,-5
5248,26,85,67306,3,1,0,1,0,-2
5249,29,67,67306,1,0,0,0,12,0
5250,38,67,67306,1,0,0,0,2,-2
5254,11,68,71093,78,29,6,23,62,3
5255,14,68,71093,48,13,6,7,38,1
5256,17,68,71093,64,23,7,16,37,4
5257,20,68,71093,69,14,8,6,48,12
5258,23,76,71093,74,12,5,7,27,-4
5259,26,76,71093,11,0,0,0,2,-2
5263,11,78,21375,26,22,7,15,12,-5
5264,14,62,21375,43,43,8,35,18,17
5265,17,62,21375,59,52,16,36,22,-2
5266,17,72,21375,22,16,1,15,8,-4
5267,20,89,21375,77,40,11,29,24,-10
5268,23,89,21375,64,31,6,25,24,-10
5270,29,62,21375,78,55,11,44,24,-12
5271,32,62,21375,69,34,4,30,24,-15
5272,35,65,21375,80,39,15,24,34,-3
5273,38,65,21375,57,29,6,23,24,7
5274,38,83,21375,1,0,0,0,2,-1
5275,8,72,24185,2,0,0,0,0,0
5276,11,72,24185,15,10,5,5,2,0
5277,14,72,24185,6,1,0,1,0,-2
5278,20,63,24185,5,0,0,0,0,-1
5279,32,68,24185,6,0,0,0,0,-1
5280,11,86,76683,3,1,1,0,0,-4
5281,83,78,195287,1,0,0,0,0,0
5282,83,82,37805,1,0,0,0,0,1
5283,86,82,37805,13,0,0,0,0,-4
5284,86,70,118708,18,2,2,0,6,-4
5285,2,77,22128,19,10,0,10,8,9
5287,8,85,22128,60,34,3,31,22,22
5288,11,85,22128,44,24,4,20,8,16
5289,14,85,22128,18,6,1,5,10,-3
5290,83,88,216319,1,1,0,1,0,1
5291,86,88,216319,4,1,0,1,0,-2
5292,86,88,142362,7,0,0,0,0,-1
5293,5,83,68869,2,0,0,0,0,0
5295,11,62,68869,6,3,0,3,7,-1
5296,14,71,68869,14,6,0,6,15,-8
5297,14,62,68869,1,0,0,0,0,-2
5298,86,86,22778,36,11,7,4,6,7
5300,5,86,33769,22,12,2,10,4,-2
5301,5,65,33769,18,3,1,2,6,4
5302,11,78,33769,36,11,6,5,8,-11
5303,23,70,33769,13,8,5,3,0,0
5304,23,71,33769,36,19,8,11,10,3
5306,29,76,33769,7,2,0,2,0,-1
5307,29,1479,33769,60,11,4,7,8,-2
5308,32,1479,33769,80,38,13,25,29,0
5311,2,62,68992,14,3,0,3,4,-4
5312,2,79,68992,37,20,6,14,13,-2
5313,5,79,68992,56,16,3,13,16,4
5314,86,84,201723,5,3,0,3,2,0
5315,86,80,201525,71,45,22,23,75,-10
5316,8,77,695711,10,4,2,2,4,5
5317,11,77,695711,37,13,8,5,10,-1
5318,86,71,300635,7,1,1,0,2,-5
5319,2,71,32176,53,27,5,22,32,4
5320,5,88,32176,56,23,4,19,43,-10
5321,8,88,32176,82,27,2,25,64,16
5322,11,88,32176,79,18,5,13,71,4
5323,14,88,32176,9,1,0,1,6,-6
5325,17,67,32176,52,10,5,5,59,-5
5326,17,78,32176,12,0,0,0,6,-7
5327,20,67,32176,1,0,0,0,0,-1
5328,86,1479,265646,15,2,0,2,2,-1
5329,5,78,73179,3,1,0,1,0,0
5330,8,78,73179,6,3,0,3,2,4
5331,11,78,73179,6,1,1,0,2,-1
5332,14,78,73179,3,0,0,0,2,-1
5333,11,75,27644,2,1,0,1,0,1
5334,14,75,27644,1,0,0,0,0,0
5335,17,75,27644,10,1,1,0,2,-5
5336,17,62,27644,8,0,0,0,4,-4
5337,20,68,27644,3,0,0,0,0,-1
5338,29,68,27644,3,0,0,0,0,-2
5339,2,65,70626,55,16,7,9,62,5
5340,5,65,70626,76,29,14,15,92,-11
5342,8,71,70626,5,1,0,1,2,-1
5343,11,74,70626,48,11,4,7,47,-5
5344,14,79,70626,40,11,2,9,34,-1
5345,17,83,70626,27,2,2,0,29,-5
5346,17,78,70626,32,15,3,12,26,7
5348,2,77,48624,10,3,1,2,10,1
5349,5,77,48624,60,32,14,18,41,1
5352,11,80,48624,34,12,4,8,12,-30
5353,14,80,48624,37,6,2,4,46,-17
5354,17,80,48624,43,15,4,11,63,-18
5355,17,77,48624,4,2,1,1,6,0
5356,5,63,19611,8,2,1,1,38,1
5357,8,63,19611,62,9,5,4,191,-4
5358,11,63,19611,77,24,13,11,143,10
5359,14,63,19611,44,12,6,6,139,6
5360,17,67,19611,76,15,5,10,148,-9
5362,86,85,236520,9,3,1,2,0,-5
5363,86,75,363887,79,34,11,23,26,1
5364,5,74,74393,1,0,0,0,0,0
5365,62,65,8307,7,0,0,0,4,-4
5366,65,65,8307,71,26,9,17,22,11
5367,68,65,8307,47,13,4,9,24,3
5368,71,65,8307,81,28,8,20,36,6
5369,74,65,8307,81,17,7,10,32,-5
5370,77,65,8307,41,4,0,4,24,-5
5371,80,65,8307,70,17,5,12,34,7
5372,83,66,8307,48,6,1,5,28,-6
5373,86,65,8307,74,12,4,8,30,-2
5374,86,66,328594,82,37,20,17,62,0
5375,80,85,37783,49,13,4,9,12,-7
5244,17,67,67306,38,4,1,3,52,3
5245,20,76,67306,70,10,2,8,99,1
5380,11,75,73615,5,0,0,0,25,-4
5381,14,75,73615,6,0,0,0,17,-1
5382,2,78,21339,78,131,86,45,22,23
5383,5,78,21339,73,109,70,39,48,-2
5384,8,78,21339,80,101,54,47,41,-27
5385,11,78,21339,81,97,57,40,38,-3
5386,14,78,21339,48,50,29,21,10,13
5387,17,78,21339,70,83,43,40,30,4
5388,20,78,21339,77,82,42,40,10,-9
5389,23,78,21339,66,72,27,45,26,-1
5390,26,70,21339,60,58,32,26,30,19
5391,29,70,21339,79,59,24,35,43,-21
5392,32,70,21339,79,79,39,40,18,10
5393,35,85,21339,82,63,30,33,35,18
5394,38,85,21339,82,76,37,39,22,11
5395,41,85,21339,81,68,25,43,12,-4
5398,5,74,54393,3,0,0,0,2,-4
5399,8,80,54393,69,34,13,21,14,-24
5400,11,68,54393,69,26,13,13,8,6
5401,14,68,54393,46,19,11,8,8,-1
5402,17,68,54393,78,37,20,17,25,5
5403,20,68,54393,67,16,10,6,4,1
5404,23,68,54393,21,2,2,0,4,1
5405,23,81,54393,28,6,2,4,4,2
5406,26,77,54393,72,14,3,11,12,-2
5407,29,77,54393,67,13,10,3,4,8
5408,32,77,54393,71,15,7,8,10,-1
5409,35,80,54393,24,4,2,2,6,0
5410,38,80,54393,70,11,3,8,14,-3
5411,41,80,54393,1,0,0,0,0,0
5416,17,64,9153,73,16,5,11,88,27
5417,20,64,9153,78,21,2,19,135,16
5419,26,64,9153,64,21,5,16,92,20
5420,29,64,9153,59,18,5,13,98,5
5421,32,64,9153,35,15,3,12,42,6
5422,35,64,9153,55,27,5,22,55,7
5423,38,64,9153,78,31,11,20,88,30
5424,41,64,9153,73,30,8,22,87,13
5425,47,82,9153,65,22,6,16,89,-16
5426,50,82,9153,59,12,3,9,71,-17
5427,53,82,9153,63,15,1,14,95,3
5428,53,64,9153,12,1,0,1,12,-1
5429,56,64,9153,42,7,1,6,30,-12
5430,59,64,9153,67,9,0,9,64,8
5431,62,64,9153,47,8,0,8,33,-9
5432,5,62,442,38,14,5,9,12,-6
5433,8,62,442,6,2,0,2,0,0
5434,2,72,67703,8,1,0,1,27,1
5436,14,63,67703,34,6,0,6,103,-3
5437,17,62,67703,70,12,3,9,162,14
5438,20,62,67703,39,4,0,4,117,2
5439,20,81,67703,13,1,0,1,34,-4
5440,23,81,67703,44,3,0,3,122,-4
5441,23,84,67703,7,1,0,1,55,2
5442,26,84,67703,26,1,0,1,63,-3
5444,29,89,67703,7,0,0,0,11,-5
5445,2,62,40938,57,25,10,15,125,-1
5448,8,89,40938,7,0,0,0,14,1
5449,71,85,10373,2,1,1,0,0,-1
5450,8,76,71092,7,4,2,2,2,-1
5452,14,70,71092,4,0,0,0,0,-3
5453,14,71,71092,9,3,3,0,0,3
5455,20,86,71092,2,0,0,0,2,-1
5456,2,89,21420,76,46,16,30,234,-22
5458,8,89,21420,84,79,20,59,198,3
5459,11,89,21420,52,38,9,29,131,-4
5460,14,89,21420,45,23,8,15,101,-4
5461,17,89,21420,82,37,13,24,112,5
5462,20,89,21420,82,46,14,32,125,-2
5463,23,89,21420,82,26,8,18,103,1
5464,26,89,21420,50,5,0,5,102,-7
5465,26,64,21420,12,6,2,4,17,0
5466,2,62,31549,34,7,5,2,143,1
5467,5,62,31549,30,4,1,3,167,2
5469,8,84,31549,26,4,0,4,99,1
5470,11,84,31549,56,7,3,4,171,-7
5471,14,84,31549,34,5,3,2,120,1
5472,17,84,31549,60,2,2,0,122,-8
5473,20,86,31549,46,4,0,4,135,0
5474,2,83,21416,42,18,3,15,113,-15
5476,5,89,21416,78,51,17,34,180,1
5477,8,89,21416,81,66,25,41,169,15
5478,11,89,21416,67,45,10,35,143,10
5479,11,63,21416,12,13,5,8,20,6
5480,20,86,21416,38,15,6,9,91,-10
5481,23,86,21416,21,9,2,7,28,-1
5482,2,85,72262,27,10,5,5,4,6
5483,86,63,118718,11,5,3,2,2,5
5484,8,86,27895,59,43,23,20,18,-18
5485,11,86,27895,84,35,15,20,28,-10
5486,14,80,27895,36,14,5,9,8,-16
5487,17,80,27895,52,13,8,5,15,-19
5488,14,65,15489,5,0,0,0,0,0
5489,77,88,39385,5,0,0,0,2,1
5490,80,88,39385,70,22,6,16,25,-15
5491,83,88,39385,16,1,0,1,12,-3
5493,86,89,39385,64,22,8,14,20,10
5494,86,67,85008,33,6,1,5,20,-8
5495,17,74,69980,10,5,2,3,4,-3
5496,41,74,69980,2,0,0,0,2,-1
5497,86,83,77292,53,7,3,4,14,0
5498,86,83,13082,61,12,1,11,18,5
5499,86,547,13082,4,1,0,1,0,0
5500,86,79,57000,37,5,2,3,10,3
5501,86,65,71996,82,37,13,24,6,10
5502,86,72,240138,25,7,2,5,6,-6
5503,86,87,123162,41,4,0,4,13,-9
5504,86,65,33107,2,0,0,0,0,-2
5505,86,68,17753,32,8,0,8,12,-3
5506,5,63,67947,3,0,0,0,2,0
5377,86,85,37783,60,15,2,13,17,1
5378,86,89,37783,20,5,0,5,4,3
5512,2,79,8626,80,57,27,30,42,-4
5513,5,79,8626,70,69,32,37,34,12
5514,8,79,8626,81,94,34,60,61,30
5515,11,79,8626,80,99,32,67,61,15
5516,14,79,8626,48,70,32,38,37,23
5517,17,79,8626,82,149,62,87,96,31
5518,20,79,8626,63,95,47,48,40,22
5519,23,79,8626,77,102,35,67,64,17
5520,26,79,8626,81,127,44,83,66,17
5521,29,79,8626,63,96,42,54,50,25
5522,32,79,8626,81,121,52,69,42,19
5523,35,89,8626,69,79,31,48,30,0
5524,38,89,8626,75,77,36,41,38,5
5525,41,89,8626,46,45,16,29,26,-4
5526,41,74,8626,31,29,15,14,12,-1
5527,47,74,8626,82,123,54,69,72,34
5529,53,74,8626,82,71,25,46,58,8
5530,65,77,8626,73,54,19,35,30,5
5531,68,70,8626,34,26,14,12,20,-5
5532,68,63,8626,11,9,2,7,2,3
5533,71,72,8626,82,67,24,43,46,16
5534,74,72,8626,57,29,11,18,42,-10
5535,74,68,8626,20,18,6,12,6,7
5536,77,68,8626,79,66,27,39,48,23
5537,80,68,8626,82,46,16,30,56,2
5538,83,62,8626,22,7,1,6,10,6
5539,8,67,20413,16,9,3,6,0,4
5540,14,67,20413,10,2,0,2,0,-3
5541,74,82,80656,6,1,0,1,2,-1
5542,77,82,80656,12,4,1,3,2,0
5543,80,82,80656,78,29,17,12,89,12
5544,83,82,80656,63,30,19,11,42,-1
5546,2,63,27963,77,92,26,66,8,15
5547,5,63,27963,53,51,12,39,20,1
5548,5,78,27963,25,36,6,30,2,5
5549,8,78,27963,84,106,24,82,12,-4
5550,11,78,27963,69,84,16,68,24,-14
5551,14,78,27963,8,7,2,5,0,3
5552,14,86,27963,27,20,5,15,10,-4
5553,17,86,27963,71,62,13,49,26,-35
5557,26,81,27963,38,22,4,18,10,-13
5558,26,76,27963,18,5,1,4,4,-2
5559,2,74,53019,67,16,9,7,172,-1
5560,5,74,53019,4,0,0,0,5,-1
5567,20,1479,53019,12,2,0,2,47,-3
5568,23,1479,53019,55,9,4,5,116,-22
5569,23,76,53019,12,0,0,0,34,-3
5571,26,65,53019,60,1,1,0,65,-11
5573,32,65,53019,28,0,0,0,33,-8
5574,8,76,9164,61,25,7,18,43,4
5575,11,76,9164,83,40,18,22,44,16
5576,14,76,9164,42,12,5,7,25,-10
5577,17,76,9164,69,70,25,45,42,-20
5578,20,76,9164,79,64,23,41,38,-5
5579,23,76,9164,54,26,14,12,66,-19
5580,23,1479,9164,22,16,5,11,16,-10
5581,26,1479,9164,79,30,13,17,81,-7
5584,35,83,9164,82,34,11,23,61,13
5585,38,83,9164,75,24,12,12,67,2
5586,41,63,9164,64,16,11,5,67,-6
5587,47,63,9164,82,22,10,12,79,-2
5588,50,1479,9164,7,2,1,1,6,3
5589,50,83,9164,24,0,0,0,21,1
5590,11,76,70513,3,0,0,0,7,0
5592,14,65,70513,24,6,1,5,23,2
5593,17,65,70513,28,6,2,4,28,5
5594,20,88,70513,18,6,4,2,15,-2
5595,11,63,47472,7,1,0,1,2,-3
5596,14,63,47472,38,6,0,6,22,3
5597,17,63,47472,14,0,0,0,4,-3
5598,26,80,47472,13,1,0,1,8,0
5599,29,80,47472,9,0,0,0,4,0
5600,41,89,47472,11,1,1,0,6,-1
5601,2,77,46371,18,3,2,1,2,-5
5602,5,77,46371,2,0,0,0,0,-1
5604,2,79,60366,13,4,1,3,26,2
5605,5,79,60366,53,9,4,5,104,-1
5606,8,79,60366,58,5,0,5,65,6
5607,11,79,60366,61,6,2,4,126,-10
5608,14,79,60366,25,4,0,4,36,2
5610,17,67,60366,6,0,0,0,28,1
5611,5,72,9049,5,1,0,1,9,1
5612,8,72,9049,65,34,14,20,63,14
5613,11,72,9049,81,44,25,19,101,14
5614,14,72,9049,48,25,12,13,72,6
5615,17,72,9049,80,53,23,30,116,7
5616,20,72,9049,82,47,29,18,95,-2
5617,23,72,9049,19,10,5,5,13,0
5618,23,71,9049,40,29,13,16,80,1
5619,26,71,9049,80,64,30,34,133,7
5620,29,71,9049,70,46,24,22,123,4
5621,32,71,9049,21,22,12,10,18,11
5622,32,63,9049,64,63,28,35,122,-4
5623,35,63,9049,78,66,41,25,91,-1
5624,38,70,9049,64,50,25,25,113,5
5625,41,70,9049,82,69,34,35,109,14
5627,50,78,9049,61,47,28,19,52,8
5628,50,86,9049,16,9,8,1,14,2
5629,53,76,9049,81,44,23,21,65,-15
5630,56,76,9049,61,36,16,20,63,-15
5631,56,79,9049,17,12,5,7,18,3
5632,59,79,9049,78,45,21,24,75,-9
5633,2,89,13685,80,52,11,41,23,-2
5634,5,89,13685,80,56,14,42,49,2
5635,8,89,13685,77,45,7,38,56,3
5636,11,89,13685,84,42,9,33,59,3
5637,14,89,13685,46,31,5,26,35,-6
5638,17,89,13685,78,35,10,25,50,13
5639,20,89,13685,65,17,6,11,16,-2
5640,23,89,13685,73,35,15,20,30,-11
5508,11,84,77882,30,14,7,7,49,-3
5509,14,84,77882,3,1,1,0,0,0
5645,38,89,13685,82,15,3,12,22,9
5646,41,83,13685,8,6,0,6,0,5
5647,2,62,1394,38,17,4,13,47,9
5648,8,62,1394,77,20,4,16,62,13
5649,14,65,1394,11,1,1,0,6,1
5650,2,79,31455,24,5,0,5,23,-3
5654,11,70,31455,53,7,0,7,51,-6
5655,11,89,31455,8,0,0,0,12,-1
5656,14,89,31455,47,13,0,13,43,6
5657,17,89,31455,66,6,2,4,34,-3
5660,8,72,73766,4,3,2,1,9,2
5661,11,72,73766,13,1,1,0,23,0
5662,14,72,73766,8,0,0,0,7,-6
5663,14,81,73766,18,2,0,2,6,1
5664,14,63,1316,1,1,0,1,0,0
5665,17,68,1316,8,3,0,3,6,-2
5667,35,82,1316,25,14,2,12,8,-5
5668,5,62,54453,5,0,0,0,7,-2
5669,8,62,54453,15,5,2,3,22,-4
5671,11,83,27459,6,0,0,0,0,-2
5672,14,83,27459,1,0,0,0,0,-1
5673,17,83,27459,1,0,0,0,0,0
5674,23,89,27459,6,0,0,0,4,2
5675,26,76,27459,70,8,2,6,68,-16
5679,2,83,334,1,0,0,0,0,0
5680,5,83,334,3,1,0,1,5,-1
5681,29,70,69532,4,0,0,0,0,1
5684,11,70,8835,83,31,12,19,211,19
5685,14,70,8835,43,16,5,11,105,3
5686,17,70,8835,79,31,8,23,129,-12
5687,20,70,8835,63,22,3,19,97,8
5688,23,70,8835,70,31,6,25,132,9
5690,29,70,8835,57,24,2,22,68,6
5691,32,70,8835,80,23,2,21,77,5
5692,35,70,8835,80,25,4,21,87,12
5693,38,70,8835,82,30,8,22,106,37
5694,41,85,8835,15,4,0,4,8,4
5695,47,77,8835,77,17,4,13,93,2
5696,50,77,8835,82,9,3,6,67,-24
5697,53,77,8835,44,7,2,5,33,4
5698,17,71,1573,29,6,4,2,30,-11
5699,29,71,1573,5,2,0,2,2,-2
5700,35,73,1573,3,0,0,0,6,-3
5701,8,62,28519,1,0,0,0,0,0
5702,5,78,9040,4,1,1,0,0,1
5703,8,78,9040,42,8,0,8,30,-2
5704,11,78,9040,61,11,0,11,64,-8
5705,11,84,9040,8,1,0,1,0,1
5707,17,84,9040,77,29,6,23,83,8
5708,20,84,9040,67,19,4,15,51,-3
5709,23,84,9040,71,27,3,24,79,3
5710,26,84,9040,42,13,2,11,34,7
5711,26,68,9040,25,10,3,7,17,-2
5712,29,68,9040,76,25,6,19,68,4
5713,32,68,9040,70,20,5,15,72,-7
5714,35,68,9040,31,10,3,7,12,-4
5715,35,66,9040,26,6,2,4,10,3
5716,38,66,9040,72,17,3,14,75,-24
5717,41,66,9040,81,24,7,17,64,-10
5718,47,66,9040,74,27,5,22,58,11
5719,50,66,9040,50,10,0,10,36,-8
5720,53,66,9040,66,17,2,15,70,17
5721,56,1479,9040,51,6,1,5,36,-7
5722,5,63,30314,14,7,3,4,6,-1
5724,11,63,30314,77,21,10,11,32,-2
5725,14,63,30314,36,16,7,9,23,0
5726,17,63,30314,76,28,16,12,43,-3
5727,20,63,30314,30,25,17,8,27,-8
5728,23,63,30314,61,46,26,20,54,8
5729,26,63,30314,73,40,22,18,30,7
5730,29,63,30314,75,25,12,13,36,-8
5731,32,82,30314,65,42,22,20,38,-19
5732,32,67,30314,14,12,5,7,8,6
5733,35,88,30314,73,31,15,16,46,-15
5734,38,88,30314,27,12,5,7,12,-5
5735,2,88,145847,53,20,9,11,57,11
5736,5,77,145847,48,17,7,10,44,-2
5737,2,89,74621,17,6,3,3,8,3
5740,14,83,23271,8,1,0,1,4,0
5741,17,83,23271,46,12,6,6,47,-2
5743,20,83,23271,64,17,11,6,47,-20
5744,23,83,23271,80,12,8,4,67,-20
5745,26,83,23271,35,5,2,3,30,-4
5746,26,84,23271,27,4,2,2,22,-15
5747,29,84,23271,40,9,5,4,14,-3
5748,32,69,23271,72,29,18,11,36,1
5749,35,69,23271,68,24,9,15,50,-22
5750,38,69,23271,28,6,1,5,8,-3
5751,41,69,23271,14,1,1,0,6,-7
5752,41,64,23271,20,4,1,3,6,-8
5753,2,71,54457,49,22,5,17,59,3
5754,5,71,54457,7,0,0,0,8,-1
5755,8,71,54457,33,12,2,10,48,-9
5756,11,71,54457,10,2,1,1,28,-8
5757,11,81,54457,66,29,10,19,108,-13
5758,14,79,54457,33,15,5,10,46,3
5760,20,84,54457,63,16,3,13,62,-21
5761,23,77,54457,15,1,1,0,19,1
5762,26,77,54457,2,0,0,0,2,0
5763,29,84,54457,38,11,2,9,6,-4
5767,11,71,70021,22,2,0,2,32,-6
5768,29,81,70021,37,0,0,0,45,-12
5769,29,76,70021,6,3,0,3,2,6
5770,17,76,54531,1,1,0,1,0,1
5772,11,89,64835,13,5,0,5,87,2
5773,14,89,64835,27,2,1,1,102,-6
5774,17,89,64835,54,3,1,2,164,-1
5775,20,89,64835,38,3,1,2,130,0
5776,17,83,9043,5,0,0,0,0,-1
5777,20,83,9043,20,5,1,4,6,-6
5642,29,89,13685,82,32,7,25,24,13
5643,32,89,13685,76,36,7,29,26,11
5782,47,89,9043,71,28,7,21,54,-5
5783,50,89,9043,52,16,4,12,27,4
5784,50,88,9043,19,8,2,6,20,-2
5785,56,81,9043,13,2,0,2,4,-1
5786,29,73,18450,2,0,0,0,2,0
5787,32,73,18450,8,0,0,0,13,-1
5788,8,75,9050,31,8,2,6,54,-5
5789,11,1479,9050,68,27,7,20,78,-12
5790,14,80,9050,45,15,1,14,30,-11
5791,17,80,9050,80,21,7,14,94,-26
5792,20,80,9050,5,0,0,0,4,1
5793,23,80,9050,13,2,1,1,6,-3
5794,23,66,9050,42,5,0,5,48,-2
5795,26,66,9050,54,10,0,10,48,9
5796,29,66,9050,62,44,13,31,59,3
5797,32,78,9050,48,11,1,10,51,5
5799,35,66,9050,49,30,7,23,61,-1
5800,38,66,9050,82,29,5,24,141,4
5801,41,66,9050,80,39,13,26,84,-2
5802,47,68,9050,78,20,2,18,80,3
5803,50,76,9050,81,25,1,24,110,6
5804,53,69,9050,35,9,2,7,32,-16
5805,8,88,72249,40,12,6,6,90,0
5806,8,85,72249,21,8,2,6,19,7
5807,11,74,72249,2,0,0,0,7,1
5808,11,77,27541,2,1,1,0,0,1
5809,14,62,27541,2,1,0,1,2,1
5810,17,62,27541,4,0,0,0,6,0
5811,20,62,27541,58,18,7,11,49,-2
5812,23,62,27541,13,1,0,1,27,0
5813,2,88,26584,67,28,9,19,33,3
5814,5,77,26584,16,5,3,2,10,-3
5816,8,81,26584,47,7,3,4,18,-13
5817,2,75,25148,73,36,13,23,50,6
5818,5,75,25148,67,41,11,30,64,16
5819,8,75,25148,77,60,15,45,95,29
5820,11,75,25148,80,46,16,30,119,6
5821,14,75,25148,48,20,10,10,15,5
5822,17,75,25148,18,7,0,7,6,-6
5823,17,64,25148,55,20,10,10,40,1
5824,20,64,25148,81,27,10,17,63,2
5825,23,74,25148,70,18,8,10,47,-12
5826,23,70,25148,13,5,2,3,5,0
5827,26,70,25148,81,29,6,23,62,-2
5828,29,70,25148,81,34,13,21,41,9
5829,32,70,25148,67,24,10,14,35,4
5830,35,78,25148,56,10,4,6,22,-2
5831,35,64,25148,22,7,2,5,16,-2
5833,41,84,25148,64,17,8,9,20,7
5834,2,72,21383,78,41,10,31,76,23
5835,5,72,21383,76,40,12,28,70,14
5836,8,72,21383,64,17,3,14,57,4
5837,11,1479,21383,55,22,4,18,43,-8
5838,11,78,21383,8,2,0,2,19,5
5839,14,63,21383,44,16,2,14,33,-2
5840,17,63,21383,19,1,1,0,12,1
5841,86,64,62380,5,0,0,0,0,-2
5846,11,62,31453,57,21,1,20,48,-2
5847,14,62,31453,28,5,2,3,10,7
5848,17,62,31453,13,0,0,0,14,-6
5849,20,70,31453,13,1,0,1,6,3
5850,23,70,31453,17,3,1,2,26,5
5851,26,70,31453,22,1,0,1,22,-2
5852,26,73,31453,16,0,0,0,12,-3
5854,2,63,2160,16,3,2,1,6,0
5855,11,80,2160,28,6,1,5,14,-8
5856,2,67,60223,64,12,4,8,119,5
5860,14,71,60223,40,10,2,8,25,2
5861,8,63,67939,2,0,0,0,0,0
5862,11,80,67939,63,4,2,2,162,-19
5863,14,80,67939,26,2,1,1,64,-2
5865,17,70,67939,51,12,6,6,176,3
5866,20,70,67939,40,11,5,6,105,5
5867,23,71,67939,30,1,0,1,72,-5
5868,26,71,67939,3,0,0,0,0,0
5869,29,88,67939,1,0,0,0,2,0
5870,2,85,48582,7,1,1,0,12,-1
5871,5,85,48582,27,11,3,8,24,-2
5872,8,85,48582,68,30,19,11,46,-1
5873,11,85,48582,61,13,6,7,30,-2
5875,17,62,48582,41,10,3,7,36,3
5876,20,63,48582,56,18,8,10,30,-17
5877,17,63,54642,3,0,0,0,0,0
5878,2,76,74365,2,0,0,0,5,0
5879,5,85,74365,58,11,3,8,133,1
5881,2,77,21573,27,24,10,14,8,-8
5882,5,74,21573,32,18,7,11,12,-5
5884,8,74,68092,23,9,1,8,16,4
5886,23,67,68092,3,0,0,0,2,-1
5887,26,67,68092,1,0,0,0,0,2
5888,29,67,68092,1,0,0,0,2,1
5889,2,85,72197,4,0,0,0,0,1
5890,8,85,72197,10,0,0,0,20,1
5891,11,85,72197,9,0,0,0,12,-4
5893,2,78,67936,26,2,1,1,128,2
5894,5,78,67936,46,4,1,3,166,-3
5896,11,65,67936,65,6,4,2,133,2
5897,14,65,67936,14,0,0,0,30,-5
5898,2,89,21562,40,27,13,14,21,-1
5899,5,89,21562,80,73,36,37,35,24
5900,8,89,21562,64,66,31,35,28,29
5901,11,89,21562,83,58,29,29,73,-2
5902,14,89,21562,48,26,12,14,41,0
5903,17,88,21562,76,64,27,37,44,0
5904,20,88,21562,75,56,19,37,38,8
5905,23,63,21562,82,66,29,37,42,25
5906,26,63,21562,79,71,29,42,48,11
5907,29,83,21562,53,30,12,18,24,8
5908,32,83,21562,27,9,3,6,8,8
5909,32,89,21562,43,29,10,19,8,-8
5779,29,76,9043,54,17,6,11,26,-9
5780,32,82,9043,69,27,11,16,33,3
5919,23,83,52061,82,6,3,3,199,-13
5920,26,83,52061,67,4,2,2,105,-16
5921,29,83,52061,39,6,2,4,55,4
5922,32,65,52061,13,1,1,0,8,-3
5923,2,76,31690,66,45,19,26,44,1
5924,5,76,31690,80,78,40,38,46,-10
5925,8,76,31690,77,76,38,38,47,-4
5926,11,76,31690,78,70,30,40,59,18
5927,14,76,31690,43,26,10,16,41,-5
5928,17,76,31690,61,32,12,20,23,-10
5929,20,76,31690,70,53,23,30,20,-6
5931,23,83,31690,77,46,21,25,43,-7
5932,26,83,31690,81,52,24,28,20,15
5933,29,83,31690,3,0,0,0,2,-2
5934,29,78,31690,19,9,2,7,6,0
5935,2,71,72199,70,68,40,28,113,24
5937,8,71,72199,68,48,32,16,100,-15
5938,11,81,72199,75,55,28,27,76,-15
5939,14,81,72199,47,26,13,13,26,-13
5940,17,81,72199,67,52,22,30,68,-25
5941,20,88,72199,8,4,0,4,2,-7
5942,20,79,72199,9,4,1,3,4,-4
5943,20,71,72199,16,6,1,5,6,-1
5944,26,85,72199,13,1,1,0,4,-3
5945,20,88,26328,9,0,0,0,37,1
5946,23,88,26328,62,8,4,4,150,-9
5947,26,88,26328,20,1,1,0,36,-3
5948,29,88,26328,46,5,0,5,125,3
5949,32,69,26328,20,2,1,1,19,0
5950,32,79,26328,34,0,0,0,100,-4
5951,35,74,26328,54,3,2,1,144,0
5952,38,79,26328,79,10,9,1,128,-18
5954,5,63,68033,15,5,0,5,6,8
5955,8,77,68033,37,7,3,4,16,-3
5956,11,84,68098,12,6,5,1,9,3
5957,14,84,68098,3,1,1,0,4,0
5958,17,67,68098,22,9,5,4,41,3
5959,23,76,68098,8,2,1,1,4,1
5960,2,74,27638,51,35,15,20,58,3
5961,5,86,27638,48,37,11,26,54,-7
5962,8,86,27638,78,78,26,52,90,-15
5963,11,62,27638,51,30,7,23,28,-6
5964,14,62,27638,12,11,7,4,6,2
5965,2,63,42237,2,0,0,0,0,2
5966,11,88,43021,3,1,0,1,0,-2
5967,2,85,40947,52,9,5,4,253,-6
5968,2,74,40947,5,0,0,0,36,-1
5969,5,74,40947,51,11,7,4,121,-4
5971,11,74,40947,71,3,2,1,129,-9
5972,14,74,40947,48,3,1,2,71,-4
5973,17,74,40947,38,3,1,2,49,-4
5974,17,84,40947,7,1,0,1,19,-3
5975,20,85,40947,34,3,2,1,70,-7
5976,23,85,40947,63,11,6,5,92,7
5977,26,85,40947,39,7,2,5,87,0
5978,8,81,8513,66,51,27,24,12,-7
5979,2,65,26571,70,12,0,12,40,11
5980,5,65,26571,49,16,2,14,65,4
5983,8,85,26571,6,1,0,1,4,1
5984,11,85,26571,19,0,0,0,10,1
5985,11,80,26571,8,2,0,2,2,-4
5986,14,62,26571,1,0,0,0,0,0
5987,2,83,58182,3,0,0,0,9,0
5988,2,89,58182,7,0,0,0,101,1
5992,14,78,14820,15,6,3,3,6,4
5993,17,78,14820,49,15,8,7,30,-4
5994,17,88,14820,11,9,5,4,6,-4
5995,20,88,14820,31,7,4,3,26,-7
5996,23,88,14820,74,38,17,21,42,9
5997,26,88,14820,69,19,7,12,32,-12
5998,29,88,14820,76,23,9,14,28,-10
5999,32,88,14820,26,9,4,5,16,0
6000,35,88,14820,72,27,13,14,24,14
6001,38,88,14820,70,9,3,6,22,-13
6002,41,1479,14820,39,3,1,2,14,-4
6003,41,83,14820,10,2,1,1,6,0
6004,41,89,14820,15,6,0,6,8,-6
6005,35,64,69530,1,1,0,1,0,0
6006,2,89,52376,79,18,9,9,196,-4
6007,5,89,52376,65,10,4,6,206,-3
6011,14,74,52376,40,4,1,3,93,0
6012,17,74,52376,42,7,3,4,77,1
6013,17,83,52376,19,2,1,1,30,0
6014,20,83,52376,35,5,3,2,62,1
6015,11,85,9026,52,17,6,11,22,-7
6016,14,85,9026,22,8,3,5,14,1
6017,17,85,9026,60,40,18,22,30,6
6018,20,85,9026,43,16,6,10,12,-5
6019,20,79,9026,32,16,7,9,14,-13
6020,23,79,9026,5,1,1,0,2,0
6021,23,65,9026,69,33,11,22,38,-2
6022,26,73,9026,68,50,16,34,24,-8
6023,29,73,9026,82,44,11,33,40,-15
6024,32,73,9026,82,32,15,17,46,-6
6025,35,73,9026,82,44,18,26,38,-14
6026,38,73,9026,38,17,8,9,22,7
6028,47,73,9026,68,19,11,8,10,5
6029,2,65,31948,40,14,2,12,32,3
6030,5,65,31948,61,13,3,10,36,3
6031,8,65,31948,71,19,5,14,59,7
6032,11,65,31948,60,17,4,13,34,9
6036,17,84,31948,24,1,1,0,10,5
6037,20,84,31948,2,0,0,0,0,0
6038,20,77,31948,2,0,0,0,2,-2
6039,32,82,31948,48,7,2,5,12,-5
6040,32,79,31948,7,2,0,2,0,-2
6041,35,89,31948,56,14,1,13,12,7
6042,2,84,32133,76,32,12,20,21,-11
6043,5,84,32133,36,4,2,2,2,-9
6044,8,84,32133,32,21,10,11,14,10
5911,2,74,52061,72,25,11,14,154,-1
5912,5,74,52061,79,19,10,9,224,13
6054,35,82,32133,59,15,4,11,4,-14
6055,2,77,74366,63,18,7,11,195,-4
6056,5,77,74366,19,5,3,2,18,-5
6058,5,89,67311,67,30,13,17,107,-1
6059,8,89,67311,77,23,11,12,60,-13
6060,11,89,67311,66,30,12,18,60,-4
6061,14,1479,67311,35,22,11,11,10,1
6062,17,1479,67311,60,37,9,28,70,-9
6063,17,89,67311,16,11,6,5,12,8
6064,20,89,67311,47,16,5,11,37,-10
6065,23,89,67311,45,14,2,12,30,-3
6066,8,89,53594,71,26,12,14,124,18
6067,11,89,53594,68,35,16,19,149,4
6068,14,89,53594,40,20,14,6,65,-2
6069,17,89,53594,68,41,18,23,103,8
6070,20,89,53594,11,5,2,3,13,-2
6072,23,64,53594,23,10,3,7,22,-4
6073,26,64,53594,12,4,2,2,20,-6
6074,26,77,53594,66,49,18,31,78,29
6075,29,77,53594,57,25,9,16,82,8
6076,32,77,53594,8,0,0,0,4,-5
6077,2,67,21348,74,44,12,32,66,14
6078,5,67,21348,8,2,2,0,6,0
6079,5,76,21348,59,35,6,29,43,13
6080,8,76,21348,80,38,9,29,67,6
6081,11,76,21348,41,21,7,14,30,11
6083,17,64,21348,6,3,0,3,4,4
6084,20,64,21348,60,21,4,17,48,12
6085,23,64,21348,78,31,9,22,38,21
6086,26,85,21348,22,5,3,2,6,0
6087,35,85,21348,8,1,0,1,8,-1
6089,2,76,2927,6,1,1,0,0,-2
6091,8,76,2927,1,3,1,2,0,3
6092,2,88,22059,72,36,23,13,46,9
6093,5,88,22059,80,43,22,21,42,-15
6094,8,88,22059,15,6,3,3,8,-3
6095,8,80,22059,48,35,21,14,22,-22
6096,11,80,22059,42,41,26,15,14,-25
6097,11,68,22059,44,29,14,15,10,-8
6098,14,68,22059,26,9,6,3,2,2
6099,17,68,22059,13,1,0,1,0,1
6100,11,70,72035,3,0,0,0,0,0
6101,2,88,22055,15,6,1,5,10,7
6102,2,83,22055,59,39,17,22,48,-6
6103,5,83,22055,72,24,9,15,72,-5
6104,8,83,22055,84,39,19,20,62,3
6105,11,83,22055,54,11,5,6,28,-5
6106,14,85,22055,20,5,2,3,6,3
6108,17,77,104410,14,6,3,3,17,4
6109,2,83,28720,19,3,0,3,8,-12
6110,2,84,28720,32,27,4,23,20,-13
6111,5,76,28720,74,56,9,47,30,-18
6112,8,76,28720,52,38,8,30,38,9
6113,11,76,28720,66,40,9,31,47,7
6114,14,1479,28720,22,7,4,3,6,-13
6115,5,88,2700,73,60,23,37,24,-24
6116,8,88,2700,82,87,27,60,38,19
6117,11,88,2700,81,77,31,46,48,-24
6118,14,88,2700,38,29,10,19,24,-17
6119,17,88,2700,57,40,17,23,37,-12
6120,17,74,2700,14,5,1,4,2,-4
6121,20,1479,2700,82,35,13,22,12,-13
6122,23,64,2700,70,22,5,17,12,6
6123,5,63,21386,14,19,5,14,4,6
6125,11,63,21386,63,72,14,58,35,11
6126,11,89,21386,11,13,5,8,6,0
6127,14,89,21386,44,43,5,38,8,-1
6128,17,89,21386,80,64,14,50,30,-3
6129,20,89,21386,58,42,15,27,8,-11
6130,23,89,21386,56,31,9,22,26,-8
6131,26,89,21386,63,41,14,27,20,-3
6132,26,67,21386,9,2,1,1,2,-1
6133,29,80,21386,65,37,13,24,22,3
6135,35,75,21386,70,36,8,28,10,-3
6136,38,75,21386,72,22,6,16,20,-10
6137,41,75,21386,70,15,5,10,20,-4
6138,23,80,4713,72,16,5,11,38,2
6139,26,80,4713,34,6,3,3,32,-5
6140,29,80,4713,65,19,5,14,39,12
6141,32,80,4713,73,14,2,12,31,8
6143,38,80,4713,78,19,3,16,71,7
6144,41,80,4713,82,23,7,16,46,15
6145,47,80,4713,69,19,1,18,90,19
6146,50,80,4713,82,26,8,18,80,36
6147,53,80,4713,81,18,5,13,56,15
6148,56,80,4713,82,22,6,16,66,-14
6149,59,80,4713,82,24,8,16,45,8
6150,62,80,4713,82,9,1,8,32,-35
6151,65,80,4713,80,19,5,14,16,12
6152,68,80,4713,48,14,5,9,43,-5
6153,71,80,4713,70,15,1,14,30,-12
6154,74,80,4713,36,3,0,3,12,0
6155,26,65,8778,25,15,9,6,10,7
6156,29,65,8778,47,18,10,8,18,-6
6157,32,67,8778,79,51,23,28,54,1
6158,35,67,8778,76,44,23,21,42,-10
6160,41,67,8778,77,53,22,31,40,-9
6161,47,67,8778,54,40,20,20,38,-1
6162,50,73,8778,82,66,21,45,28,14
6163,53,73,8778,80,72,29,43,34,5
6164,56,73,8778,82,65,16,49,20,1
6165,59,73,8778,74,45,17,28,20,8
6166,62,73,8778,70,19,10,9,16,2
6167,29,89,19079,3,0,0,0,0,-2
6168,29,70,4482,22,3,1,2,6,-1
6169,32,70,4482,16,0,0,0,18,-6
6170,35,63,4482,2,0,0,0,2,-1
6171,38,83,4482,42,2,0,2,41,-10
6172,41,83,4482,29,6,2,4,13,-11
6173,41,79,4482,25,24,7,17,14,-5
6051,26,66,32133,75,25,9,16,10,-13
6052,29,66,32133,81,40,13,27,8,-4
6178,23,71,9130,38,5,1,4,6,-5
6179,26,71,9130,61,14,6,8,23,2
6180,29,71,9130,76,27,8,19,20,7
6181,32,85,9130,55,11,5,6,14,1
6182,35,85,9130,79,25,9,16,24,9
6183,38,85,9130,61,12,3,9,16,4
6184,41,85,9130,61,15,6,9,20,-1
6186,50,83,9130,33,19,8,11,12,4
6187,53,83,9130,62,18,7,11,24,-6
6188,56,83,9130,23,11,6,5,2,3
6189,2,79,68902,1,0,0,0,2,0
6190,2,62,68902,42,9,0,9,153,10
6191,5,62,68902,21,1,0,1,107,2
6192,8,80,68902,4,1,0,1,4,0
6193,14,86,68902,18,7,2,5,33,-7
6194,17,86,68902,57,8,1,7,146,-12
6200,20,64,21349,68,66,28,38,38,5
6201,23,64,21349,75,66,26,40,60,-2
6202,26,64,21349,65,44,14,30,28,1
6203,29,74,21349,58,32,13,19,24,-13
6204,32,74,21349,65,34,14,20,36,-18
6205,35,70,21349,24,9,3,6,2,3
6206,35,72,21349,30,12,4,8,18,-2
6207,29,63,31018,3,0,0,0,0,-3
6208,41,65,31018,41,1,0,1,70,-9
6211,38,79,70062,12,3,0,3,19,-7
6212,41,79,70062,52,5,2,3,105,-23
6213,26,84,10822,30,6,2,4,10,-10
6214,29,84,10822,6,6,1,5,2,2
6215,32,84,10822,10,1,1,0,0,0
6216,35,66,10822,8,0,0,0,2,0
6217,38,83,10822,5,1,1,0,2,-2
6219,23,62,8960,82,29,9,20,88,1
6220,26,62,8960,71,34,7,27,73,4
6221,29,62,8960,78,38,9,29,80,2
6222,32,62,8960,51,28,5,23,56,-15
6223,35,62,8960,61,34,4,30,88,-4
6224,38,64,8960,75,48,11,37,68,16
6225,41,64,8960,69,28,6,22,47,4
6231,56,74,8960,18,8,0,8,16,3
6232,59,63,8960,58,25,3,22,26,-2
6238,26,78,8703,22,10,3,7,8,2
6239,29,78,8703,32,24,10,14,20,9
6240,32,78,8703,41,13,4,9,14,-5
6241,35,71,8703,52,11,6,5,41,0
6242,38,71,8703,70,31,11,20,28,19
6243,41,71,8703,17,8,2,6,10,5
6244,47,71,8703,58,26,9,17,20,-12
6246,50,71,8703,72,20,6,14,60,-15
6247,53,71,8703,82,25,11,14,50,-17
6250,62,68,8703,82,32,14,18,22,2
6251,65,76,8703,61,6,1,5,34,-25
6252,68,76,8703,31,5,0,5,4,-3
6253,23,67,8864,21,5,2,3,14,2
6254,26,67,8864,42,10,3,7,37,6
6255,29,67,8864,67,14,8,6,43,1
6256,32,67,8864,82,31,12,19,51,0
6257,35,67,8864,69,19,8,11,34,-1
6258,38,88,8864,57,16,4,12,28,-1
6259,41,72,8864,69,13,7,6,41,5
6260,47,72,8864,67,10,5,5,32,-4
6261,50,72,8864,71,10,3,7,25,-3
6262,32,68,8285,30,2,0,2,45,-3
6263,35,68,8285,68,5,1,4,131,-20
6265,38,1479,8285,29,1,0,1,43,-2
6266,41,1479,8285,46,4,0,4,94,-1
6267,20,1479,8647,30,1,0,1,37,-8
6268,23,1479,8647,66,15,5,10,70,7
6269,26,1479,8647,74,16,2,14,65,1
6270,29,1479,8647,71,10,5,5,94,3
6271,32,1479,8647,50,6,1,5,70,-14
6272,35,1479,8647,82,11,4,7,97,-10
6273,38,1479,8647,61,12,4,8,78,2
6274,41,1479,8647,82,15,4,11,110,-1
6275,47,1479,8647,78,19,1,18,114,17
6276,50,68,8647,82,32,6,26,102,-13
6277,53,68,8647,65,23,3,20,75,-5
6278,53,64,8647,17,7,3,4,23,1
6279,56,64,8647,70,21,4,17,72,-4
6280,59,64,8647,14,6,1,5,10,-1
6282,23,75,13396,1,0,0,0,0,-1
6283,26,75,13396,25,1,1,0,0,-2
6284,29,75,13396,25,2,0,2,4,-6
6285,32,75,13396,6,0,0,0,2,-2
6286,32,75,3594,5,2,1,1,4,-2
6287,26,81,14731,5,0,0,0,16,-4
6288,11,79,76337,9,0,0,0,2,0
6295,38,67,8767,14,12,7,5,12,1
6296,41,67,8767,82,65,28,37,70,-7
6297,47,67,8767,48,58,25,33,48,3
6298,50,67,8767,81,95,32,63,89,17
6299,53,77,8767,79,72,31,41,68,-22
6300,56,77,8767,29,25,11,14,26,-1
6301,59,77,8767,75,53,26,27,71,-2
6302,62,77,8767,77,68,34,34,87,20
6303,65,77,8767,70,49,16,33,69,5
6305,71,75,8767,69,25,13,12,30,1
6306,74,64,8767,57,12,8,4,18,-7
6307,20,89,35345,19,10,7,3,4,-1
6308,23,89,35345,17,5,4,1,10,-5
6309,26,89,35345,25,14,6,8,12,-2
6310,29,89,35345,23,3,1,2,2,-7
6311,29,81,35345,29,10,5,5,28,-7
6312,20,77,8628,68,21,8,13,22,3
6313,23,77,8628,69,33,8,25,42,29
6314,26,77,8628,63,8,3,5,25,-5
6315,26,75,8628,17,8,3,5,4,-3
6316,29,75,8628,73,42,14,28,54,-1
6317,32,75,8628,49,24,12,12,30,-7
6318,32,89,8628,12,2,1,1,7,-4
6175,47,68,4482,15,2,1,1,6,0
6176,50,68,4482,7,1,1,0,10,-3
6323,50,89,8628,60,52,20,32,50,-16
6324,50,67,8628,19,8,4,4,12,-3
6325,53,72,8628,82,38,13,25,38,2
6326,56,72,8628,82,40,15,25,69,6
6327,59,72,8628,51,27,10,17,28,4
6328,62,72,8628,79,30,13,17,53,-11
6329,65,72,8628,82,44,17,27,34,7
6330,68,72,8628,22,9,2,7,12,-3
6331,71,72,8628,82,26,13,13,46,1
6332,74,72,8628,74,10,4,6,42,-9
6333,77,86,8628,50,7,3,4,20,4
6334,29,85,29035,1,0,0,0,0,-2
6335,32,85,29035,1,0,0,0,2,0
6336,35,85,29035,15,1,0,1,13,-1
6337,38,85,29035,32,1,0,1,19,-2
6338,23,86,8569,74,30,10,20,40,-2
6340,29,86,8569,74,27,12,15,22,4
6341,32,86,8569,81,32,14,18,28,9
6342,35,86,8569,77,41,21,20,32,23
6343,38,86,8569,82,48,28,20,16,9
6344,41,86,8569,64,41,21,20,36,0
6345,47,86,8569,23,16,6,10,16,-8
6346,47,63,8569,51,43,23,20,32,14
6347,50,63,8569,76,44,27,17,46,-24
6348,53,63,8569,80,56,27,29,40,11
6349,56,63,8569,19,13,7,6,8,9
6350,59,63,8569,76,37,22,15,30,14
6351,62,88,8569,17,9,4,5,17,6
6352,62,89,8569,18,7,1,6,6,0
6353,65,84,8569,6,0,0,0,2,-5
6354,65,68,8569,42,5,3,2,23,-8
6355,26,68,11033,24,2,1,1,10,-1
6357,26,67,8863,4,0,0,0,0,3
6358,29,67,8863,42,4,0,4,35,2
6359,29,81,8863,17,2,0,2,42,-8
6360,32,81,8863,73,9,1,8,106,-25
6361,35,81,8863,72,11,0,11,105,-4
6362,38,81,8863,82,14,5,9,63,-3
6363,41,81,8863,82,19,3,16,89,5
6364,47,81,8863,82,15,1,14,79,-2
6365,50,81,8863,82,15,0,15,70,-6
6366,53,62,8863,80,7,2,5,135,2
6367,56,62,8863,76,20,2,18,112,12
6368,59,62,8863,57,6,1,5,58,4
6369,62,62,8863,76,17,4,13,75,11
6370,65,62,8863,62,7,1,6,66,1
6371,68,62,8863,28,2,0,2,16,-8
6372,71,64,8863,54,10,1,9,38,7
6374,32,73,602,5,0,0,0,4,1
6375,35,73,602,3,0,0,0,2,-2
6376,26,71,8979,3,0,0,0,0,1
6377,29,71,8979,5,0,0,0,10,0
6378,32,71,8979,37,6,2,4,29,-2
6379,32,79,8979,11,0,0,0,14,0
6380,35,79,8979,82,17,6,11,71,-19
6381,38,79,8979,44,4,2,2,72,-8
6382,38,74,8979,24,5,1,4,0,4
6383,41,74,8979,59,7,5,2,82,-13
6384,47,63,8979,55,4,2,2,53,-6
6385,50,72,8979,6,0,0,0,7,0
6386,56,66,8979,11,2,2,0,10,-1
6387,26,88,10217,27,4,1,3,8,-5
6388,29,76,10217,49,26,12,14,41,-7
6389,35,71,10217,61,15,10,5,52,9
6391,38,74,10217,4,0,0,0,2,-1
6392,38,89,10217,21,3,1,2,7,1
6393,41,62,10217,36,6,2,4,24,-3
6394,41,74,10217,14,5,3,2,8,0
6395,47,84,10217,33,6,4,2,14,2
6396,50,84,10217,57,7,2,5,25,0
6397,62,1479,10217,12,0,0,0,6,-3
6398,65,71,10217,7,2,1,1,7,-6
6399,11,74,19556,67,18,3,15,58,12
6400,14,74,19556,47,12,4,8,30,-4
6401,17,74,19556,40,18,2,16,26,12
6402,20,74,19556,77,38,9,29,59,1
6403,23,74,19556,47,10,3,7,38,-1
6404,26,74,19556,2,1,1,0,0,1
6405,26,83,19556,56,27,2,25,52,38
6406,29,83,19556,69,17,3,14,54,9
6408,35,65,19556,65,10,1,9,40,10
6409,38,65,19556,40,14,4,10,12,-8
6410,41,65,19556,24,7,0,7,14,-17
6411,41,76,19556,3,1,0,1,4,1
6412,47,68,19556,6,0,0,0,4,-3
6413,32,71,10723,1,0,0,0,0,-1
6414,41,89,10723,5,0,0,0,2,0
6415,2,77,47095,74,31,11,20,27,-1
6416,26,65,12779,18,0,0,0,67,-10
6417,23,1479,8750,61,27,6,21,23,-4
6418,26,1479,8750,75,25,11,14,47,-12
6419,29,1479,8750,80,39,13,26,24,5
6420,32,1479,8750,82,40,10,30,38,-23
6421,35,1479,8750,79,48,18,30,24,-1
6422,38,1479,8750,50,21,7,14,12,-4
6423,38,68,8750,30,12,6,6,22,-4
6425,47,66,8750,78,49,25,24,40,4
6426,50,74,8750,80,41,16,25,52,0
6427,53,66,8750,59,49,13,36,32,2
6428,56,66,8750,69,43,22,21,20,11
6429,59,66,8750,60,40,12,28,26,0
6430,59,80,8750,21,8,4,4,8,-7
6431,62,69,8750,78,39,12,27,34,-14
6432,65,69,8750,73,35,14,21,24,-10
6433,68,69,8750,42,27,7,20,10,9
6434,71,73,8750,77,39,10,29,32,4
6435,74,73,8750,62,25,7,18,16,8
6436,77,79,8750,82,32,16,16,20,5
6437,80,79,8750,72,31,13,18,30,4
6438,83,69,8750,79,22,11,11,20,-1
6320,38,89,8628,63,35,13,22,43,15
6321,41,89,8628,54,27,12,15,38,-16
6443,32,73,69917,60,27,12,15,45,-7
6444,35,73,69917,10,3,1,2,8,-3
6445,23,62,13503,2,0,0,0,2,0
6446,29,62,13503,17,2,0,2,4,-6
6447,41,64,13503,36,7,3,4,10,0
6448,23,62,255997,5,0,0,0,23,0
6449,29,62,255997,13,2,1,1,18,-3
6450,32,62,255997,4,0,0,0,21,0
6451,35,62,255997,51,12,7,5,79,-3
6452,38,62,255997,50,4,3,1,51,-7
6453,41,75,255997,52,15,10,5,41,6
6454,47,75,255997,76,23,11,12,113,9
6455,50,75,255997,52,10,5,5,46,-6
6456,53,75,255997,44,8,3,5,48,0
6457,56,75,255997,42,10,6,4,27,-5
6458,56,70,255997,20,2,1,1,15,-1
6460,62,73,255997,2,0,0,0,4,-2
6461,68,62,255997,36,8,4,4,22,-2
6462,38,64,13505,2,0,0,0,7,0
6463,23,89,8365,48,16,5,11,18,-5
6464,26,89,8365,38,23,7,16,6,3
6465,29,89,8365,56,31,9,22,30,7
6466,32,89,8365,39,18,5,13,26,0
6467,32,75,8365,12,5,0,5,0,-1
6468,35,75,8365,53,19,9,10,8,-2
6469,38,75,8365,82,40,16,24,30,9
6470,41,75,8365,72,30,13,17,30,-8
6471,47,75,8365,73,40,20,20,50,2
6472,50,84,8365,79,23,12,11,70,-8
6476,11,1479,56213,81,10,1,9,74,7
6477,14,1479,56213,44,6,2,4,36,2
6478,17,1479,56213,63,4,1,3,47,5
6480,32,72,10250,9,5,3,2,6,1
6481,35,72,10250,16,6,3,3,4,-5
6482,35,68,10250,26,8,7,1,4,-5
6483,38,68,10250,9,0,0,0,4,-1
6484,41,75,10250,50,27,17,10,24,15
6485,47,75,10250,32,12,5,7,16,-5
6486,29,72,8817,21,3,2,1,40,3
6487,32,72,8817,82,20,1,19,155,32
6488,35,72,8817,73,5,2,3,133,6
6489,38,72,8817,72,13,5,8,98,19
6490,41,72,8817,75,13,2,11,96,10
6491,47,72,8817,73,17,3,14,91,-2
6492,50,72,8817,69,8,0,8,69,-8
6493,53,72,8817,57,10,2,8,26,-5
6494,56,72,8817,71,18,1,17,46,18
6495,59,72,8817,81,12,2,10,46,8
6497,65,86,8817,54,4,1,3,21,-5
6498,2,75,8986,10,7,2,5,2,1
6499,5,75,8986,59,19,8,11,14,5
6500,8,75,8986,72,44,19,25,33,11
6501,11,75,8986,74,43,19,24,32,17
6502,14,75,8986,9,5,1,4,10,-1
6503,14,77,8986,37,49,25,24,20,21
6504,17,77,8986,82,97,51,46,64,21
6505,20,77,8986,82,97,50,47,58,44
6506,23,77,8986,82,87,51,36,32,30
6507,26,77,8986,76,90,43,47,30,36
6508,29,77,8986,82,77,40,37,36,8
6509,32,77,8986,16,12,7,5,0,2
6510,35,77,8986,82,51,25,26,30,5
6511,38,77,8986,35,28,18,10,16,10
6512,41,77,8986,75,55,23,32,51,20
6514,50,79,8986,21,7,2,5,12,-2
6515,11,71,26364,5,0,0,0,21,-2
6516,23,76,4525,25,1,0,1,50,1
6517,26,76,4525,59,8,2,6,83,-8
6518,29,76,4525,65,11,2,9,57,-27
6519,32,76,4525,82,9,2,7,157,-27
6520,35,80,4525,75,23,10,13,156,30
6521,38,80,4525,74,39,9,30,116,29
6522,41,80,4525,79,41,16,25,147,33
6523,47,80,4525,71,43,16,27,135,17
6524,50,63,4525,80,43,11,32,100,-21
6525,53,63,4525,77,51,17,34,114,14
6526,56,63,4525,80,50,19,31,95,23
6527,59,63,4525,80,44,7,37,87,19
6528,62,63,4525,81,44,14,30,88,33
6529,65,63,4525,79,52,12,40,86,33
6531,71,63,4525,77,40,17,23,66,25
6532,74,63,4525,63,20,8,12,42,0
6533,77,63,4525,80,37,9,28,71,12
6534,80,63,4525,75,29,10,19,59,18
6535,83,63,4525,73,24,7,17,60,22
6536,86,63,4525,62,14,5,9,57,22
6537,2,76,21325,75,85,41,44,42,-6
6538,5,67,21325,57,93,46,47,98,10
6539,8,67,21325,84,148,53,95,63,11
6540,11,67,21325,16,18,5,13,2,-4
6541,14,67,21325,22,27,12,15,4,2
6542,17,67,21325,76,91,40,51,36,-8
6543,20,67,21325,13,8,2,6,4,-8
6544,23,74,21325,67,62,23,39,36,-16
6545,8,81,23871,11,6,3,3,4,-6
6546,11,81,23871,1,0,0,0,0,-1
6548,29,71,8912,76,35,9,26,65,8
6549,32,71,8912,81,32,12,20,60,-4
6550,35,71,8912,55,17,1,16,42,-6
6551,35,74,8912,11,8,1,7,2,-4
6552,38,74,8912,80,48,11,37,58,-6
6553,41,74,8912,67,24,10,14,47,-1
6554,47,74,8912,73,23,3,20,70,16
6555,50,76,8912,78,44,6,38,74,-1
6556,53,89,8912,71,29,2,27,46,9
6557,56,89,8912,52,13,3,10,28,3
6558,59,89,8912,70,24,4,20,42,26
6559,62,89,8912,21,7,2,5,8,-4
6560,68,89,8912,16,2,0,2,2,-2
6561,23,68,12723,1,0,0,0,2,0
6440,29,81,12736,18,3,1,2,20,1
6441,32,81,12736,1,0,0,0,0,-1
6566,38,64,8897,43,4,1,3,82,6
6567,41,86,8897,50,4,1,3,101,0
6568,47,86,8897,10,1,1,0,38,3
6569,50,86,8897,11,0,0,0,22,0
6570,50,64,8897,10,2,1,1,6,0
6571,53,64,8897,25,0,0,0,70,0
6572,2,89,71757,68,6,1,5,61,-23
6573,5,89,71757,64,12,5,7,64,14
6576,11,86,71757,23,2,0,2,8,-5
6577,11,70,71757,12,1,0,1,6,-5
6578,14,70,71757,12,0,0,0,9,0
6579,17,70,71757,63,3,1,2,31,-10
6580,20,70,71757,55,2,1,1,42,3
6581,26,68,8582,68,25,12,13,45,5
6582,29,68,8582,78,25,5,20,34,3
6583,32,76,8582,62,20,11,9,46,-15
6585,38,76,8582,69,26,12,14,44,4
6586,41,76,8582,81,51,15,36,48,4
6587,47,76,8582,49,21,9,12,32,-2
6589,29,81,10372,24,1,0,1,135,-6
6590,32,81,10372,28,1,0,1,96,-7
6591,35,81,10372,26,2,0,2,60,-4
6592,38,74,10372,17,1,0,1,50,-1
6593,38,75,10372,11,0,0,0,46,-2
6594,41,75,10372,2,0,0,0,7,0
6595,26,70,8559,7,1,1,0,12,1
6596,29,70,8559,25,8,5,3,10,4
6597,32,70,8559,15,3,0,3,6,-2
6598,35,70,8559,26,3,3,0,10,-3
6599,38,70,8559,4,0,0,0,0,-1
6600,38,73,8559,4,1,1,0,0,0
6601,38,88,8559,14,2,0,2,19,-3
6603,41,79,8559,15,5,2,3,6,-4
6604,47,77,8559,39,14,7,7,28,-6
6605,47,68,8559,33,18,10,8,26,-1
6607,53,76,8559,2,1,0,1,2,-1
6608,56,76,8559,49,15,9,6,42,-12
6609,59,76,8559,77,22,13,9,44,-4
6610,62,76,8559,34,4,1,3,22,-10
6611,26,75,8790,7,0,0,0,0,-4
6612,29,75,8790,33,6,4,2,24,-7
6613,32,75,8790,46,5,2,3,59,-9
6614,35,75,8790,35,9,5,4,55,7
6615,38,76,8790,78,34,15,19,57,1
6616,41,76,8790,79,24,12,12,92,-12
6617,47,76,8790,63,24,9,15,103,-5
6618,50,76,8790,80,23,11,12,63,3
6619,53,72,8790,77,10,6,4,84,-6
6621,59,77,8790,72,24,10,14,126,-2
6622,62,79,8790,44,11,5,6,46,0
6623,65,79,8790,64,16,5,11,76,-5
6624,68,74,8790,27,2,2,0,50,2
6625,71,74,8790,6,0,0,0,14,-5
6626,26,68,8902,73,37,24,13,25,-6
6627,29,68,8902,81,44,26,18,39,1
6628,32,76,8902,70,30,17,13,28,-27
6629,35,76,8902,78,60,30,30,32,10
6630,38,76,8902,81,48,23,25,28,-11
6631,41,76,8902,59,35,24,11,18,8
6632,47,76,8902,57,41,24,17,16,-14
6633,47,88,8902,19,8,5,3,4,-9
6634,50,69,8902,76,39,19,20,18,9
6635,53,69,8902,66,30,16,14,16,2
6636,56,70,8902,44,13,8,5,18,-3
6638,62,67,8902,2,0,0,0,0,-2
6639,2,71,72944,37,12,4,8,25,-2
6640,5,71,72944,59,28,6,22,46,4
6641,8,80,72944,71,26,7,19,64,-40
6642,11,80,72944,66,29,11,18,56,-41
6643,11,77,72944,19,7,1,6,16,-3
6644,14,77,72944,8,2,0,2,2,1
6645,14,75,72944,39,1,1,0,18,-13
6646,17,75,72944,1,0,0,0,0,0
6647,41,77,10204,7,0,0,0,7,-4
6648,47,89,10204,5,1,0,1,2,1
6649,50,77,10204,15,2,0,2,28,-4
6650,56,77,10204,1,0,0,0,0,0
6651,59,89,10204,3,0,0,0,2,-1
6652,26,79,74796,0,0,0,0,0,0
6653,29,84,29033,18,2,1,1,8,-1
6655,41,82,29033,2,0,0,0,0,0
6656,32,1479,48174,28,2,1,1,22,-6
6657,35,1479,48174,1,0,0,0,0,-1
6658,32,68,68991,29,4,3,1,44,-1
6659,35,68,68991,38,1,1,0,123,-5
6660,38,68,68991,2,0,0,0,4,-1
6661,38,80,68991,2,0,0,0,5,0
6662,41,66,68991,2,0,0,0,0,0
6663,2,89,22715,56,8,1,7,24,12
6664,5,89,22715,64,13,0,13,22,11
6665,8,89,22715,21,0,0,0,20,-13
6666,8,75,729581,7,0,0,0,2,-3
6667,26,73,729581,71,31,11,20,24,-13
6668,29,73,729581,82,46,23,23,14,-11
6669,32,73,729581,81,45,14,31,12,-2
6670,35,73,729581,12,4,1,3,6,-3
6672,38,1479,729581,76,19,8,11,16,-9
6675,11,70,69613,61,38,14,24,30,13
6676,14,70,69613,47,22,12,10,26,-2
6677,17,70,69613,22,8,4,4,23,0
6678,17,77,69613,49,11,3,8,21,2
6679,20,77,69613,76,45,24,21,20,9
6680,23,77,69613,82,42,14,28,16,2
6681,26,77,69613,2,0,0,0,0,0
6682,26,84,69613,73,14,4,10,12,-3
6683,29,84,69613,47,20,10,10,26,-8
6684,32,84,69613,77,33,13,20,31,8
6685,35,84,69613,34,15,8,7,10,9
6686,38,84,69613,82,29,16,13,8,10
6687,41,88,69613,82,43,17,26,46,2
6563,26,64,8897,27,0,0,0,71,-3
6564,32,64,8897,69,5,2,3,155,-2
6692,26,89,9012,78,20,7,13,80,-9
6693,29,89,9012,80,20,7,13,79,8
6694,32,89,9012,54,6,2,4,60,-5
6695,35,89,9012,68,16,8,8,38,4
6696,38,89,9012,70,17,1,16,89,22
6697,41,83,9012,66,29,4,25,36,-1
6698,47,83,9012,56,15,3,12,66,-1
6699,47,72,9012,18,0,0,0,14,-3
6700,50,64,9012,81,19,3,16,68,18
6702,56,1479,9012,3,0,0,0,4,0
6704,26,66,8948,11,0,0,0,0,0
6705,35,66,8948,12,2,1,1,0,-1
6706,38,66,8948,35,4,1,3,20,-3
6707,41,68,8948,34,3,0,3,25,-5
6708,41,63,8948,18,3,0,3,8,0
6709,47,62,8948,25,5,3,2,8,5
6711,53,81,8948,65,11,2,9,16,-10
6712,56,82,8948,8,2,1,1,0,1
6713,35,72,2526,1,1,1,0,2,-1
6714,35,81,2526,3,0,0,0,4,-1
6715,38,89,2526,6,1,1,0,0,-1
6716,41,89,2526,37,14,2,12,30,-10
6717,32,62,2673,62,19,3,16,30,-7
6718,35,62,2673,79,28,6,22,52,-8
6719,38,62,2673,81,26,6,20,28,-7
6720,41,62,2673,67,20,4,16,30,6
6721,47,67,2673,75,17,1,16,82,9
6722,50,67,2673,67,19,2,17,55,10
6723,53,67,2673,82,26,4,22,74,1
6724,56,67,2673,80,23,3,20,70,0
6725,59,67,2673,67,20,4,16,30,10
6726,62,1479,2673,78,25,3,22,42,32
6728,68,1479,2673,35,6,0,6,12,-1
6732,17,64,9015,56,15,3,12,20,12
6733,20,64,9015,80,24,9,15,37,12
6734,23,64,9015,67,14,6,8,30,-3
6735,26,64,9015,39,3,1,2,31,4
6736,29,64,9015,73,12,5,7,34,26
6737,32,64,9015,78,15,4,11,54,22
6738,35,65,9015,82,20,4,16,42,-3
6739,38,65,9015,70,16,2,14,44,-9
6740,41,65,9015,19,1,0,1,20,6
6741,41,70,9015,58,6,2,4,24,10
6742,47,70,9015,76,11,4,7,60,-3
6743,50,70,9015,38,3,1,2,24,0
6744,53,88,9015,22,0,0,0,10,-5
6745,86,85,247472,10,0,0,0,0,-4
6746,2,76,70557,44,12,4,8,45,-6
6748,5,65,70557,6,0,0,0,4,-3
6749,8,65,70557,7,1,0,1,2,-1
6750,11,80,70557,30,7,2,5,6,-15
6751,17,79,70557,21,5,4,1,6,-5
6752,86,85,83512,10,7,1,6,2,0
6753,32,88,28376,62,21,9,12,16,14
6754,35,88,28376,53,24,8,16,21,2
6755,38,88,28376,62,35,16,19,26,-5
6756,41,88,28376,81,33,13,20,44,-16
6757,47,88,28376,65,37,17,20,62,-5
6758,50,66,28376,56,20,8,12,14,-2
6760,53,69,28376,75,37,13,24,30,-6
6761,56,69,28376,79,36,13,23,26,-5
6762,59,69,28376,60,35,13,22,28,-1
6763,59,89,28376,17,6,2,4,4,3
6765,65,71,28376,78,16,4,12,32,-13
6767,5,65,26153,1,0,0,0,2,0
6768,2,84,7138,64,34,13,21,14,-3
6769,5,84,7138,72,65,21,44,54,7
6770,11,86,7138,60,56,18,38,40,20
6771,14,86,7138,33,24,4,20,14,-3
6772,17,86,7138,4,2,1,1,0,-6
6773,17,85,7138,69,71,21,50,34,37
6774,20,85,7138,64,54,12,42,26,31
6775,23,85,7138,69,47,8,39,40,14
6776,26,85,7138,75,63,14,49,48,13
6777,29,85,7138,79,47,9,38,28,13
6778,32,68,7138,26,11,5,6,10,-11
6779,32,85,7138,39,29,4,25,28,6
6780,35,85,7138,70,43,11,32,50,-5
6781,38,85,7138,74,43,10,33,48,-7
6782,41,72,7138,49,11,1,10,20,3
6784,32,82,411791,66,53,11,42,30,-3
6785,35,82,411791,77,42,11,31,47,-28
6786,38,82,411791,31,9,5,4,20,-15
6787,41,82,411791,14,4,0,4,2,-5
6788,32,89,8821,61,6,2,4,35,3
6789,35,89,8821,24,1,0,1,28,-3
6790,35,74,8821,1,0,0,0,0,1
6791,38,89,8821,14,2,1,1,6,1
6792,41,89,8821,44,11,6,5,14,-2
6793,47,78,8821,30,7,2,5,14,-3
6794,56,78,8821,3,1,0,1,0,2
6795,59,63,8821,16,1,0,1,7,-2
6796,65,63,8821,1,0,0,0,0,0
6802,17,64,27549,3,0,0,0,0,-1
6803,17,62,27549,32,9,4,5,20,2
6804,20,76,27549,73,18,13,5,49,-12
6806,26,76,27549,82,37,14,23,62,-19
6807,29,76,27549,76,31,15,16,60,-22
6808,32,76,27549,80,32,9,23,56,-2
6809,35,76,27549,80,21,9,12,60,-9
6810,38,76,27549,66,12,6,6,20,-3
6811,38,77,27549,14,4,2,2,16,5
6812,41,77,27549,42,8,5,3,32,2
6813,2,85,72259,4,1,0,1,4,0
6814,8,80,72259,76,12,3,9,68,-47
6815,11,76,72259,17,4,1,3,13,-1
6816,14,76,72259,47,4,1,3,36,-2
6817,17,76,72259,74,10,3,7,55,-23
6818,29,79,8687,75,21,4,17,48,11
6819,32,79,8687,30,5,1,4,26,3
6689,17,89,9012,66,11,8,3,60,-1
6690,20,89,9012,80,11,3,8,115,-5
6824,53,74,8687,80,38,13,25,80,0
6825,56,74,8687,76,30,8,22,52,-7
6826,59,74,8687,82,23,3,20,78,3
6827,62,74,8687,32,15,3,12,22,3
6830,68,65,8687,27,12,0,12,14,18
6831,71,65,8687,42,8,1,7,32,7
6832,74,65,8687,65,13,1,12,22,0
6833,77,65,8687,51,13,1,12,33,3
6834,80,65,8687,22,3,1,2,14,-3
6835,2,77,42302,50,26,5,21,14,-19
6836,5,77,42302,10,3,1,2,4,1
6837,32,86,9089,21,2,1,1,19,0
6838,35,86,9089,54,22,9,13,43,22
6839,38,86,9089,46,5,2,3,37,-1
6840,41,79,9089,82,16,7,9,65,-27
6841,47,89,9089,74,19,7,12,72,-8
6843,53,89,9089,77,18,7,11,74,1
6844,56,89,9089,81,11,5,6,59,-1
6845,59,89,9089,77,24,10,14,47,6
6846,62,89,9089,61,11,4,7,68,-3
6847,65,68,9089,45,8,3,5,31,-3
6848,2,63,31128,49,18,5,13,67,7
6849,5,63,31128,27,9,3,6,31,4
6850,8,80,31128,26,10,6,4,16,-8
6852,5,83,68892,34,14,9,5,27,-8
6853,8,83,68892,9,0,0,0,8,-3
6854,11,83,68892,10,3,1,2,10,-2
6855,11,62,68892,7,1,0,1,4,-3
6856,5,85,21306,79,34,8,26,172,25
6857,8,85,21306,82,22,5,17,137,22
6858,11,85,21306,80,33,12,21,138,30
6859,14,85,21306,47,14,3,11,101,10
6861,20,85,21306,77,38,5,33,151,38
6862,5,77,27426,46,4,1,3,126,1
6863,11,77,27426,4,0,0,0,5,0
6864,17,77,27426,9,1,1,0,31,1
6865,20,77,27426,75,5,1,4,210,-1
6866,23,77,27426,61,2,1,1,210,-4
6867,26,77,27426,2,0,0,0,2,-1
6868,35,77,9084,3,0,0,0,5,-1
6869,38,66,9084,48,3,2,1,108,-2
6870,41,66,9084,76,7,6,1,127,-5
6871,47,66,9084,26,0,0,0,51,-3
6872,47,78,9084,12,0,0,0,13,-4
6873,53,77,9084,5,0,0,0,29,-2
6874,56,71,9084,2,0,0,0,0,0
6875,29,73,69913,2,0,0,0,0,-1
6876,32,73,69913,5,0,0,0,0,0
6878,38,73,69913,4,0,0,0,0,0
6879,29,70,58912,5,0,0,0,0,-1
6880,35,62,58912,2,0,0,0,0,-1
6881,68,86,12201,1,0,0,0,0,0
6882,2,76,60943,4,0,0,0,0,-1
6883,26,89,13539,5,0,0,0,0,-1
6884,29,89,13539,23,2,1,1,2,-2
6885,35,84,13539,2,0,0,0,0,2
6886,5,86,22352,59,37,15,22,42,-25
6887,8,86,22352,21,10,2,8,12,-9
6891,17,64,19551,26,22,11,11,16,11
6892,17,75,19551,51,34,17,17,33,9
6893,20,71,19551,74,59,32,27,81,-5
6894,23,71,19551,59,23,6,17,28,-14
6895,26,71,19551,43,27,13,14,30,-4
6896,26,77,19551,13,1,0,1,2,-5
6898,29,66,19551,76,39,15,24,38,-13
6899,32,63,19551,76,37,16,21,27,-14
6900,77,547,45500,9,1,0,1,5,0
6901,5,85,8543,7,2,0,2,2,-2
6902,8,85,8543,17,5,4,1,14,-1
6903,11,85,8543,77,73,34,39,50,27
6904,14,85,8543,46,33,13,20,45,12
6905,17,85,8543,82,73,36,37,70,33
6906,20,85,8543,75,45,23,22,46,21
6907,23,85,8543,80,52,25,27,46,14
6908,26,85,8543,79,58,29,29,45,10
6909,29,85,8543,72,36,18,18,28,11
6910,32,85,8543,72,38,20,18,30,9
6911,35,67,8543,38,22,9,13,16,0
6919,2,65,21400,80,101,44,57,79,37
6920,5,65,21400,80,74,29,45,65,10
6922,11,74,21400,68,60,21,39,41,14
6923,14,74,21400,47,29,14,15,16,8
6924,20,80,729564,79,31,12,19,8,-6
6925,23,80,729564,82,33,15,18,24,-11
6926,26,80,729564,77,50,15,35,30,9
6927,29,80,729564,82,35,10,25,18,5
6928,32,80,729564,81,31,13,18,24,7
6929,35,75,729564,79,33,15,18,24,-3
6930,38,75,729564,73,25,7,18,24,-5
6931,41,75,729564,60,12,4,8,10,8
6932,29,83,30973,2,0,0,0,2,0
6933,2,62,27150,1,0,0,0,7,-1
6934,5,62,27150,16,4,3,1,65,1
6935,8,62,27150,27,5,2,3,41,2
6936,11,62,27150,68,11,3,8,185,-6
6937,14,62,27150,45,16,11,5,141,13
6939,20,62,27150,14,2,2,0,30,-4
6940,20,76,27150,48,6,4,2,111,-5
6941,23,76,27150,62,7,6,1,138,-12
6942,23,67,27150,12,2,1,1,49,1
6943,26,67,27150,43,3,3,0,114,0
6944,29,67,27150,11,0,0,0,43,-2
6945,32,86,27150,1,0,0,0,5,0
6946,86,84,248574,2,0,0,0,0,-1
6947,86,88,321235,1,0,0,0,0,-1
6948,86,69,54505,2,0,0,0,0,0
6949,2,78,23028,6,3,1,2,2,4
6950,5,78,23028,6,1,0,1,10,-3
6951,8,80,23028,2,1,0,1,0,0
6952,8,63,23028,2,0,0,0,2,-1
6821,38,79,8687,53,10,4,6,40,-5
6822,47,74,8687,82,30,5,25,90,35
6957,8,75,19326,71,80,31,49,20,23
6958,11,75,19326,34,16,9,7,8,1
6959,11,1479,19326,22,10,6,4,14,-5
6960,14,1479,19326,38,24,8,16,12,6
6961,14,84,8733,1,0,0,0,0,1
6962,20,84,8733,36,9,3,6,19,8
6963,23,84,8733,5,0,0,0,6,-2
6964,32,70,8733,1,0,0,0,0,0
6965,29,64,8764,1,0,0,0,0,0
6966,35,64,8764,56,14,7,7,14,4
6967,38,64,8764,12,1,0,1,15,0
6968,41,89,8764,49,15,10,5,18,-7
6969,47,89,8764,82,41,19,22,77,-19
6970,50,88,8764,81,21,11,10,49,-20
6971,53,88,8764,53,12,4,8,30,-8
6972,56,64,8764,42,4,1,3,14,-6
6974,62,89,8764,1,1,0,1,0,0
6975,20,70,71758,9,0,0,0,46,-4
6976,23,75,9109,41,1,1,0,20,-3
6977,26,75,9109,61,4,2,2,16,-3
6981,41,64,9109,12,2,1,1,6,3
6982,47,64,9109,80,36,9,27,56,3
6983,50,64,9109,82,39,10,29,50,5
6984,53,64,9109,57,21,5,16,33,5
6985,56,64,9109,76,12,2,10,32,-16
6986,59,64,9109,64,20,3,17,28,6
6987,62,81,9109,82,31,9,22,14,2
6988,65,81,9109,82,15,2,13,20,-26
6989,68,69,9109,8,1,0,1,0,-9
6990,11,74,67702,4,0,0,0,0,0
6991,14,63,67702,23,1,1,0,38,-2
6992,14,74,67702,1,0,0,0,0,0
6994,20,77,67702,74,8,7,1,163,-1
6995,23,77,67702,56,5,1,4,135,0
6996,26,71,67702,4,0,0,0,13,0
6997,29,76,67702,1,0,0,0,0,-1
6998,11,83,280710,3,0,0,0,2,0
6999,14,88,280710,45,16,9,7,54,2
7000,17,88,280710,72,32,16,16,110,-11
7001,20,64,280710,81,36,18,18,26,16
7002,23,64,280710,82,31,16,15,84,0
7003,26,64,280710,7,0,0,0,2,-2
7004,26,88,280710,27,1,0,1,12,-5
7005,26,74,280710,30,3,2,1,4,-5
7006,29,74,280710,70,12,4,8,24,-12
7007,32,74,280710,46,5,2,3,39,-6
7008,32,80,280710,9,1,0,1,4,0
7009,2,67,32223,60,31,8,23,46,13
7011,8,67,32223,50,16,2,14,45,-2
7012,11,70,32223,84,46,9,37,42,7
7013,14,70,32223,38,18,5,13,20,6
7014,17,70,32223,73,24,5,19,20,-15
7015,20,70,32223,67,16,1,15,61,31
7016,23,84,32223,49,15,2,13,14,-2
7017,23,63,32223,22,9,2,7,6,-2
7018,26,63,32223,47,12,4,8,33,-8
7019,29,80,32223,40,6,2,4,8,-3
7020,32,81,32223,14,4,2,2,12,-5
7021,32,70,32223,8,1,0,1,4,3
7022,35,81,32223,53,4,1,3,12,-5
7023,26,81,69897,2,0,0,0,0,0
7024,32,75,69897,14,5,3,2,6,-5
7025,2,83,38548,52,29,17,12,39,-25
7026,5,83,38548,34,20,7,13,44,-1
7028,8,62,38548,30,14,9,5,10,5
7029,8,75,38548,20,18,6,12,14,9
7030,11,75,38548,31,15,4,11,17,5
7031,14,84,38548,10,2,2,0,0,-3
7032,20,78,38548,2,1,0,1,0,0
7033,2,89,47062,68,30,11,19,99,-9
7034,5,63,47062,78,60,31,29,147,-8
7035,8,63,47062,79,51,26,25,126,-6
7036,11,63,47062,42,15,5,10,74,-10
7037,14,63,47062,35,11,5,6,68,-3
7038,17,63,47062,59,22,9,13,86,-4
7039,17,78,47062,14,6,2,4,22,-3
7040,20,78,47062,17,3,2,1,24,-2
7041,23,66,47062,45,9,4,5,42,-19
7042,26,80,47062,9,2,0,2,6,-1
7044,29,79,47062,56,5,2,3,24,-11
7046,2,74,729543,80,88,16,72,42,2
7047,5,74,729543,80,102,22,80,26,25
7048,8,74,729543,36,36,6,30,26,2
7049,11,74,729543,84,79,23,56,67,28
7050,14,74,729543,48,41,9,32,18,0
7051,17,74,729543,82,85,15,70,30,12
7052,20,74,729543,82,78,20,58,40,31
7053,23,74,729543,76,50,17,33,32,-36
7054,26,74,729543,82,55,13,42,42,-7
7055,29,74,729543,50,26,7,19,20,-16
7056,32,74,729543,82,79,21,58,34,-18
7057,35,74,729543,82,55,10,45,28,14
7058,38,74,729543,51,30,12,18,20,-3
7059,41,74,729543,57,36,13,23,24,-5
7060,41,83,729543,15,15,2,13,10,11
7061,47,63,729543,61,32,5,27,36,-10
7063,5,75,27903,69,17,3,14,91,9
7064,8,83,27903,81,14,2,12,90,8
7065,11,83,27903,84,11,2,9,79,33
7067,17,64,27903,75,16,5,11,49,26
7068,20,64,27903,71,13,2,11,30,12
7069,23,64,27903,81,10,0,10,48,2
7070,26,64,27903,76,20,2,18,48,18
7071,29,74,27903,82,12,2,10,43,-13
7072,32,74,27903,71,15,2,13,55,3
7073,35,74,27903,41,5,0,5,23,-3
7074,38,74,27903,35,2,0,2,10,-7
7075,2,79,70181,7,2,2,0,0,-1
7076,5,79,70181,38,9,5,4,8,-2
7077,8,79,70181,5,0,0,0,2,-2
6954,86,20120,197012,1,1,0,1,0,-1
6955,2,75,19326,73,53,22,31,24,4
7083,11,72,24780,79,44,18,26,86,13
7084,14,72,24780,45,19,6,13,86,2
7085,17,64,24780,79,71,39,32,117,14
7086,20,64,24780,45,28,11,17,43,-4
7087,23,64,24780,78,53,26,27,115,-7
7088,26,64,24780,82,51,27,24,102,0
7089,29,64,24780,13,9,3,6,4,0
7090,29,72,24780,70,38,17,21,86,-3
7094,38,70,24780,32,6,2,4,14,-9
7095,56,86,24780,18,1,0,1,21,-5
7096,8,88,8618,11,5,0,5,2,-3
7097,11,88,8618,32,19,9,10,10,7
7098,14,88,8618,36,12,4,8,4,-7
7099,17,88,8618,68,22,6,16,10,-15
7100,23,63,8618,3,0,0,0,2,1
7101,23,79,8618,51,22,9,13,14,6
7103,29,79,8618,78,65,23,42,14,-9
7104,32,79,8618,82,80,32,48,28,20
7105,35,79,8618,62,50,18,32,16,9
7106,38,89,8618,82,69,22,47,22,12
7107,41,89,8618,63,74,29,45,24,2
7108,41,85,8618,6,5,1,4,0,2
7109,47,85,8618,72,62,20,42,72,17
7110,50,85,8618,81,52,19,33,66,12
7111,53,65,8618,76,54,21,33,50,9
7112,56,75,8618,50,39,18,21,36,6
7114,2,75,19321,2,2,1,1,0,0
7115,8,62,19321,1,0,0,0,0,0
7116,11,68,19321,4,2,1,1,4,0
7117,26,79,19321,8,1,1,0,2,-2
7118,2,89,78390,1,0,0,0,0,-2
7119,2,65,28900,67,13,6,7,119,-7
7121,8,65,28900,81,31,10,21,111,5
7122,11,65,28900,66,20,12,8,63,5
7126,17,72,28900,18,1,0,1,4,-7
7127,17,62,28900,20,8,4,4,10,-1
7130,29,76,18740,17,3,1,2,8,-10
7131,32,76,18740,8,0,0,0,6,0
7132,35,76,18740,17,2,0,2,6,0
7133,2,79,9680,26,45,19,26,30,8
7134,5,79,9680,64,131,44,87,94,27
7135,8,79,9680,60,160,69,91,38,55
7136,11,79,9680,22,37,17,20,32,-2
7137,17,79,9680,70,161,69,92,54,10
7138,20,79,9680,76,122,50,72,65,27
7139,32,79,9680,43,76,35,41,18,15
7140,35,79,9680,24,31,6,25,14,0
7141,38,79,9680,67,91,28,63,43,-25
7143,47,79,9680,26,22,7,15,16,-16
7144,32,80,9020,4,1,1,0,0,1
7145,35,80,9020,11,0,0,0,12,5
7146,38,80,9020,20,2,0,2,6,2
7147,38,89,9020,34,3,0,3,12,1
7148,41,89,9020,80,12,6,6,89,-28
7149,47,68,9020,73,12,4,8,86,3
7150,50,68,9020,41,10,5,5,20,-5
7151,50,79,9020,1,0,0,0,0,-1
7153,32,66,8752,44,1,1,0,20,-7
7154,35,66,8752,33,1,0,1,38,2
7155,38,66,8752,81,18,6,12,71,-11
7156,41,66,8752,80,17,7,10,69,-5
7157,47,66,8752,67,21,10,11,51,1
7158,50,66,8752,82,14,7,7,54,-9
7159,53,66,8752,40,5,2,3,34,-8
7161,56,65,8752,36,6,2,4,22,-3
7162,56,79,8752,9,1,0,1,0,0
7163,59,79,8752,82,10,0,10,72,-5
7164,62,79,8752,80,15,4,11,76,-5
7165,65,79,8752,82,18,5,13,34,-6
7166,68,79,8752,48,9,3,6,28,-1
7167,71,79,8752,82,11,5,6,46,-16
7168,74,79,8752,70,7,1,6,44,-1
7169,8,78,19307,5,1,0,1,0,-3
7170,11,78,19307,20,4,1,3,8,-1
7171,14,78,19307,4,0,0,0,15,1
7172,14,80,19307,13,2,1,1,0,-4
7173,17,80,19307,6,0,0,0,4,2
7174,38,71,8602,35,13,8,5,10,9
7175,41,71,8602,76,30,16,14,46,14
7176,47,71,8602,80,37,18,19,42,5
7178,53,71,8602,56,22,13,9,28,-5
7179,56,71,8602,38,15,7,8,14,-1
7180,59,71,8602,40,8,4,4,10,-16
7181,62,65,8602,60,16,7,9,10,0
7182,20,88,1659,67,27,16,11,22,-3
7183,32,69,1659,2,1,1,0,2,-1
7184,29,64,5529,27,4,1,3,10,0
7185,32,64,5529,76,15,5,10,51,1
7186,35,64,5529,58,12,6,6,39,8
7187,38,64,5529,60,10,6,4,49,4
7188,41,64,5529,59,11,4,7,57,-6
7189,47,64,5529,73,13,5,8,48,-5
7190,50,78,5529,41,10,5,5,23,-8
7191,53,78,5529,58,10,5,5,42,-3
7192,56,78,5529,51,5,1,4,64,-7
7193,23,84,10852,5,2,1,1,2,-2
7195,14,80,10898,18,15,8,7,6,-5
7196,17,74,10898,1,0,0,0,0,0
7197,17,88,10898,7,3,1,2,4,0
7198,2,67,68613,6,0,0,0,8,-4
7199,5,67,68613,2,0,0,0,2,0
7200,8,80,68613,79,9,4,5,145,-26
7201,11,80,68613,44,3,0,3,52,-11
7202,32,68,12451,6,1,1,0,2,0
7203,41,89,12451,2,0,0,0,0,-1
7204,32,62,5670,30,9,4,5,54,0
7205,35,62,5670,77,12,5,7,85,0
7206,38,74,5670,66,14,5,9,77,-12
7209,50,79,5670,31,6,3,3,28,4
7215,17,64,32210,77,19,4,15,73,32
7080,2,72,24780,78,47,30,17,105,-8
7081,5,72,24780,74,68,41,27,109,9
7221,29,66,32210,53,2,0,2,14,-19
7222,32,69,32210,54,5,2,3,19,-2
7223,32,80,32210,11,4,0,4,0,7
7224,35,80,32210,79,10,1,9,44,-5
7225,38,80,32210,54,7,1,6,18,11
7226,41,80,32210,56,5,1,4,16,13
7227,32,78,11573,28,13,10,3,14,0
7228,35,78,11573,41,11,4,7,6,3
7229,38,78,11573,1,0,0,0,0,-1
7231,2,62,68985,1,1,0,1,0,-1
7232,5,86,68985,8,2,0,2,16,-4
7233,32,66,15422,1,0,0,0,0,0
7234,29,72,8542,2,0,0,0,0,1
7235,32,72,8542,16,2,0,2,29,0
7236,32,69,8542,17,8,1,7,11,4
7237,35,69,8542,68,13,3,10,68,-16
7239,41,69,8542,70,14,1,13,83,12
7240,47,69,8542,64,8,2,6,87,15
7241,47,70,8542,16,2,0,2,26,4
7242,50,84,8542,62,11,1,10,45,1
7243,53,84,8542,72,12,2,10,81,6
7244,56,84,8542,82,23,3,20,59,29
7245,59,84,8542,48,12,4,8,48,13
7246,62,88,8542,57,10,5,5,21,4
7247,65,88,8542,76,24,5,19,44,20
7248,71,88,8542,76,12,1,11,58,14
7249,74,68,8542,66,8,3,5,25,1
7250,77,68,8542,46,7,1,6,18,-2
7255,35,84,8787,42,17,7,10,15,2
7256,38,84,8787,78,25,11,14,36,8
7257,41,82,8787,73,32,15,17,16,-12
7258,47,82,8787,81,28,10,18,36,-2
7260,53,66,8787,75,18,9,9,30,-10
7261,32,63,350055,17,2,1,1,6,-5
7262,32,1479,350055,59,7,3,4,14,-9
7263,35,1479,350055,80,20,6,14,26,-16
7264,38,1479,350055,34,15,4,11,18,10
7265,41,1479,350055,82,22,8,14,52,-2
7266,47,1479,350055,82,21,11,10,34,-1
7267,50,1479,350055,82,26,8,18,42,-4
7268,53,1479,350055,56,15,6,9,34,-2
7269,56,1479,350055,52,15,5,10,32,-16
7270,56,65,350055,13,3,2,1,2,-1
7271,59,82,350055,79,16,3,13,32,-9
7272,62,82,350055,82,20,7,13,30,-13
7273,65,82,350055,61,11,2,9,22,-6
7274,65,84,350055,19,6,2,4,12,4
7275,53,73,7434,48,17,4,13,18,13
7277,59,68,7434,17,4,1,3,8,1
7278,11,68,41692,39,2,2,0,109,9
7279,14,68,41692,37,7,0,7,138,12
7280,17,68,41692,78,9,3,6,236,-2
7281,20,68,41692,77,12,0,12,313,13
7282,23,68,41692,77,11,0,11,293,-5
7283,26,68,41692,75,10,1,9,218,-1
7284,29,68,41692,77,11,3,8,172,-1
7285,32,68,41692,25,3,1,2,66,5
7286,35,68,41692,45,7,4,3,157,1
7287,26,83,8538,57,22,4,18,12,3
7288,29,83,8538,82,40,7,33,24,3
7289,32,83,8538,82,45,6,39,24,10
7290,35,83,8538,69,39,10,29,2,5
7291,38,83,8538,82,47,11,36,30,20
7292,41,83,8538,71,31,3,28,18,16
7294,50,83,8538,74,58,11,47,20,3
7295,53,83,8538,82,53,8,45,22,-8
7296,56,83,8538,57,31,4,27,8,-8
7297,59,83,8538,82,49,7,42,24,-16
7298,62,83,8538,58,38,3,35,16,-2
7299,62,63,8538,24,9,1,8,2,6
7300,65,66,8538,29,9,0,9,2,-12
7301,65,75,8538,43,22,3,19,10,-6
7302,68,75,8538,10,3,0,3,0,4
7303,32,84,8763,6,0,0,0,0,0
7304,35,84,8763,11,0,0,0,6,1
7305,38,84,8763,48,8,5,3,73,8
7306,41,84,8763,74,7,2,5,94,-10
7307,47,84,8763,77,17,7,10,115,4
7308,50,68,8763,82,25,4,21,112,7
7309,53,68,8763,73,16,2,14,67,5
7311,59,68,8763,74,13,4,9,99,-8
7312,62,68,8763,53,12,4,8,63,-5
7313,62,66,8763,19,5,0,5,19,4
7314,65,66,8763,82,14,1,13,76,-1
7315,68,1479,8763,41,6,0,6,34,1
7316,71,1479,8763,68,10,0,10,75,20
7317,74,1479,8763,6,1,0,1,4,0
7318,74,75,8763,5,1,0,1,2,-2
7319,26,80,1028,61,19,7,12,24,20
7320,29,80,1028,37,14,6,8,2,6
7321,32,80,1028,31,18,2,16,10,9
7322,35,80,1028,66,18,4,14,14,1
7323,38,84,1028,79,30,9,21,10,9
7324,41,84,1028,74,26,7,19,22,8
7325,47,84,1028,59,33,10,23,38,9
7326,50,84,1028,67,37,14,23,26,21
7328,56,84,1028,60,25,5,20,26,5
7329,59,84,1028,68,28,9,19,18,14
7330,62,84,1028,27,7,3,4,14,-3
7331,65,84,1028,69,25,9,16,10,7
7332,68,81,1028,46,17,2,15,16,5
7333,71,81,1028,71,17,4,13,18,11
7334,2,71,53788,1,2,0,2,0,1
7335,5,71,53788,4,0,0,0,7,-1
7336,8,71,53788,1,0,0,0,4,0
7337,11,80,53788,23,1,0,1,70,-4
7338,14,79,53788,40,2,0,2,114,7
7339,17,79,53788,66,11,2,9,161,2
7340,20,79,53788,59,3,0,3,81,-3
7341,23,64,53788,50,3,1,2,140,-3
7217,20,89,32210,2,0,0,0,2,0
7219,23,66,32210,73,12,2,10,45,-2
7346,50,65,10191,6,0,0,0,31,-1
7347,2,84,2661,80,32,5,27,59,-15
7348,5,84,2661,75,44,12,32,65,25
7349,8,84,2661,74,44,8,36,55,30
7350,11,84,2661,83,55,13,42,50,3
7351,14,84,2661,36,17,5,12,26,4
7352,17,84,2661,80,54,17,37,50,-9
7353,20,84,2661,66,35,11,24,32,8
7354,23,84,2661,74,30,9,21,34,-25
7358,35,70,2661,15,1,0,1,4,-5
7359,35,83,2661,51,12,4,8,18,13
7360,38,83,2661,73,17,6,11,46,10
7361,2,84,8547,80,70,33,37,65,-25
7362,5,84,8547,80,75,31,44,101,3
7363,8,84,8547,84,72,33,39,64,19
7364,11,84,8547,84,61,32,29,73,6
7366,17,84,8547,82,80,33,47,42,6
7367,20,84,8547,49,40,9,31,27,5
7368,23,84,8547,42,21,7,14,49,-13
7369,23,76,8547,25,17,10,7,33,-1
7370,26,76,8547,82,47,18,29,32,-14
7371,29,75,8547,50,30,13,17,34,-3
7372,32,75,8547,57,33,12,21,52,-2
7373,32,89,8547,12,4,3,1,8,2
7374,35,89,8547,16,3,1,2,6,-2
7375,35,84,8547,64,34,12,22,65,-3
7376,38,84,8547,71,41,19,22,30,-1
7377,41,84,8547,82,36,14,22,26,-6
7378,47,84,8547,82,16,7,9,15,3
7379,50,84,8547,80,25,12,13,34,-6
7380,53,84,8547,59,12,7,5,15,0
7381,23,81,5513,10,3,1,2,22,-1
7383,29,81,5513,69,26,8,18,93,-19
7384,32,81,5513,70,30,11,19,103,-14
7385,35,81,5513,82,34,11,23,106,-22
7386,38,81,5513,75,22,3,19,78,-7
7387,41,81,5513,81,35,17,18,85,9
7388,47,81,5513,76,38,5,33,96,-12
7389,50,83,5513,61,21,7,14,48,7
7390,53,83,5513,72,40,11,29,116,5
7391,56,83,5513,82,40,14,26,94,-15
7393,62,81,5513,79,23,4,19,62,2
7394,65,81,5513,52,11,3,8,59,1
7395,65,77,5513,17,4,0,4,15,-3
7396,56,64,297,3,0,0,0,2,-1
7397,32,65,8761,13,1,0,1,4,0
7398,35,65,8761,80,28,12,16,124,-6
7399,38,65,8761,82,29,14,15,113,0
7401,47,65,8761,82,48,25,23,107,-14
7402,50,86,8761,71,21,11,10,83,-9
7403,53,83,8761,35,10,4,6,60,-2
7404,65,1479,8761,5,0,0,0,5,0
7405,2,78,32218,79,40,19,21,168,19
7406,5,78,32218,75,20,7,13,77,-11
7407,8,78,32218,58,13,5,8,101,-18
7408,11,68,32218,80,37,15,22,64,-4
7409,14,68,32218,45,20,10,10,25,-3
7410,17,68,32218,63,24,10,14,36,-2
7411,20,68,32218,77,29,15,14,51,2
7412,23,68,32218,7,0,0,0,2,-1
7413,23,86,32218,50,8,4,4,51,0
7414,26,86,32218,61,15,6,9,24,-5
7415,29,86,32218,32,5,1,4,18,1
7416,32,62,32218,79,35,18,17,47,-2
7418,38,62,32218,34,19,5,14,22,4
7419,41,62,32218,18,2,1,1,11,-6
7420,35,79,10326,23,1,0,1,8,-7
7421,38,79,10326,13,6,5,1,4,-2
7422,41,79,10326,25,10,3,7,20,-6
7423,50,77,10326,13,3,1,2,4,-6
7428,65,547,10422,74,46,24,22,26,-11
7429,68,547,10422,48,32,7,25,4,8
7430,71,547,10422,82,64,23,41,58,8
7431,74,547,10422,70,52,24,28,24,8
7432,77,547,10422,57,42,17,25,12,-13
7433,80,547,10422,59,47,21,26,18,-7
7434,83,547,10422,82,43,16,27,28,2
7435,86,547,10422,82,41,15,26,26,-12
7436,29,80,70047,1,0,0,0,0,0
7437,2,84,26416,78,38,6,32,77,-6
7439,8,84,26416,71,25,6,19,36,9
7440,11,74,26416,34,2,0,2,33,-12
7441,14,78,26416,37,9,2,7,12,9
7442,17,74,26416,59,14,5,9,50,11
7443,20,74,26416,48,7,3,4,24,10
7444,23,74,26416,36,4,0,4,24,2
7445,26,70,26416,17,0,0,0,10,0
7446,68,68,11231,2,0,0,0,0,-1
7447,2,79,58477,44,16,7,9,85,10
7448,5,79,58477,76,26,10,16,127,-5
7449,8,79,58477,82,21,5,16,99,1
7450,11,1479,58477,62,19,13,6,88,-5
7451,14,76,58477,26,9,5,4,23,0
7452,14,74,58477,4,0,0,0,0,-2
7453,38,66,10413,10,3,3,0,2,-2
7454,41,78,10413,22,3,1,2,4,-5
7456,62,63,10432,77,41,21,20,51,25
7457,65,63,10432,76,55,28,27,87,31
7458,68,63,10432,45,36,18,18,27,23
7459,71,63,10432,82,53,25,28,64,36
7460,74,63,10432,77,42,24,18,95,5
7461,77,63,10432,77,61,37,24,90,21
7462,80,63,10432,80,85,39,46,81,18
7463,83,63,10432,68,85,34,51,63,25
7464,86,63,10432,79,100,36,64,96,15
7465,2,76,24086,75,9,1,8,77,-24
7468,11,70,24086,84,14,1,13,123,-1
7469,14,70,24086,47,9,2,7,61,-6
7470,17,70,24086,65,3,1,2,70,-17
7471,20,70,24086,77,13,2,11,62,17
7343,35,78,10191,58,5,0,5,160,-3
7344,38,78,10191,79,6,2,4,234,3
7476,35,80,12446,23,3,1,2,4,0
7477,35,89,12446,6,1,0,1,2,0
7478,38,89,12446,47,18,8,10,24,6
7479,41,89,12446,7,2,1,1,0,1
7480,53,80,10665,45,9,6,3,20,0
7481,56,80,10665,81,32,17,15,59,-10
7482,59,80,10665,61,26,9,17,53,6
7483,62,80,10665,82,34,14,20,43,-19
7484,65,80,10665,82,47,15,32,124,2
7485,68,82,10665,45,19,6,13,28,6
7486,71,82,10665,70,39,18,21,96,5
7487,74,82,10665,79,73,31,42,50,16
7488,77,82,10665,72,37,12,25,53,-14
7489,80,82,10665,79,51,26,25,55,-4
7490,83,82,10665,72,33,15,18,50,1
7491,86,82,10665,73,35,17,18,44,12
7493,53,67,11230,16,3,0,3,14,12
7494,56,67,11230,7,0,0,0,19,-3
7495,62,67,11230,58,17,4,13,69,13
7496,65,67,11230,51,5,1,4,64,-19
7497,68,67,11230,42,7,1,6,70,3
7498,71,67,11230,68,9,1,8,73,-29
7499,74,67,11230,64,7,1,6,68,-22
7500,77,67,11230,35,5,1,4,32,3
7501,77,89,11230,10,0,0,0,28,-1
7502,23,74,402,1,0,0,0,0,0
7503,77,75,11617,1,0,0,0,0,0
7504,56,82,11663,52,5,4,1,150,-1
7505,59,82,11663,51,14,4,10,105,6
7506,62,82,11663,76,17,4,13,184,-15
7507,65,82,11663,77,20,12,8,235,-11
7508,68,82,11663,24,9,3,6,53,-11
7510,74,84,11663,79,25,7,18,175,4
7511,77,84,11663,71,16,5,11,177,-13
7512,80,84,11663,14,4,1,3,33,-6
7513,83,84,11663,20,9,7,2,74,-1
7514,2,71,57094,56,36,7,29,94,15
7515,5,83,57094,2,0,0,0,2,-2
7516,56,81,15080,6,1,0,1,0,0
7517,59,75,11886,3,0,0,0,4,1
7518,83,77,12252,1,0,0,0,0,0
7519,23,86,8605,56,13,6,7,66,8
7520,26,86,8605,25,4,3,1,38,5
7521,29,81,8605,34,11,2,9,33,-11
7522,32,81,8605,64,20,4,16,76,-8
7523,35,81,8605,9,2,0,2,6,-6
7524,35,72,8605,38,3,1,2,25,1
7525,38,72,8605,1,1,0,1,2,-1
7527,41,69,8605,65,21,8,13,48,4
7528,47,69,8605,57,18,7,11,50,-12
7529,50,62,8605,49,6,1,5,30,-2
7530,53,65,8605,32,5,2,3,38,-11
7531,29,73,676,33,6,1,5,22,-6
7532,32,73,676,50,8,3,5,22,2
7533,38,74,676,10,1,1,0,0,-5
7534,38,79,676,19,5,3,2,10,-9
7536,11,68,73038,29,11,5,6,69,0
7537,11,80,73038,33,8,3,5,93,-26
7538,14,80,73038,24,11,5,6,51,4
7539,17,80,73038,27,2,0,2,80,-3
7542,2,83,70449,7,2,1,1,2,0
7543,5,83,70449,64,15,6,9,102,-21
7544,5,76,70449,11,2,1,1,13,-3
7545,8,76,70449,41,8,5,3,90,-5
7547,62,66,11405,13,2,2,0,4,-4
7548,65,68,11405,1,0,0,0,0,0
7549,26,68,147718,8,2,1,1,5,2
7550,29,68,147718,9,2,0,2,2,2
7551,32,68,147718,78,36,12,24,74,-3
7552,35,68,147718,81,33,14,19,55,-14
7553,38,68,147718,82,34,15,19,31,2
7554,41,68,147718,69,19,6,13,26,-9
7555,41,62,147718,14,5,5,0,14,3
7556,47,62,147718,70,17,6,11,32,13
7557,50,62,147718,63,15,5,10,27,7
7558,53,62,147718,47,5,3,2,4,2
7559,53,76,10450,9,5,2,3,2,3
7560,56,76,10450,65,39,18,21,36,-6
7561,59,76,10450,80,52,19,33,34,-22
7562,62,76,10450,38,20,5,15,40,3
7564,68,76,10450,48,24,4,20,38,-2
7565,71,76,10450,71,69,27,42,51,-9
7566,74,76,10450,60,51,18,33,12,-8
7567,77,76,10450,79,64,22,42,51,-4
7568,80,67,10450,65,45,19,26,24,-7
7569,83,67,10450,76,44,15,29,40,-34
7570,86,67,10450,78,29,14,15,41,-9
7571,5,85,130734,80,60,11,49,22,36
7572,8,85,130734,84,41,7,34,28,7
7573,11,85,130734,84,56,10,46,26,43
7574,14,85,130734,43,26,10,16,6,15
7575,17,85,130734,81,67,17,50,20,29
7576,20,85,130734,79,57,15,42,30,11
7577,23,85,130734,80,59,17,42,18,22
7578,26,85,130734,81,57,14,43,14,14
7579,29,85,130734,81,73,20,53,18,19
7581,35,85,130734,78,59,9,50,20,13
7582,38,85,130734,82,62,18,44,38,40
7583,41,85,130734,81,38,10,28,18,19
7584,47,85,130734,80,80,16,64,50,21
7585,50,85,130734,80,62,13,49,46,40
7586,53,85,130734,76,70,10,60,40,40
7587,56,85,130734,78,59,16,43,30,31
7588,59,85,130734,82,49,9,40,24,22
7589,62,85,130734,82,62,16,46,20,-2
7590,65,85,130734,70,34,11,23,28,21
7591,47,73,8894,71,16,1,15,66,7
7592,50,73,8894,82,24,8,16,54,10
7593,53,73,8894,76,31,7,24,71,3
7594,56,73,8894,82,45,7,38,73,-16
7473,26,70,24086,80,8,2,6,87,5
7474,23,80,12446,2,0,0,0,0,0
7599,71,69,8894,82,43,8,35,34,15
7600,74,69,8894,77,38,2,36,48,7
7601,77,69,8894,82,51,8,43,30,10
7602,80,69,8894,82,40,9,31,36,34
7603,83,69,8894,78,51,6,45,34,-1
7604,86,69,8894,82,47,7,40,41,-8
7605,53,78,9200,69,33,5,28,28,-9
7606,59,78,9200,79,39,10,29,79,1
7607,62,78,9200,55,19,5,14,37,-8
7608,62,64,9200,22,10,3,7,19,-5
7609,65,64,9200,73,26,4,22,26,-7
7610,68,64,9200,31,4,0,4,18,-3
7611,71,64,9200,80,39,9,30,61,5
7612,74,64,9200,47,23,12,11,33,2
7613,77,64,9200,73,27,11,16,50,-19
7614,80,64,9200,46,17,2,15,9,-6
7616,86,64,9200,80,25,7,18,38,8
7617,5,62,18714,17,7,2,5,17,3
7618,8,62,18714,62,21,9,12,18,-3
7620,11,1479,67316,13,7,1,6,8,1
7621,14,1479,67316,9,4,2,2,5,2
7622,17,1479,67316,1,0,0,0,0,-1
7623,56,88,10460,6,3,1,2,0,0
7624,59,88,10460,5,0,0,0,0,-3
7625,62,88,10460,72,13,3,10,6,-11
7626,65,88,10460,72,7,3,4,26,-3
7627,68,88,10460,48,14,5,9,19,5
7628,71,88,10460,73,11,6,5,6,-1
7629,74,88,10460,73,25,9,16,14,8
7630,77,88,10460,75,16,8,8,20,-10
7631,80,88,10460,82,24,12,12,30,-6
7632,83,88,10460,68,26,14,12,25,-6
7634,62,76,9310,2,0,0,0,0,-1
7635,65,76,9310,5,0,0,0,2,0
7638,65,547,11357,9,0,0,0,4,3
7639,2,71,31993,73,16,3,13,113,-9
7640,5,71,31993,55,10,2,8,107,-4
7641,8,74,31993,49,15,3,12,58,-2
7642,11,74,31993,71,19,5,14,70,4
7643,14,74,31993,44,8,1,7,58,-2
7644,17,74,31993,53,6,1,5,76,20
7645,20,71,31993,64,14,1,13,50,-1
7646,23,71,31993,7,0,0,0,22,-3
7647,68,83,7613,42,9,4,5,18,-1
7648,74,83,7613,62,26,8,18,18,0
7649,77,83,7613,67,36,19,17,40,-12
7650,80,83,7613,82,32,14,18,31,6
7651,83,83,7613,74,19,7,12,31,0
7653,56,86,9328,35,6,4,2,2,-6
7654,59,86,9328,59,13,10,3,38,-3
7655,62,86,9328,49,6,1,5,33,-6
7656,65,86,9328,61,24,12,12,26,1
7657,65,64,9328,17,13,8,5,11,-4
7658,68,64,9328,47,22,11,11,26,-13
7659,71,64,9328,79,38,19,19,30,-3
7660,74,64,9328,19,6,4,2,6,-9
7661,77,67,9328,63,27,14,13,10,-10
7662,77,1479,9328,21,12,8,4,23,3
7663,80,87,9328,72,17,9,8,23,-23
7664,83,68,9328,76,29,13,16,33,-5
7665,86,68,9328,19,7,4,3,6,-5
7666,59,75,11042,16,2,0,2,16,-6
7667,62,75,11042,27,5,2,3,38,5
7668,65,75,11042,20,3,0,3,61,-7
7670,71,75,11042,52,6,2,4,50,-8
7671,74,77,11042,34,12,6,6,30,4
7672,77,77,11042,73,16,11,5,101,-9
7673,80,87,11042,46,13,7,6,70,-8
7674,80,69,11042,19,3,2,1,14,-8
7675,8,80,38570,3,0,0,0,0,0
7676,8,88,38570,50,23,10,13,27,3
7677,11,1479,38570,3,0,0,0,2,-2
7678,68,80,12265,33,6,2,4,26,-3
7679,71,80,12265,57,11,2,9,64,9
7680,74,80,12265,75,12,0,12,97,11
7681,77,71,12265,53,6,1,5,75,0
7682,80,71,12265,40,6,2,4,65,-5
7683,83,71,12265,21,2,0,2,31,4
7684,86,72,12265,10,0,0,0,10,-1
7685,53,63,11105,77,27,8,19,89,-2
7687,59,63,11105,50,20,9,11,44,-7
7688,62,63,11105,79,62,30,32,121,28
7689,65,63,11105,81,61,26,35,135,7
7690,68,63,11105,46,27,7,20,75,8
7691,71,63,11105,80,59,24,35,91,30
7692,74,63,11105,81,44,18,26,81,13
7693,77,88,11105,81,55,20,35,79,26
7694,80,71,11105,82,50,23,27,50,-3
7695,83,71,11105,82,34,10,24,80,-12
7696,86,71,11105,79,20,6,14,91,-9
7697,29,85,8617,52,8,0,8,45,1
7698,32,85,8617,55,9,1,8,59,3
7699,35,85,8617,80,10,2,8,67,17
7700,38,85,8617,15,6,1,5,16,0
7701,41,85,8617,81,19,4,15,75,0
7702,47,85,8617,22,8,3,5,33,8
7704,47,88,9098,79,28,14,14,80,-10
7705,50,88,9098,81,46,17,29,54,-21
7706,53,88,9098,78,60,33,27,55,-13
7707,56,88,9098,80,53,24,29,64,-15
7708,59,88,9098,82,56,24,32,41,-6
7709,62,88,9098,82,57,28,29,67,17
7710,65,88,9098,82,54,22,32,53,18
7711,68,88,9098,46,29,18,11,22,6
7712,71,88,9098,79,27,15,12,66,7
7713,74,88,9098,82,27,11,16,26,-17
7714,77,88,9098,82,28,11,17,30,-5
7715,80,88,9098,80,36,14,22,22,-4
7716,83,88,9098,81,61,28,33,58,31
7717,86,88,9098,72,51,22,29,24,-17
7596,62,73,8894,70,39,4,35,54,20
7597,65,73,8894,79,46,7,39,30,15
7722,62,66,8599,57,12,6,6,14,1
7723,65,66,8599,79,36,17,19,26,1
7724,68,66,8599,48,38,23,15,18,15
7725,71,66,8599,68,30,16,14,22,2
7726,74,66,8599,52,23,13,10,16,-17
7727,74,547,8599,20,8,1,7,4,-1
7728,77,72,8599,30,4,2,2,6,-1
7729,59,80,11339,1,0,0,0,0,0
7730,65,80,11339,65,11,5,6,12,-2
7731,68,80,11339,19,3,1,2,9,-7
7732,68,63,11339,6,1,0,1,0,-1
7733,56,64,10440,53,19,11,8,54,-18
7734,59,64,10440,77,64,28,36,73,4
7735,62,64,10440,36,30,13,17,38,-10
7736,62,78,10440,26,23,15,8,15,4
7737,65,78,10440,79,30,15,15,109,1
7739,71,78,10440,58,26,15,11,112,2
7740,71,67,10440,5,0,0,0,6,-2
7741,74,67,10440,61,25,11,14,63,-30
7742,74,69,10440,20,11,3,8,25,4
7743,77,1479,10440,56,20,8,12,73,2
7744,80,69,10440,79,21,13,8,94,3
7745,83,69,10440,47,13,9,4,27,-1
7746,83,62,10440,7,3,1,2,0,-4
7747,59,84,9261,6,0,0,0,2,-4
7748,62,84,9261,2,1,1,0,0,1
7749,59,82,9227,6,2,0,2,2,2
7750,56,1479,9336,2,0,0,0,0,0
7751,59,1479,9336,60,18,11,7,35,-10
7752,62,1479,9336,35,10,3,7,36,-10
7753,65,1479,9336,70,15,4,11,72,-2
7754,68,1479,9336,42,13,8,5,56,2
7756,74,1479,9336,65,32,22,10,39,13
7757,77,63,9336,80,37,15,22,65,6
7758,80,63,9336,49,8,3,5,47,-10
7759,83,63,9336,14,0,0,0,17,-8
7760,83,74,9336,1,0,0,0,4,-1
7761,86,74,9336,4,1,1,0,5,1
7762,56,75,9333,7,0,0,0,2,-1
7763,59,75,9333,13,0,0,0,6,-2
7765,65,547,9333,4,0,0,0,0,-2
7766,65,1479,9333,6,1,0,1,2,1
7767,65,547,9333,5,5,1,4,0,5
7768,53,1479,4218,3,1,1,0,2,1
7771,5,89,70302,15,7,2,5,43,2
7772,8,89,70302,72,17,9,8,80,-13
7775,56,89,8390,2,0,0,0,0,-1
7776,59,66,8390,1,0,0,0,0,0
7778,83,20120,178573,78,37,15,22,27,3
7779,86,20120,178573,74,52,20,32,8,13
7780,56,81,9331,5,1,0,1,0,0
7781,62,76,9331,20,5,1,4,10,5
7782,65,76,9331,1,0,0,0,0,0
7783,53,69,9355,2,0,0,0,0,0
7784,56,69,9355,78,18,11,7,76,-5
7785,59,69,9355,74,21,13,8,52,-8
7786,62,69,9355,76,34,19,15,79,-5
7787,65,69,9355,74,27,15,12,103,-4
7788,68,69,9355,42,10,4,6,27,-5
7789,71,76,9355,73,19,12,7,50,-9
7790,74,76,9355,76,16,7,9,60,1
7791,77,76,9355,77,23,15,8,22,7
7792,80,76,9355,66,20,5,15,28,2
7793,83,76,9355,76,18,8,10,53,-7
7795,71,89,12257,1,0,0,0,0,0
7796,62,71,12256,35,5,1,4,10,-12
7797,65,71,12256,73,25,2,23,26,-7
7798,68,71,12256,48,12,3,9,29,1
7799,71,71,12256,80,17,7,10,42,-22
7800,74,71,12256,59,15,4,11,32,-25
7801,74,75,12256,19,7,3,4,10,-3
7802,77,75,12256,51,16,5,11,16,-6
7803,80,75,12256,80,28,8,20,22,3
7804,83,75,12256,82,42,12,30,28,-30
7805,86,75,12256,82,46,13,33,28,-5
7806,56,78,3439,1,0,0,0,2,0
7807,59,78,3439,3,2,0,2,0,-3
7808,47,1479,8522,57,39,14,25,22,6
7809,50,1479,8522,82,58,25,33,66,17
7810,53,1479,8522,77,82,24,58,94,32
7812,59,1479,8522,66,69,19,50,79,4
7813,62,1479,8522,67,76,19,57,35,14
7814,65,1479,8522,82,57,11,46,75,-11
7815,68,1479,8522,44,49,15,34,41,14
7816,71,1479,8522,77,87,31,56,31,28
7817,74,1479,8522,77,70,25,45,62,15
7818,77,1479,8522,77,63,13,50,55,14
7819,80,1479,8522,74,73,15,58,49,7
7820,83,1479,8522,56,61,11,50,42,20
7821,86,1479,8522,67,48,14,34,58,-19
7822,53,77,10429,2,0,0,0,0,-2
7823,56,77,10429,42,27,9,18,14,10
7824,59,77,10429,82,47,16,31,23,-9
7825,62,77,10429,82,76,25,51,47,20
7826,65,77,10429,77,93,28,65,29,6
7827,68,77,10429,48,48,13,35,22,-7
7829,74,77,10429,81,73,25,48,36,-3
7830,77,77,10429,78,67,22,45,53,-8
7831,80,77,10429,82,58,14,44,38,-15
7832,83,77,10429,82,102,34,68,20,28
7833,86,77,10429,82,85,22,63,24,9
7834,65,69,12273,7,2,1,1,2,-1
7835,56,76,4214,7,3,1,2,4,-1
7836,59,76,4214,11,1,1,0,4,4
7837,62,76,4214,42,9,6,3,33,-6
7838,68,76,4214,7,2,0,2,6,2
7839,71,71,4214,42,5,3,2,16,-16
7840,74,71,4214,20,4,2,2,14,-8
7841,5,78,72196,19,1,1,0,49,-4
7842,8,78,72196,15,5,1,4,23,-3
7719,56,83,8599,14,4,0,4,0,0
7720,59,83,8599,2,0,0,0,0,-2
7847,53,69,9100,82,43,15,28,80,12
7848,56,69,9100,59,27,8,19,45,-7
7849,59,69,9100,47,20,3,17,32,-15
7850,62,69,9100,80,46,17,29,98,-10
7851,65,86,9100,81,37,11,26,34,8
7852,68,86,9100,30,20,9,11,20,0
7853,71,86,9100,69,48,22,26,34,26
7854,74,86,9100,82,60,17,43,65,-9
7855,77,86,9100,82,75,27,48,53,-5
7856,80,86,9100,82,76,29,47,40,19
7857,83,86,9100,82,67,12,55,46,-16
7858,86,86,9100,82,83,16,67,34,13
7859,8,67,68099,5,1,1,0,2,0
7860,11,67,68099,4,0,0,0,0,-2
7861,14,67,68099,2,0,0,0,0,-1
7862,11,80,74519,1,0,0,0,2,0
7864,53,71,11260,1,0,0,0,2,0
7865,56,71,11260,15,0,0,0,59,-1
7866,59,71,11260,15,1,0,1,43,-8
7867,62,71,11260,71,13,3,10,198,-5
7868,65,71,11260,54,3,1,2,80,0
7869,68,71,11260,4,0,0,0,6,-1
7873,59,64,9214,15,20,9,11,8,4
7874,65,64,9214,32,16,7,9,8,-3
7875,68,68,9214,43,17,8,9,18,-11
7876,29,84,9592,49,9,1,8,10,-4
7877,32,84,9592,1,0,0,0,0,-1
7878,35,84,9592,51,10,5,5,10,-3
7879,38,84,9592,62,20,7,13,6,4
7880,41,84,9592,65,19,12,7,14,1
7881,41,84,9011,28,5,2,3,16,-2
7882,47,84,9011,82,23,10,13,79,1
7884,53,84,9011,80,37,21,16,79,1
7885,56,84,9011,82,59,26,33,61,8
7886,59,84,9011,82,75,25,50,104,1
7887,62,84,9011,82,73,41,32,66,24
7888,65,84,9011,77,49,22,27,56,11
7889,68,84,9011,17,13,4,9,12,-5
7890,71,84,9011,77,43,25,18,81,-15
7891,74,1479,9011,81,47,20,27,75,-5
7892,77,1479,9011,79,53,21,32,78,5
7893,80,1479,9011,82,58,22,36,83,8
7894,83,1479,9011,44,14,8,6,46,-4
7895,86,1479,9011,60,8,5,3,44,-19
7896,50,79,10152,81,42,29,13,24,16
7897,53,79,10152,82,28,12,16,55,-5
7898,56,79,10152,82,49,22,27,37,5
7899,59,79,10152,82,49,21,28,57,19
7901,65,79,10152,62,50,25,25,34,11
7902,68,66,10152,48,31,10,21,32,-18
7903,71,66,10152,82,40,15,25,34,2
7904,74,66,10152,46,24,6,18,14,-6
7905,77,66,10152,82,48,20,28,34,6
7906,80,66,10152,75,45,16,29,38,-1
7907,83,66,10152,79,46,19,27,26,-4
7908,86,66,10152,50,28,11,17,26,6
7909,56,78,3633,76,47,21,26,16,19
7910,59,78,3633,71,26,13,13,16,-5
7911,62,78,3633,81,52,22,30,26,-3
7912,65,78,3633,82,38,19,19,30,4
7913,68,78,3633,48,25,17,8,12,-2
7914,71,78,3633,78,32,14,18,38,10
7915,74,78,3633,77,27,12,15,26,-2
7916,77,78,3633,42,15,10,5,16,1
7918,83,78,3633,57,26,17,9,30,-5
7919,86,67,3633,23,4,2,2,6,-5
7920,35,89,9736,38,4,2,2,85,-1
7921,38,89,9736,27,1,1,0,57,-3
7922,41,89,9736,64,5,5,0,90,-10
7923,47,89,9736,1,0,0,0,2,-2
7924,53,69,11122,78,19,4,15,29,0
7925,56,69,11122,82,24,5,19,41,-14
7926,59,69,11122,64,6,2,4,38,-14
7927,68,86,11122,32,4,1,3,12,-9
7928,71,86,11122,67,20,4,16,35,3
7929,74,86,11122,57,16,5,11,28,-3
7930,74,74,11122,14,2,2,0,9,-1
7931,59,83,4202,40,14,9,5,30,-13
7932,62,65,4202,77,24,12,12,43,2
7933,65,65,4202,79,43,22,21,34,6
7935,71,73,4202,70,18,8,10,32,-14
7936,74,73,4202,25,10,2,8,18,0
7937,77,74,4202,75,20,9,11,22,6
7938,80,66,4202,57,12,9,3,33,-6
7939,80,80,4202,18,4,2,2,8,-3
7940,2,71,72949,21,7,2,5,14,1
7941,5,71,72949,57,40,6,34,38,20
7942,8,80,72949,80,63,17,46,84,-46
7943,11,80,72949,53,23,3,20,26,-26
7944,14,80,72949,28,11,4,7,10,-9
7945,14,79,72949,13,9,0,9,6,7
7946,17,79,72949,32,23,2,21,32,12
7950,65,79,11431,1,1,0,1,0,1
7951,2,62,21304,78,103,28,75,90,42
7952,5,62,21304,72,77,20,57,83,13
7953,8,62,21304,50,54,11,43,61,15
7955,14,78,21304,32,28,8,20,43,19
7956,17,78,21304,82,61,17,44,88,5
7957,20,78,21304,72,43,13,30,65,2
7958,23,78,21304,71,49,19,30,80,6
7959,26,78,21304,82,62,20,42,70,33
7960,29,78,21304,61,39,11,28,34,20
7961,32,78,21304,59,54,12,42,52,23
7962,35,78,21304,71,46,11,35,52,3
7963,38,78,21304,80,68,16,52,61,22
7964,41,78,21304,3,2,0,2,6,-1
7965,53,82,12266,1,0,0,0,17,0
7966,59,82,12266,3,0,0,0,7,0
7967,62,82,12266,9,4,2,2,40,-4
7968,65,77,12266,14,1,0,1,83,-3
7844,41,69,9100,36,6,1,5,12,-10
7845,47,69,9100,72,16,4,12,32,-7
7973,77,79,12266,4,1,0,1,19,1
7974,80,79,12266,13,2,0,2,48,0
7975,53,82,9363,17,2,1,1,6,-4
7976,56,82,9363,31,25,10,15,17,12
7977,59,82,9363,79,36,9,27,48,-17
7978,62,82,9363,74,47,17,30,55,-11
7979,65,82,9363,74,41,14,27,42,-20
7980,68,82,9363,34,18,7,11,16,-2
7981,68,74,9363,13,11,5,6,0,3
7982,71,74,9363,81,45,18,27,46,2
7983,74,74,9363,80,60,19,41,34,9
7984,77,74,9363,80,58,27,31,30,12
7985,80,80,9363,81,39,14,25,24,12
7986,83,80,9363,58,38,18,20,30,-1
7987,83,79,9363,14,8,3,5,4,1
7988,86,79,9363,40,15,9,6,29,-6
7990,86,64,9363,20,4,4,0,8,-7
7991,32,82,29032,29,9,4,5,4,4
7992,35,82,29032,23,5,2,3,4,-3
7993,59,84,8489,20,11,5,6,8,2
7994,62,76,8489,76,52,34,18,10,13
7995,65,76,8489,78,32,20,12,12,-18
7996,68,76,8489,45,21,16,5,12,4
7997,71,76,8489,64,26,12,14,12,-10
7998,74,76,8489,34,13,8,5,4,4
7999,77,83,8489,80,18,9,9,12,-4
8000,80,74,8489,76,40,27,13,10,22
8001,83,74,8489,59,31,25,6,12,11
8002,83,72,8489,21,5,2,3,4,0
8003,86,87,8489,41,16,9,7,8,-2
8004,50,63,8786,70,29,11,18,12,-12
8005,53,63,8786,82,37,19,18,28,-6
8007,59,83,8786,70,55,30,25,21,-8
8008,62,83,8786,82,64,32,32,24,-20
8009,65,83,8786,82,82,37,45,20,-10
8010,68,83,8786,48,52,20,32,18,-3
8011,71,83,8786,82,80,37,43,27,-5
8012,74,83,8786,82,61,25,36,30,-34
8013,77,79,8786,82,59,26,33,18,9
8014,80,79,8786,82,70,23,47,20,3
8015,83,79,8786,82,92,34,58,36,-4
8016,86,79,8786,82,82,27,55,28,-19
8017,59,63,12272,5,0,0,0,2,-2
8018,77,82,12272,16,2,0,2,8,-6
8019,77,64,12272,21,2,0,2,6,-1
8020,2,62,60158,57,27,13,14,55,15
8021,5,85,60158,23,6,1,5,38,4
8022,2,78,77157,37,17,6,11,24,-2
8024,62,85,9343,2,1,1,0,0,1
8025,65,85,9343,71,10,6,4,14,1
8026,68,85,9343,48,8,5,3,4,-1
8027,71,85,9343,18,2,0,2,4,-2
8028,62,83,12277,2,0,0,0,2,-1
8029,68,83,12277,22,3,2,1,28,-12
8030,74,83,12277,34,6,0,6,25,3
8031,77,1479,12277,29,3,0,3,10,-3
8032,80,1479,12277,32,7,2,5,23,0
8033,83,1479,12277,16,0,0,0,6,-3
8034,86,1479,12277,22,4,1,3,8,5
8035,47,1479,8537,56,25,13,12,50,1
8036,50,1479,8537,82,44,17,27,55,12
8037,53,1479,8537,70,54,29,25,108,12
8038,56,1479,8537,78,72,32,40,109,10
8039,59,1479,8537,82,76,27,49,111,0
8041,65,1479,8537,80,60,37,23,127,-7
8042,68,1479,8537,44,36,15,21,72,10
8043,71,1479,8537,81,82,43,39,65,32
8044,74,1479,8537,67,55,33,22,67,13
8045,77,1479,8537,82,62,34,28,68,2
8046,80,1479,8537,82,53,19,34,76,2
8047,83,1479,8537,71,49,17,32,71,-4
8048,86,1479,8537,31,10,6,4,27,-16
8049,59,86,12258,4,0,0,0,0,-3
8050,62,86,12258,37,4,2,2,8,-8
8051,65,86,12258,10,0,0,0,10,-2
8052,71,86,12258,36,2,1,1,4,-11
8053,77,86,12258,1,0,0,0,0,0
8054,53,89,3680,82,69,14,55,24,13
8055,56,89,3680,82,88,22,66,46,16
8056,59,89,3680,82,101,33,68,50,37
8058,65,89,3680,42,44,14,30,24,-4
8059,68,89,3680,48,48,8,40,20,8
8060,71,89,3680,82,79,18,61,54,-20
8061,74,89,3680,82,78,18,60,40,5
8062,77,89,3680,75,70,20,50,36,17
8063,80,89,3680,82,86,23,63,38,17
8064,83,89,3680,81,71,21,50,46,5
8065,86,89,3680,80,74,22,52,30,2
8066,56,68,8697,79,45,21,24,22,10
8067,59,68,8697,82,43,21,22,43,-4
8068,62,68,8697,52,29,8,21,16,2
8069,62,65,8697,28,9,3,6,14,0
8070,65,65,8697,63,15,5,10,22,-10
8071,68,65,8697,45,10,3,7,8,5
8072,71,547,8697,81,42,15,27,12,8
8073,74,547,8697,82,42,19,23,18,4
8075,80,62,8697,82,44,17,27,58,13
8076,83,62,8697,70,25,10,15,26,-19
8077,86,62,8697,65,34,16,18,26,24
8078,62,79,9309,3,0,0,0,0,-1
8079,65,79,9309,9,1,0,1,4,-2
8080,68,76,9309,19,4,0,4,10,4
8081,71,76,9309,47,9,3,6,14,-14
8082,74,76,9309,52,7,2,5,32,-1
8083,77,76,9309,52,6,1,5,31,1
8084,80,547,9309,5,2,0,2,0,-1
8086,5,86,1632,37,16,5,11,4,-32
8087,8,86,1632,13,1,0,1,10,-19
8088,17,70,1632,2,0,0,0,0,0
8089,56,77,11446,38,4,1,3,2,-15
7970,68,84,12266,23,1,1,0,53,-3
7971,71,84,12266,77,9,5,4,213,-14
8094,68,66,11446,8,1,0,1,2,-1
8095,62,85,11108,19,1,1,0,4,-3
8096,65,85,11108,25,3,1,2,0,2
8097,68,85,11108,2,0,0,0,4,0
8098,20,85,53799,2,0,0,0,5,0
8099,59,66,9308,14,10,3,7,0,6
8100,62,66,9308,76,30,7,23,32,-8
8101,65,66,9308,76,27,8,19,4,-7
8102,68,66,9308,40,8,1,7,12,0
8103,71,67,9308,69,17,6,11,14,-13
8104,74,88,9308,26,9,3,6,4,4
8105,77,88,9308,44,9,2,7,6,2
8106,80,87,9308,3,0,0,0,0,-1
8107,56,74,9296,1,0,0,0,0,0
8108,59,74,9296,82,28,12,16,32,-2
8109,62,74,9296,82,44,18,26,20,3
8111,68,82,9296,35,18,11,7,12,-6
8112,71,82,9296,81,39,22,17,20,-2
8113,74,82,9296,52,27,7,20,8,-6
8114,77,65,9296,77,42,20,22,12,8
8115,80,65,9296,64,45,22,23,30,9
8116,83,65,9296,72,31,20,11,22,-17
8117,86,65,9296,78,37,15,22,14,-2
8118,53,68,9341,4,2,2,0,2,-2
8119,56,68,9341,16,2,0,2,2,-3
8120,59,68,9341,55,16,7,9,10,-3
8121,62,68,9341,51,16,6,10,16,0
8122,65,68,9341,79,24,10,14,49,-2
8123,68,68,9341,48,21,14,7,16,-8
8124,71,68,9341,59,16,9,7,14,0
8125,71,84,9341,18,7,3,4,12,-3
8126,74,84,9341,78,27,18,9,16,-3
8128,77,64,9341,20,11,6,5,8,-7
8129,80,547,9341,45,12,8,4,13,0
8130,83,547,9341,27,3,1,2,10,-1
8131,8,76,8696,64,52,14,38,59,14
8132,11,76,8696,76,57,10,47,80,29
8133,14,76,8696,26,16,3,13,32,-1
8134,14,75,8696,14,5,1,4,14,-2
8135,17,75,8696,61,28,5,23,79,7
8136,20,75,8696,65,30,10,20,43,3
8137,23,75,8696,74,44,13,31,70,16
8138,26,75,8696,62,34,13,21,77,-7
8139,29,75,8696,7,0,0,0,4,0
8140,29,72,8696,17,5,1,4,19,1
8141,32,74,8696,3,2,0,2,4,0
8142,35,74,8696,81,28,6,22,83,10
8143,38,74,8696,71,17,3,14,52,-7
8145,41,77,8696,6,1,0,1,2,-1
8146,47,72,8696,29,9,4,5,26,-9
8147,11,77,27314,67,4,1,3,86,2
8148,14,77,27314,4,0,0,0,4,-1
8150,17,89,27314,1,0,0,0,0,0
8151,20,89,27314,6,0,0,0,2,2
8152,23,89,27314,8,0,0,0,12,1
8153,26,89,27314,10,0,0,0,6,-5
8154,29,62,27314,4,1,0,1,2,1
8155,17,84,18761,41,2,0,2,136,-10
8156,20,63,18761,33,0,0,0,70,-14
8157,23,63,18761,40,1,1,0,86,-12
8158,26,76,18761,2,1,0,1,7,3
8159,56,83,9251,73,31,15,16,18,-8
8160,59,83,9251,78,36,16,20,16,0
8161,62,83,9251,82,57,30,27,26,7
8163,68,83,9251,48,23,7,16,22,-5
8164,71,83,9251,70,20,9,11,24,-4
8165,74,76,9251,82,31,15,16,21,7
8166,77,76,9251,81,22,9,13,22,13
8167,80,76,9251,72,23,12,11,18,3
8168,83,76,9251,13,3,1,2,0,0
8169,59,72,9327,12,0,0,0,24,0
8170,62,72,9327,22,6,0,6,44,-5
8171,56,70,11888,3,2,0,2,2,1
8172,59,70,11888,2,0,0,0,0,-2
8173,56,76,12401,3,0,0,0,2,2
8174,59,76,12401,46,7,1,6,20,4
8175,62,76,12401,60,27,4,23,37,9
8176,65,76,12401,75,19,5,14,26,-5
8177,68,76,12401,48,12,3,9,20,-2
8178,71,76,12401,63,24,4,20,34,-19
8180,74,77,12401,58,12,2,10,41,-5
8181,77,77,12401,28,8,1,7,6,10
8182,80,77,12401,73,18,2,16,26,-5
8183,83,77,12401,66,21,6,15,30,8
8184,86,77,12401,47,9,0,9,18,-5
8185,29,80,8766,32,9,4,5,15,-6
8186,32,80,8766,60,19,7,12,46,-1
8187,35,80,8766,58,24,15,9,55,8
8188,38,80,8766,74,38,18,20,54,13
8189,41,80,8766,24,10,4,6,39,-3
8190,47,80,8766,68,44,22,22,64,23
8191,50,80,8766,68,48,22,26,41,15
8192,53,80,8766,79,47,23,24,82,-10
8193,56,80,8766,78,32,13,19,66,0
8194,59,80,8766,79,53,25,28,59,1
8195,62,80,8766,55,24,14,10,33,-19
8197,65,73,8766,72,51,24,27,33,11
8198,68,73,8766,38,21,10,11,27,6
8199,71,73,8766,75,49,20,29,60,-4
8200,74,73,8766,59,39,19,20,39,4
8201,77,73,8766,70,23,13,10,29,-14
8202,80,73,8766,72,42,18,24,55,1
8203,83,73,8766,16,4,2,2,8,0
8204,2,62,32220,79,22,7,15,84,29
8205,5,62,32220,37,14,2,12,53,10
8206,5,83,32220,39,16,3,13,18,0
8207,8,83,32220,77,19,4,15,55,3
8208,11,83,32220,82,30,3,27,115,-5
8209,14,83,32220,46,10,2,8,75,-6
8210,17,83,32220,82,8,0,8,87,2
8091,62,77,11446,67,22,11,11,16,14
8092,65,77,11446,12,1,0,1,2,-1
8215,5,83,3717,15,4,0,4,0,1
8216,8,83,3717,18,2,1,1,17,-9
8217,11,83,3717,67,16,7,9,63,5
8218,14,83,3717,36,1,0,1,22,-2
8219,17,71,3717,37,8,3,5,38,-5
8221,23,66,3717,77,8,4,4,31,-6
8222,26,66,3717,81,16,5,11,38,9
8223,29,66,3717,56,5,1,4,12,-8
8224,29,77,3717,13,3,0,3,4,2
8225,32,77,3717,82,15,5,10,47,-2
8226,35,77,3717,34,7,2,5,8,2
8227,35,79,3717,4,1,1,0,4,1
8228,38,79,3717,82,7,2,5,46,-22
8229,62,80,11418,26,11,6,5,12,-1
8230,65,80,11418,81,25,8,17,30,11
8231,68,80,11418,48,12,4,8,34,3
8233,74,80,11418,68,23,9,14,30,13
8234,77,81,11418,54,11,6,5,34,-4
8235,80,81,11418,13,0,0,0,4,-4
8236,86,70,11418,6,1,1,0,2,-2
8241,74,87,9311,17,3,0,3,8,-12
8242,74,74,9311,3,0,0,0,0,0
8243,77,74,9311,3,0,0,0,4,-2
8244,59,72,9300,40,10,0,10,8,2
8245,62,72,9300,38,4,2,2,2,3
8246,65,72,9300,4,0,0,0,0,-2
8247,2,71,21492,80,32,17,15,76,-1
8248,5,71,21492,80,30,12,18,98,-1
8249,8,71,21492,82,30,10,20,110,-16
8250,11,71,21492,66,26,16,10,80,-20
8251,11,74,21492,12,6,4,2,11,6
8252,14,77,21492,45,12,3,9,23,2
8254,17,78,21492,13,1,0,1,8,-6
8255,20,78,21492,50,7,2,5,33,-12
8256,47,70,9608,3,0,0,0,0,-1
8257,50,70,9608,2,0,0,0,0,-1
8258,14,76,2083,12,5,1,4,2,-1
8259,20,88,2083,1,0,0,0,0,-2
8260,59,86,9374,24,5,2,3,8,4
8261,62,86,9374,33,9,5,4,9,8
8262,65,86,9374,35,8,7,1,8,0
8263,68,74,9374,4,1,0,1,0,0
8264,71,84,9374,2,0,0,0,0,0
8265,53,65,8789,64,54,24,30,44,11
8266,56,65,8789,82,69,34,35,51,12
8267,59,65,8789,76,68,25,43,47,22
8268,62,65,8789,80,76,32,44,26,25
8269,65,65,8789,59,57,29,28,28,17
8271,71,65,8789,76,68,28,40,34,26
8272,74,65,8789,81,66,28,38,36,30
8273,77,65,8789,80,58,28,30,62,16
8274,80,65,8789,72,58,21,37,35,7
8275,83,65,8789,74,52,20,32,47,-1
8276,86,65,8789,82,81,35,46,40,2
8277,2,72,73793,14,4,4,0,46,-1
8278,62,72,9301,18,5,1,4,0,0
8279,62,73,9307,20,8,6,2,7,3
8280,65,73,9307,22,3,0,3,17,-2
8281,65,75,9307,13,2,2,0,10,2
8282,5,78,8528,2,1,1,0,4,0
8283,14,1479,8528,1,0,0,0,0,-2
8284,17,1479,8528,24,1,0,1,42,3
8285,20,1479,8528,73,10,1,9,140,6
8286,23,1479,8528,72,9,3,6,189,-8
8288,29,1479,8528,55,3,0,3,88,-10
8289,32,1479,8528,50,7,3,4,105,-12
8290,32,89,8528,5,0,0,0,17,-1
8291,35,69,8528,80,11,5,6,148,-8
8292,38,69,8528,45,6,1,5,69,4
8293,41,69,8528,12,5,1,4,18,-1
8294,41,86,8528,12,2,0,2,8,-2
8295,47,1479,8528,23,4,0,4,34,2
8296,59,74,11107,5,0,0,0,4,0
8297,65,66,11107,3,0,0,0,0,0
8298,68,66,11107,37,6,2,4,4,-6
8299,62,76,12275,1,0,0,0,0,0
8301,20,68,46843,1,0,0,0,5,0
8302,2,83,68719,63,14,9,5,180,-10
8303,5,83,68719,8,1,1,0,4,-4
8304,53,62,9649,1,0,0,0,0,-1
8306,14,83,19215,15,0,0,0,13,2
8307,17,83,19215,13,0,0,0,14,-1
8308,20,83,19215,36,4,0,4,38,-12
8309,68,68,14853,5,0,0,0,0,0
8310,59,89,10439,21,9,4,5,6,4
8311,62,89,10439,35,14,7,7,20,-3
8312,65,89,10439,64,30,16,14,24,9
8313,68,89,10439,39,17,6,11,20,7
8314,71,1479,10439,69,43,18,25,36,13
8315,74,547,10439,62,41,18,23,38,7
8316,77,547,10439,71,41,9,32,36,-11
8317,80,547,10439,65,45,13,32,30,-11
8318,83,547,10439,70,39,17,22,38,4
8319,86,547,10439,82,30,15,15,44,-1
8320,11,71,24190,2,0,0,0,0,-1
8321,53,77,11403,26,6,1,5,24,-4
8323,50,88,9654,16,4,2,2,8,-2
8324,50,88,11011,5,0,0,0,2,-1
8325,53,88,11011,3,0,0,0,0,0
8326,5,67,8968,69,17,11,6,309,-12
8327,8,67,8968,82,26,13,13,242,3
8328,11,67,8968,84,45,18,27,171,-6
8329,14,67,8968,33,6,3,3,87,5
8330,17,67,8968,79,44,15,29,295,6
8331,20,67,8968,42,7,3,4,106,-8
8332,23,67,8968,36,11,4,7,113,2
8333,23,84,8968,27,12,9,3,41,0
8334,26,84,8968,66,17,6,11,102,-14
8335,29,84,8968,59,16,9,7,90,-2
8339,38,84,8968,3,0,0,0,10,1
8212,23,83,32220,67,7,0,7,63,-17
8213,23,85,32220,7,0,0,0,2,0
8344,53,1479,8968,61,4,3,1,53,2
8345,56,1479,8968,20,5,0,5,28,5
8346,56,83,8968,38,2,1,1,61,-5
8347,59,85,8968,40,1,0,1,66,-5
8348,53,1479,11741,34,8,4,4,36,-2
8349,56,1479,11741,48,9,3,6,52,3
8350,59,1479,11741,38,9,4,5,31,0
8351,62,1479,11741,18,3,1,2,22,-4
8352,62,66,11741,32,3,0,3,22,0
8353,62,68,11741,12,3,2,1,22,3
8354,65,68,11741,7,0,0,0,6,-1
8355,65,72,11741,65,8,4,4,84,-12
8356,68,72,11741,44,15,6,9,31,-2
8357,71,72,11741,62,10,7,3,35,-6
8358,74,69,11741,53,13,3,10,55,3
8359,77,69,11741,60,12,7,5,48,-3
8361,74,82,23512,4,1,0,1,0,-1
8362,14,72,25723,24,3,0,3,17,4
8363,20,78,25723,15,0,0,0,24,-2
8364,23,78,25723,54,10,3,7,36,14
8365,26,78,25723,51,2,1,1,50,-10
8366,29,78,25723,21,2,1,1,14,1
8367,29,81,25723,10,2,1,1,10,-5
8369,32,65,25723,50,6,0,6,32,5
8370,35,65,25723,40,3,0,3,36,8
8371,38,88,25723,21,2,0,2,24,-4
8372,11,80,74524,17,4,2,2,8,-16
8378,17,64,8859,82,120,51,69,44,14
8379,20,64,8859,65,74,22,52,34,-10
8386,41,64,8859,81,87,33,54,42,11
8387,47,64,8859,82,87,32,55,60,10
8388,50,64,8859,82,100,36,64,46,2
8389,53,64,8859,44,40,13,27,20,-4
8390,56,64,8859,15,12,2,10,6,-6
8391,2,67,1906,60,22,15,7,25,-2
8392,14,63,1906,11,3,1,2,0,0
8393,68,73,9338,24,7,0,7,6,2
8394,71,73,9338,50,6,1,5,23,0
8395,74,73,9338,37,10,0,10,26,1
8396,77,73,9338,1,0,0,0,0,-1
8397,77,75,9338,9,0,0,0,6,3
8398,5,88,73578,4,0,0,0,4,0
8399,14,74,73578,5,1,1,0,2,1
8403,8,81,32134,63,20,7,13,35,-20
8404,11,85,32134,4,1,0,1,0,-1
8405,32,82,32134,26,3,0,3,12,-9
8406,2,74,53801,71,22,12,10,252,-8
8407,5,71,53801,15,4,1,3,36,-1
8408,5,72,53801,17,7,3,4,43,7
8409,8,72,53801,34,7,4,3,56,3
8410,11,80,53801,82,23,7,16,166,-33
8411,14,80,53801,23,8,3,5,35,6
8412,17,80,53801,64,5,2,3,171,-7
8413,20,63,53801,68,14,6,8,155,-8
8414,23,81,53801,3,0,0,0,7,0
8415,2,72,72864,64,22,8,14,151,9
8416,5,72,72864,37,18,7,11,58,0
8417,5,71,72864,23,9,3,6,46,8
8418,8,71,72864,13,2,1,1,29,-3
8420,11,86,72864,19,0,0,0,30,-1
8421,11,76,72864,37,6,0,6,74,-6
8428,74,87,11661,20,4,1,3,4,-5
8429,74,70,11661,5,0,0,0,0,0
8430,74,62,11661,19,0,0,0,8,6
8431,77,72,11661,67,19,6,13,16,-22
8432,80,86,11661,62,18,2,16,14,4
8433,83,75,11661,37,5,1,4,6,3
8434,86,75,11661,18,2,0,2,4,-1
8435,38,82,13512,8,0,0,0,2,0
8436,2,76,54944,12,5,0,5,6,-3
8437,5,79,5672,15,4,0,4,0,1
8438,8,79,5672,84,61,28,33,46,21
8439,11,88,5672,49,21,8,13,24,1
8440,11,79,5672,27,21,12,9,10,13
8441,14,79,5672,44,26,13,13,22,4
8443,20,80,5672,65,31,11,20,18,-5
8444,23,80,5672,81,48,24,24,42,1
8445,26,80,5672,77,56,31,25,46,8
8446,29,80,5672,69,51,29,22,24,2
8447,32,80,5672,82,72,32,40,62,10
8448,35,80,5672,80,46,15,31,52,9
8451,47,63,5672,28,8,2,6,22,-12
8452,53,1479,10415,3,0,0,0,2,3
8453,56,1479,10415,48,32,8,24,24,8
8454,59,1479,10415,2,0,0,0,0,-1
8455,59,65,10415,10,1,1,0,2,1
8456,59,69,10415,49,14,8,6,6,-8
8458,65,84,10415,18,6,5,1,6,2
8459,68,84,10415,28,6,1,5,4,-1
8460,71,79,10415,9,1,0,1,0,-4
8461,74,79,10415,24,6,1,5,2,1
8463,56,70,9144,15,5,1,4,26,-1
8464,56,78,9144,66,17,11,6,122,-8
8465,59,78,9144,79,15,7,8,168,-5
8466,62,78,9144,80,14,7,7,154,-18
8467,65,78,9144,40,3,1,2,71,-2
8468,68,81,9144,44,8,1,7,112,4
8469,71,81,9144,55,10,3,7,79,-2
8470,74,87,9144,58,6,3,3,79,-6
8471,59,82,12013,3,0,0,0,4,0
8472,53,68,14083,4,0,0,0,0,-1
8473,62,62,14083,16,2,0,2,17,0
8476,5,77,27595,5,0,0,0,2,0
8477,2,65,21476,75,29,14,15,191,20
8478,5,71,21476,79,47,15,32,220,9
8341,47,64,8968,54,6,3,3,82,-14
8342,50,64,8968,10,3,0,3,8,0
8487,26,75,21476,11,2,0,2,48,-3
8488,26,65,21476,64,21,6,15,107,4
8489,29,65,21476,37,7,0,7,40,2
8490,29,70,21476,26,3,1,2,22,10
8491,32,83,21476,74,11,4,7,93,13
8492,35,83,21476,13,1,0,1,10,3
8493,35,70,21476,34,1,0,1,23,-1
8494,59,64,13845,61,21,3,18,36,13
8495,62,64,13845,67,16,3,13,68,-8
8496,65,64,13845,59,21,1,20,33,11
8497,68,64,13845,12,3,0,3,8,4
8498,71,64,13845,28,6,0,6,12,1
8499,74,64,13845,3,0,0,0,0,-3
8500,8,63,29243,7,4,1,3,0,2
8501,11,63,29243,29,1,0,1,4,-10
8502,14,85,29243,2,0,0,0,2,0
8504,8,76,31756,56,30,10,20,24,7
8505,11,76,31756,81,56,25,31,24,31
8506,14,76,31756,41,16,9,7,8,-1
8507,17,76,31756,74,46,12,34,39,-11
8508,20,76,31756,70,42,20,22,20,-7
8509,20,62,31756,10,7,3,4,2,-1
8510,23,62,31756,75,44,19,25,34,1
8511,26,62,31756,6,2,1,1,6,-1
8512,26,1479,31756,75,52,18,34,36,-14
8513,29,1479,31756,62,28,10,18,26,-4
8514,32,1479,31756,75,42,20,22,40,-21
8515,35,1479,31756,60,23,9,14,25,-14
8516,35,63,31756,19,5,2,3,8,-1
8517,38,63,31756,77,19,9,10,38,-11
8518,2,72,71101,9,1,0,1,21,-1
8520,8,74,71101,2,0,0,0,2,-1
8523,8,65,8963,78,20,5,15,313,15
8524,11,65,8963,13,5,1,4,42,-2
8526,14,71,8963,40,6,1,5,184,-11
8527,17,71,8963,78,18,3,15,202,-7
8528,20,71,8963,71,16,3,13,132,13
8529,23,71,8963,27,4,0,4,58,-2
8530,23,81,8963,22,6,2,4,43,-3
8531,23,86,8963,12,3,0,3,43,2
8532,26,86,8963,59,8,2,6,101,-7
8533,29,86,8963,49,4,0,4,72,3
8534,32,86,8963,75,18,7,11,204,15
8535,35,86,8963,72,22,2,20,178,22
8536,38,86,8963,67,11,2,9,108,-2
8537,38,64,8963,14,3,0,3,33,4
8538,41,83,8963,75,4,1,3,106,4
8539,47,62,8963,37,3,1,2,75,8
8541,62,86,14497,9,0,0,0,22,-1
8542,65,86,14497,7,0,0,0,9,0
8543,68,86,14497,1,0,0,0,0,0
8544,68,83,14497,35,5,3,2,102,0
8545,71,83,14497,27,0,0,0,77,-2
8546,41,65,9612,9,1,0,1,6,-5
8547,47,65,9612,25,1,0,1,20,-7
8548,56,69,11771,20,1,0,1,21,-1
8549,59,69,11771,51,2,1,1,90,-3
8550,62,65,11771,40,1,0,1,72,0
8551,65,65,11771,29,1,0,1,48,0
8552,65,74,11771,6,0,0,0,5,-1
8553,68,67,11771,34,0,0,0,69,-1
8554,71,67,11771,56,1,1,0,125,-12
8555,74,86,11771,38,4,3,1,87,0
8556,77,87,11771,11,1,0,1,25,0
8558,56,79,9404,16,2,0,2,7,2
8559,59,79,9404,1,0,0,0,0,0
8560,62,79,9404,7,0,0,0,5,-3
8561,65,76,9404,31,1,0,1,6,-7
8562,65,81,9404,18,8,3,5,10,4
8563,68,66,9404,28,2,1,1,17,-9
8564,2,62,10672,78,79,30,49,44,15
8565,5,62,10672,68,70,22,48,60,14
8566,8,62,10672,71,57,18,39,40,0
8567,11,86,10672,80,68,30,38,78,11
8568,14,86,10672,43,24,10,14,40,-4
8569,20,70,10672,4,0,0,0,0,-2
8570,11,71,72761,12,1,0,1,43,-2
8571,14,71,72761,18,2,0,2,35,-9
8572,2,63,39864,23,6,3,3,36,0
8573,5,63,39864,18,9,3,6,44,2
8575,2,78,60224,64,16,2,14,81,17
8576,5,78,60224,17,1,0,1,38,-3
8578,2,83,27718,78,30,21,9,112,-16
8579,5,83,27718,63,26,15,11,76,-36
8580,5,76,27718,12,7,2,5,18,2
8581,8,76,27718,28,7,2,5,35,-3
8582,11,63,27718,22,10,7,3,18,-4
8583,17,70,27718,3,0,0,0,2,0
8584,2,83,32226,22,0,0,0,15,-6
8585,2,85,32226,20,4,1,3,16,-3
8586,5,85,32226,55,7,3,4,53,8
8587,8,80,32226,59,3,0,3,30,-29
8588,8,74,74386,11,0,0,0,6,0
8589,11,74,74386,4,2,0,2,0,-1
8590,14,74,74386,10,2,0,2,18,2
8591,8,78,24084,8,4,1,3,4,1
8595,17,64,8975,5,0,0,0,0,0
8596,20,64,8975,56,17,5,12,15,15
8597,23,64,8975,55,4,2,2,51,0
8598,26,64,8975,76,18,5,13,42,3
8599,29,64,8975,53,8,1,7,36,3
8600,32,64,8975,56,13,4,9,29,19
8601,32,88,8975,13,5,0,5,14,3
8602,35,88,8975,74,17,5,12,54,14
8603,38,88,8975,49,6,1,5,24,-7
8604,41,88,8975,35,3,1,2,32,-3
8605,47,88,8975,56,8,0,8,27,-6
8606,50,88,8975,82,8,0,8,60,-14
8607,53,84,8975,57,9,1,8,32,-1
8608,11,72,8590,41,17,2,15,18,10
8480,11,71,21476,57,16,3,13,140,-4
8485,20,75,21476,9,2,1,1,23,-1
8613,26,88,8590,5,1,0,1,0,1
8614,29,88,8590,26,9,5,4,18,-2
8615,32,88,8590,63,19,4,15,48,16
8616,35,88,8590,80,42,4,38,65,-4
8617,38,88,8590,82,38,13,25,68,-13
8618,41,88,8590,79,32,5,27,44,11
8620,50,70,8590,57,10,1,9,32,10
8621,50,88,8590,19,8,0,8,22,1
8622,53,88,8590,61,6,1,5,42,2
8623,53,77,8590,19,3,0,3,8,-11
8624,14,63,42425,18,8,2,6,6,-1
8625,17,63,42425,80,29,15,14,65,-9
8626,20,63,42425,34,13,10,3,45,-12
8627,23,88,42425,62,24,11,13,70,4
8628,26,88,42425,42,5,3,2,26,-9
8629,17,79,5079,51,2,1,1,47,-1
8631,23,79,5079,37,7,1,6,19,0
8632,26,79,5079,62,9,4,5,37,1
8633,29,79,5079,73,12,4,8,28,-10
8634,32,79,5079,40,7,3,4,28,5
8635,35,79,5079,64,10,2,8,54,-11
8636,38,79,5079,70,7,0,7,46,-17
8637,38,63,5079,8,1,0,1,2,-1
8638,41,63,5079,35,5,1,4,28,3
8639,47,63,5079,12,2,1,1,10,0
8640,50,1479,5079,1,0,0,0,0,-1
8641,14,62,46348,4,0,0,0,0,0
8642,56,76,11491,1,0,0,0,0,0
8643,5,79,71673,1,0,0,0,2,-1
8644,8,77,71673,1,0,0,0,2,0
8645,17,62,120114,0,0,0,0,0,0
8646,11,79,30680,9,2,1,1,12,3
8648,11,79,72028,25,1,1,0,2,0
8649,11,70,72028,5,0,0,0,0,-2
8650,65,68,11519,1,0,0,0,0,0
8651,68,68,11519,10,1,1,0,2,-5
8652,2,62,54517,78,34,15,19,93,17
8653,5,62,54517,4,1,1,0,19,2
8654,5,65,54517,20,13,5,8,45,3
8655,8,65,54517,79,33,15,18,98,6
8656,11,65,54517,65,31,15,16,55,10
8657,11,74,54517,12,7,4,3,2,5
8658,14,74,54517,41,8,3,5,25,-8
8659,17,74,54517,32,6,4,2,22,-4
8660,17,78,54517,46,20,7,13,65,-4
8661,20,78,54517,74,36,16,20,50,11
8662,23,86,54517,73,29,15,14,60,4
8663,26,86,54517,68,23,8,15,73,2
8665,32,86,54517,80,32,13,19,32,5
8666,35,86,54517,55,11,7,4,15,4
8667,38,68,54517,52,8,4,4,27,-9
8668,2,89,52539,67,10,4,6,264,-10
8669,5,89,52539,75,15,6,9,221,-7
8670,8,89,52539,83,16,6,10,268,1
8671,11,89,52539,43,11,4,7,97,-2
8672,11,70,52539,8,1,1,0,18,-1
8673,14,70,52539,27,2,1,1,106,1
8674,14,62,52539,7,3,1,2,13,2
8675,5,79,76417,1,0,0,0,0,0
8676,11,89,76417,2,1,1,0,2,1
8677,5,74,25150,73,58,30,28,15,19
8678,8,74,25150,81,54,23,31,34,15
8679,11,74,25150,76,49,22,27,36,13
8680,14,74,25150,47,13,7,6,16,-6
8682,20,74,25150,63,19,6,13,12,5
8683,20,84,25150,6,5,2,3,4,4
8684,23,76,25150,74,29,10,19,24,3
8685,26,76,25150,67,16,8,8,22,-17
8686,26,72,25150,10,4,4,0,6,4
8687,29,72,25150,53,26,10,16,18,1
8688,32,72,25150,65,30,8,22,16,11
8689,35,72,25150,68,10,5,5,10,-9
8690,20,74,25851,2,0,0,0,2,-1
8691,23,1479,25851,32,9,4,5,16,-1
8692,26,1479,25851,80,9,5,4,34,-12
8693,29,1479,25851,79,18,8,10,14,4
8694,32,69,25851,59,11,3,8,4,-16
8695,2,84,66693,36,18,11,7,14,3
8696,5,84,66693,5,0,0,0,2,-2
8697,56,81,11423,31,9,4,5,12,-1
8699,65,67,11423,9,4,1,3,4,0
8700,2,84,74518,13,5,0,5,32,-3
8701,5,84,74518,6,1,1,0,0,-1
8702,8,80,74518,59,23,7,16,43,-37
8703,11,80,74518,55,19,11,8,64,-41
8704,86,82,142315,4,0,0,0,4,0
8705,2,76,54462,52,19,5,14,47,-21
8706,5,76,54462,25,6,2,4,18,11
8707,11,76,54462,19,5,1,4,16,-13
8709,56,76,11727,1,0,0,0,2,0
8710,53,77,11406,2,0,0,0,0,-1
8711,56,62,11406,2,0,0,0,0,-1
8712,56,88,14331,9,0,0,0,9,1
8713,62,88,14331,56,3,0,3,105,-6
8714,65,88,14331,25,2,1,1,39,-3
8715,68,66,14331,31,4,2,2,45,1
8717,71,62,14331,36,7,4,3,64,-2
8718,68,84,15476,12,0,0,0,29,-6
8719,71,71,15476,6,2,0,2,15,-1
8720,74,71,15476,18,4,2,2,30,1
8721,56,89,11424,15,2,1,1,12,1
8722,62,89,11424,4,1,1,0,0,2
8723,65,89,11424,2,0,0,0,0,-1
8724,59,79,11422,10,1,1,0,2,-2
8725,62,79,11422,64,27,14,13,13,4
8726,65,79,11422,11,1,0,1,2,-6
8727,65,82,11422,51,24,11,13,6,-3
8728,68,82,11422,46,27,13,14,10,7
8729,71,82,11422,82,34,12,22,20,1
8730,74,82,11422,54,13,7,6,0,-9
8610,17,80,8590,64,18,4,14,38,-17
8611,17,88,8590,9,3,0,3,6,-4
8735,86,82,11422,2,0,0,0,0,-1
8736,53,78,11333,24,8,2,6,8,-4
8737,56,78,11333,22,4,2,2,18,-5
8738,20,62,10836,9,3,1,2,2,-4
8741,17,1479,24926,3,1,0,1,2,0
8742,50,88,14336,5,0,0,0,6,-3
8743,65,62,14336,5,0,0,0,2,-5
8744,71,73,14336,2,0,0,0,0,1
8745,74,73,14336,1,0,0,0,2,-1
8746,50,82,11915,1,0,0,0,0,0
8747,53,68,3579,47,17,2,15,22,0
8748,56,68,3579,7,1,0,1,2,-1
8749,56,81,3579,25,15,5,10,12,-3
8750,59,72,3579,12,3,2,1,2,-2
8751,62,72,14960,4,1,1,0,5,1
8752,65,72,14960,27,1,0,1,32,-10
8754,2,85,27569,3,0,0,0,7,-4
8755,5,83,27569,18,1,0,1,33,-3
8757,62,84,11475,3,2,1,1,2,4
8758,56,77,12403,60,11,6,5,35,-8
8759,59,77,12403,63,15,9,6,54,0
8760,62,77,12403,81,17,7,10,41,-6
8761,65,69,12403,82,13,6,7,57,-20
8762,68,69,12403,8,0,0,0,9,1
8763,68,74,12403,34,0,0,0,18,-2
8764,71,74,12403,1,0,0,0,0,-2
8765,56,79,13392,2,0,0,0,0,0
8766,59,79,13392,12,3,0,3,2,8
8767,62,79,13392,47,17,3,14,48,11
8768,65,79,13392,34,5,1,4,13,3
8769,68,79,13392,3,0,0,0,0,-2
8770,68,1479,13392,32,10,0,10,29,6
8772,74,1479,13392,40,11,1,10,17,3
8773,74,79,13392,20,3,1,2,8,-7
8774,77,79,13392,66,10,4,6,30,9
8775,80,72,13392,82,7,1,6,39,-7
8776,83,72,13392,57,8,2,6,25,7
8777,86,72,13392,51,7,2,5,33,1
8778,86,70,13392,20,2,0,2,4,-2
8779,29,85,22060,21,2,1,1,10,-3
8780,56,76,11433,7,1,1,0,0,-3
8781,65,81,11433,16,5,2,3,4,2
8782,68,79,11433,1,0,0,0,0,0
8783,71,83,11433,28,9,4,5,4,-3
8784,74,83,11433,54,5,2,3,12,-9
8785,80,73,11433,1,0,0,0,0,0
8786,68,72,13427,2,1,0,1,0,1
8787,5,86,60924,61,11,7,4,217,-21
8789,11,86,60924,81,21,13,8,222,-13
8790,14,86,60924,48,7,4,3,117,-8
8791,17,86,60924,78,16,12,4,192,-4
8792,20,63,60924,80,15,7,8,197,-15
8793,23,64,60924,68,13,5,8,213,5
8794,26,64,60924,75,5,2,3,259,-3
8795,29,64,60924,62,3,1,2,162,-7
8799,59,80,14188,2,0,0,0,0,-4
8800,62,80,14188,9,1,0,1,0,3
8801,65,62,14188,47,11,2,9,12,-1
8802,68,62,14188,22,1,0,1,10,-5
8803,71,62,14188,14,1,0,1,2,-10
8804,11,71,42967,10,3,1,2,4,-1
8805,14,71,42967,26,13,11,2,8,-14
8806,14,84,42967,12,7,5,2,2,2
8807,17,84,42967,56,39,16,23,42,2
8809,20,1479,42967,28,13,6,7,22,-12
8810,20,79,42967,7,0,0,0,4,-4
8811,5,62,30062,1,0,0,0,0,-2
8812,83,64,159476,10,3,1,2,12,2
8813,53,88,14177,10,3,1,2,0,2
8814,56,88,14177,40,16,4,12,4,-4
8815,59,88,14177,41,6,3,3,4,-1
8816,59,81,14177,19,9,3,6,6,-8
8817,62,81,14177,81,51,17,34,10,5
8818,65,81,14177,81,65,24,41,16,9
8819,68,81,14177,48,36,11,25,12,-1
8820,71,81,14177,81,42,12,30,14,-3
8821,74,71,14177,82,34,12,22,24,-33
8822,77,71,14177,61,32,11,21,10,-9
8823,77,68,14177,15,11,3,8,2,-2
8824,80,88,14177,12,2,0,2,0,0
8826,83,68,117437,51,22,11,11,6,4
8827,86,68,117437,50,16,7,9,14,-10
8828,62,65,14510,1,0,0,0,0,1
8829,65,80,14510,15,2,0,2,2,0
8832,74,87,14510,19,3,3,0,4,3
8833,74,79,14510,10,3,1,2,0,0
8834,74,71,14510,40,3,1,2,23,-7
8835,77,71,14510,14,1,1,0,6,-6
8836,5,62,68910,50,9,2,7,24,-4
8837,8,80,68910,34,4,0,4,12,-21
8840,53,73,7581,1,0,0,0,0,-1
8841,56,73,7581,53,7,2,5,10,-1
8842,2,85,27765,2,1,0,1,0,0
8843,8,71,27765,4,3,2,1,4,2
8844,11,81,27765,22,6,3,3,8,-4
8845,2,65,409554,23,4,2,2,6,-1
8849,5,85,32239,79,29,7,22,118,39
8850,8,85,32239,60,15,1,14,71,21
8855,53,64,7284,63,28,8,20,16,6
8856,53,65,403,18,4,0,4,4,-5
8857,53,68,403,27,10,0,10,14,0
8858,68,81,12524,38,19,7,12,14,-6
8859,71,81,12524,82,41,17,24,63,8
8860,74,81,12524,71,38,15,23,36,8
8861,77,81,12524,81,40,14,26,44,14
8862,80,81,12524,81,36,19,17,66,-9
8863,83,81,12524,82,47,15,32,45,22
8864,86,81,12524,82,40,18,22,45,22
8865,2,76,73606,52,12,6,6,10,-14
8866,5,76,73606,33,9,7,2,15,-4
8732,80,71,11422,78,35,16,19,17,-2
8733,83,71,11422,60,19,8,11,10,-17
8871,80,72,15033,11,0,0,0,12,-2
8872,56,89,10425,30,5,1,4,2,-1
8873,59,89,10425,21,5,0,5,8,-2
8874,62,89,10425,82,12,2,10,24,14
8875,65,89,10425,82,17,1,16,29,12
8876,68,89,10425,48,5,1,4,14,-6
8877,71,89,10425,82,18,2,16,26,-7
8878,74,89,10425,82,21,5,16,20,14
8879,77,89,10425,82,21,4,17,26,14
8880,80,89,10425,82,13,3,10,28,23
8881,83,75,10425,82,12,1,11,40,-7
8882,86,75,10425,9,1,0,1,2,1
8883,59,69,12577,3,0,0,0,0,-2
8884,62,69,12577,22,3,0,3,6,-4
8885,65,69,12577,47,9,1,8,54,-13
8886,68,69,12577,36,3,0,3,40,-9
8888,74,69,12577,13,0,0,0,7,-6
8889,74,82,12577,5,2,1,1,7,-3
8890,77,82,12577,24,4,0,4,17,2
8891,80,67,12577,52,8,0,8,29,-3
8892,83,67,12577,46,2,1,1,28,-16
8893,86,80,12577,10,0,0,0,11,-4
8894,59,70,15393,82,41,22,19,45,-1
8895,62,70,15393,69,56,22,34,52,-5
8896,65,70,15393,71,63,26,37,55,15
8897,68,70,15393,41,33,12,21,40,-12
8898,71,70,15393,81,79,34,45,64,21
8899,74,70,15393,82,87,35,52,64,1
8900,77,70,15393,82,89,41,48,64,7
8901,80,70,15393,77,69,26,43,66,-9
8902,83,70,15393,82,79,36,43,54,20
8903,86,70,15393,78,53,27,26,56,14
8905,59,79,11308,4,2,1,1,2,-1
8906,59,83,11308,19,6,1,5,10,0
8907,62,83,11308,7,0,0,0,4,-2
8908,59,72,12521,6,1,0,1,0,0
8909,62,72,12521,43,17,9,8,6,9
8910,65,72,12521,29,7,4,3,12,-7
8911,65,69,12521,9,0,0,0,2,-3
8912,62,63,12525,38,10,5,5,12,9
8913,65,63,12525,10,2,0,2,4,6
8914,65,69,12525,13,3,2,1,2,-7
8915,74,68,12525,25,4,2,2,12,-4
8916,77,68,12525,47,4,0,4,26,5
8917,80,68,12525,1,0,0,0,4,-1
8918,80,74,12525,10,2,1,1,2,-1
8919,83,74,12525,22,1,0,1,20,-7
8920,86,63,12525,35,6,3,3,22,-6
8922,59,64,12458,70,39,15,24,28,6
8923,62,64,12458,35,15,7,8,12,-6
8924,65,64,12458,55,14,8,6,47,-6
8925,65,86,12458,14,1,1,0,6,-2
8926,68,86,12458,36,14,5,9,14,1
8927,71,62,12458,62,17,4,13,21,-13
8928,74,547,12458,38,1,1,0,2,-8
8929,62,64,12460,3,0,0,0,4,-1
8930,80,73,22853,2,0,0,0,0,1
8931,71,1479,11390,2,2,2,0,2,3
8932,77,87,11390,5,0,0,0,7,-2
8933,71,64,14380,12,0,0,0,0,2
8934,74,64,14380,10,1,0,1,0,2
8935,77,89,14380,4,1,1,0,0,0
8936,80,89,14380,6,0,0,0,0,-2
8937,83,74,14380,60,14,7,7,20,-13
8939,86,63,14380,2,0,0,0,0,0
8940,59,1479,14681,9,2,1,1,6,0
8941,62,1479,14681,26,0,0,0,4,-3
8942,65,1479,14681,50,18,5,13,8,1
8943,68,1479,14681,27,13,5,8,8,-3
8944,71,1479,14681,77,49,22,27,22,14
8945,74,84,14681,75,39,15,24,22,7
8946,77,79,14681,63,29,9,20,31,13
8947,80,79,14681,80,37,18,19,16,-5
8948,83,73,14681,71,25,12,13,20,4
8949,86,73,14681,81,35,17,18,18,27
8950,71,547,11459,9,1,1,0,0,-3
8951,62,78,11473,26,4,1,3,35,6
8952,65,78,11473,26,6,1,5,22,7
8953,68,78,11473,15,1,0,1,10,-4
8954,71,78,11473,46,11,3,8,31,15
8956,74,79,11473,20,8,1,7,7,-2
8957,77,79,11473,70,12,0,12,59,-3
8958,80,79,11473,81,26,5,21,72,26
8959,83,79,11473,47,13,3,10,52,3
8960,83,82,11473,20,7,2,5,24,11
8961,86,64,11473,71,15,2,13,115,-1
8962,2,83,70463,13,3,0,3,25,0
8963,2,88,70463,56,13,8,5,115,6
8964,5,88,70463,73,24,5,19,100,0
8965,8,88,70463,49,7,2,5,80,-13
8966,8,74,70463,11,1,1,0,4,-1
8967,11,84,70463,62,9,3,6,38,-9
8968,14,84,70463,28,4,0,4,37,-3
8969,2,65,26591,77,9,4,5,151,8
8970,5,86,26591,62,4,3,1,70,-34
8971,5,85,26591,12,0,0,0,21,-3
8973,11,76,26591,3,0,0,0,5,0
8975,77,63,11454,3,1,0,1,0,-1
8976,17,63,63741,7,0,0,0,7,0
8977,20,63,63741,15,1,0,1,7,-4
8978,80,80,11315,3,0,0,0,6,0
8979,83,80,11315,24,10,6,4,8,-4
8981,2,65,71083,9,1,0,1,4,-2
8982,62,80,9316,6,0,0,0,2,-3
8983,65,80,9316,28,6,3,3,4,6
8984,68,80,9316,29,6,5,1,8,-2
8985,77,72,9316,4,0,0,0,2,-4
8986,83,80,9316,10,1,0,1,0,-1
8987,59,79,12508,1,0,0,0,0,0
8988,62,79,12508,15,3,1,2,10,-4
8868,71,71,15033,67,4,2,2,127,-8
8869,74,71,15033,40,3,2,1,43,-4
8993,74,75,12508,7,0,0,0,17,-3
8994,77,85,12508,1,0,0,0,0,0
8995,86,72,12508,6,1,0,1,0,-3
8996,2,85,32013,47,8,1,7,183,-15
8997,5,72,32013,80,33,17,16,246,6
8998,8,72,32013,73,22,11,11,206,0
8999,11,72,32013,78,27,12,15,244,24
9000,14,72,32013,33,12,5,7,44,10
9001,17,72,32013,76,21,11,10,145,7
9002,20,72,32013,77,27,9,18,109,15
9003,23,72,32013,74,48,24,24,86,30
9004,26,72,32013,70,37,17,20,143,10
9005,29,72,32013,67,39,16,23,80,8
9006,32,72,32013,77,43,23,20,50,3
9007,35,72,32013,55,13,6,7,65,2
9008,35,70,32013,14,5,1,4,7,2
9010,5,83,52537,47,24,14,10,58,-16
9011,8,83,52537,78,37,23,14,211,-2
9012,11,83,52537,67,30,12,18,189,-6
9013,14,89,52537,32,6,0,6,96,-6
9014,17,78,52537,27,10,6,4,54,4
9015,20,78,52537,18,3,1,2,37,-5
9016,8,86,71036,44,20,7,13,31,-16
9017,11,86,71036,74,25,6,19,31,3
9018,14,86,71036,47,16,5,11,31,-14
9019,17,86,71036,60,5,1,4,40,-9
9020,20,83,71036,15,3,1,2,9,0
9021,5,65,53031,9,2,0,2,20,1
9022,8,77,53031,72,13,3,10,238,9
9023,11,77,53031,50,4,1,3,112,-5
9024,14,77,53031,12,0,0,0,13,0
9025,14,71,53031,8,0,0,0,8,-4
9027,11,72,39240,1,0,0,0,2,0
9028,17,72,39240,6,3,2,1,0,1
9029,20,78,39240,54,18,8,10,35,12
9030,23,78,39240,80,29,8,21,62,14
9031,26,78,39240,80,41,20,21,42,1
9032,29,78,39240,80,23,8,15,48,9
9033,32,69,39240,58,39,11,28,45,6
9034,32,66,39240,19,5,0,5,6,-4
9035,35,63,39240,35,6,1,5,6,-6
9036,35,70,39240,33,8,3,5,15,-5
9037,38,70,39240,20,4,1,3,8,-3
9039,41,78,39240,2,0,0,0,2,-3
9040,62,64,11464,46,26,7,19,20,-11
9041,62,78,11464,26,17,2,15,16,7
9042,65,78,11464,81,43,9,34,60,20
9043,68,78,11464,48,23,5,18,20,2
9045,74,78,11464,56,44,8,36,52,19
9046,77,78,11464,72,44,14,30,51,-14
9047,80,78,11464,61,42,11,31,37,-11
9048,80,89,11464,19,14,2,12,10,4
9049,83,74,11464,46,23,5,18,44,-14
9050,86,74,11464,73,28,2,26,20,-15
9051,62,75,12510,3,0,0,0,2,1
9052,65,75,12510,38,5,1,4,8,1
9053,68,64,12510,25,9,2,7,8,-2
9054,71,66,12510,2,0,0,0,0,-1
9055,65,78,9306,5,1,0,1,0,-1
9056,65,1479,12059,2,0,0,0,2,0
9057,68,1479,12059,13,3,2,1,10,-1
9058,71,1479,12059,62,29,11,18,101,11
9059,74,1479,12059,71,34,9,25,82,-5
9060,77,1479,12059,56,13,4,9,54,-13
9062,80,71,12059,81,42,27,15,95,13
9063,83,71,12059,57,30,14,16,60,5
9064,83,72,12059,17,13,3,10,13,-4
9065,86,78,12059,74,28,10,18,64,-3
9066,65,84,9319,2,0,0,0,0,0
9067,68,84,9319,1,0,0,0,0,-1
9068,62,86,15028,28,11,2,9,2,-1
9069,65,86,15028,66,11,2,9,23,-2
9070,68,86,15028,41,7,0,7,6,-5
9071,71,86,15028,82,17,4,13,20,19
9072,74,86,15028,70,23,1,22,48,8
9073,77,86,15028,80,23,4,19,36,11
9074,80,86,15028,81,13,4,9,28,1
9075,83,86,15028,81,33,5,28,28,7
9076,86,86,15028,78,16,2,14,35,-14
9077,59,77,9318,78,35,15,20,30,-1
9079,65,77,9318,43,24,11,13,24,-1
9080,68,83,9318,48,32,18,14,26,-7
9081,71,83,9318,80,61,30,31,50,-9
9082,74,83,9318,82,56,27,29,43,-33
9083,77,83,9318,40,29,14,15,6,3
9084,80,83,9318,82,62,29,33,37,-2
9085,83,83,9318,81,54,36,18,30,1
9086,86,77,9318,66,48,27,21,18,-10
9087,62,67,15030,8,2,1,1,2,0
9088,65,62,15030,22,5,3,2,2,3
9089,68,62,15030,4,1,0,1,2,-2
9090,71,62,15030,47,21,7,14,27,6
9091,74,62,15030,57,19,6,13,8,-2
9092,77,75,15030,62,18,11,7,11,-9
9093,80,75,15030,81,43,22,21,29,21
9094,83,75,15030,82,35,20,15,23,-4
9098,8,83,70969,2,0,0,0,2,-1
9099,11,83,70969,9,2,1,1,36,1
9100,53,71,10423,79,49,13,36,23,-21
9101,56,71,10423,76,41,16,25,51,-1
9102,59,71,10423,68,41,15,26,33,-8
9103,62,71,10423,68,42,15,27,37,-17
9104,65,71,10423,75,47,18,29,36,5
9105,68,71,10423,48,38,14,24,23,-6
9106,71,71,10423,67,37,10,27,41,-29
9107,74,87,10423,81,41,15,26,28,-28
9108,77,77,10423,53,16,8,8,25,4
9109,80,82,10423,81,50,18,32,22,10
9110,83,84,10423,74,31,10,21,35,-18
9111,86,84,10423,7,3,1,2,4,-3
8990,68,79,12508,5,0,0,0,0,2
8991,68,547,12508,36,4,1,3,22,-4
9116,59,69,11676,7,1,1,0,9,-3
9117,62,69,11676,8,0,0,0,2,0
9118,65,69,11676,10,1,1,0,15,-5
9119,17,72,17052,12,3,2,1,8,5
9120,20,72,17052,1,0,0,0,0,0
9121,20,78,17052,53,12,4,8,45,-2
9122,23,78,17052,1,0,0,0,0,0
9123,26,78,17052,54,13,1,12,94,4
9124,29,78,17052,41,8,0,8,38,-2
9125,32,80,17052,33,9,1,8,35,8
9126,35,80,17052,34,9,2,7,42,3
9127,59,63,11051,1,1,0,1,0,1
9128,62,63,11051,3,1,0,1,0,1
9129,65,63,11051,16,2,0,2,4,3
9130,59,71,11703,4,1,0,1,2,1
9131,62,71,11703,3,0,0,0,11,-2
9133,62,83,12558,40,2,2,0,32,-1
9134,65,83,12558,17,2,0,2,16,-2
9135,65,81,12558,19,1,0,1,13,-5
9136,68,81,12558,45,7,2,5,60,1
9137,71,81,12558,15,1,0,1,9,-3
9138,74,71,12558,31,1,0,1,66,-3
9139,65,62,11114,2,3,2,1,12,3
9140,68,62,11114,5,0,0,0,14,-2
9142,65,547,11110,5,2,0,2,2,1
9143,68,66,14367,3,1,1,0,0,0
9144,71,66,14367,10,2,0,2,0,-4
9145,74,66,14367,57,20,11,9,14,-4
9146,77,66,14367,68,11,8,3,16,-12
9147,80,75,14367,14,4,2,2,4,-1
9152,11,70,14179,34,5,2,3,63,4
9153,11,79,14179,11,0,0,0,16,-5
9158,26,1479,14179,73,9,5,4,99,-18
9159,29,1479,14179,31,6,3,3,48,-5
9160,29,89,14179,30,3,1,2,16,0
9161,32,72,14179,53,4,2,2,119,0
9162,35,72,14179,67,8,3,5,123,0
9163,38,72,14179,76,12,4,8,88,3
9164,41,73,14179,61,4,1,3,88,-13
9165,59,86,11102,25,9,5,4,6,4
9166,62,86,11102,79,56,32,24,41,18
9167,65,86,11102,80,65,31,34,16,2
9168,68,86,11102,48,37,21,16,4,7
9169,71,86,11102,65,54,23,31,20,21
9170,74,86,11102,82,67,27,40,12,-6
9171,77,86,11102,52,36,15,21,20,2
9172,80,86,11102,73,52,25,27,12,11
9173,83,86,11102,78,61,34,27,18,-2
9175,59,75,11248,2,2,0,2,2,1
9176,62,75,11248,77,38,14,24,124,-8
9177,65,75,11248,81,36,7,29,119,9
9178,68,75,11248,42,38,11,27,57,12
9179,71,75,11248,82,53,10,43,81,-4
9180,74,75,11248,82,60,15,45,74,21
9181,77,75,11248,68,51,6,45,75,4
9182,80,73,11248,66,40,10,30,44,-8
9183,83,73,11248,82,59,16,43,82,18
9184,86,73,11248,63,31,9,22,60,5
9185,62,71,4003,51,27,5,22,26,-16
9186,65,71,4003,14,3,3,0,8,-5
9187,71,71,4003,1,0,0,0,0,-1
9188,71,67,4003,13,2,0,2,6,-5
9189,68,547,15031,5,2,0,2,14,1
9190,71,547,15031,53,5,2,3,65,-5
9192,77,547,15031,35,5,1,4,44,4
9193,83,89,15031,2,0,0,0,4,0
9194,86,62,15031,4,0,0,0,7,-1
9195,65,66,12504,5,1,0,1,2,1
9196,68,66,12504,32,9,4,5,8,-4
9197,71,66,12504,73,24,10,14,29,0
9198,74,66,12504,68,25,8,17,12,-10
9199,77,66,12504,64,22,9,13,18,-5
9200,80,63,12504,81,17,7,10,14,-1
9201,83,63,12504,76,41,15,26,18,16
9202,86,82,12504,78,12,3,9,19,-8
9203,62,76,11393,11,1,0,1,4,-9
9206,5,67,10951,5,0,0,0,2,-3
9207,5,76,10951,54,23,8,15,28,-8
9208,5,83,10951,11,3,1,2,4,1
9209,8,83,10951,66,18,14,4,30,-18
9211,14,80,10951,43,11,5,6,22,-26
9212,17,80,10951,1,1,0,1,2,0
9213,17,79,10951,18,6,2,4,4,-5
9214,20,76,10951,4,2,1,1,0,-2
9215,2,74,8503,1,0,0,0,0,-1
9216,11,88,8503,20,4,1,3,4,-2
9217,68,76,11613,39,4,1,3,8,9
9218,71,76,11613,82,22,4,18,34,5
9219,74,76,11613,81,22,2,20,26,-12
9220,77,76,11613,62,18,6,12,30,9
9221,80,76,11613,76,20,4,16,35,-1
9222,83,76,11613,69,25,5,20,24,20
9223,86,76,11613,40,4,0,4,33,5
9224,14,80,30948,15,1,0,1,6,-5
9225,17,80,30948,28,7,1,6,20,-8
9226,20,80,30948,66,10,5,5,91,2
9228,26,80,30948,50,9,3,6,33,7
9229,29,68,30948,62,8,3,5,44,7
9230,32,68,30948,68,3,1,2,42,-5
9231,35,68,30948,35,2,1,1,12,-14
9236,65,80,11340,49,29,12,17,27,12
9237,68,80,11340,48,29,12,17,24,6
9238,71,80,11340,82,58,26,32,39,22
9239,74,80,11340,82,64,24,40,36,5
9240,77,80,11340,57,30,13,17,32,-15
9241,80,80,11340,78,55,27,28,47,-3
9242,83,80,11340,11,9,3,6,2,-3
9243,83,73,11340,65,42,13,29,24,22
9244,86,73,11340,55,23,7,16,33,-6
9245,11,76,25739,12,1,0,1,4,-2
9113,11,1479,67314,32,12,3,9,39,4
9114,14,1479,67314,2,0,0,0,0,0
9250,14,67,29311,47,22,3,19,12,-4
9251,17,67,29311,76,56,23,33,28,-4
9252,20,67,29311,82,53,27,26,24,14
9253,23,67,29311,72,34,13,21,26,8
9254,26,67,29311,41,15,4,11,12,3
9255,26,70,29311,10,5,2,3,4,1
9256,29,70,29311,16,2,1,1,2,-4
9257,29,65,29311,17,2,1,1,2,-1
9258,32,77,29311,12,3,1,2,4,0
9259,2,75,72027,64,43,22,21,56,6
9260,5,75,72027,78,31,16,15,63,6
9262,11,70,72027,79,35,20,15,36,8
9264,65,547,15043,3,0,0,0,0,0
9265,68,547,15043,34,9,4,5,6,-5
9266,71,547,15043,20,3,1,2,8,1
9267,74,547,15043,42,6,2,4,16,1
9269,80,547,15043,65,14,1,13,15,3
9270,83,63,15043,14,1,0,1,2,-2
9271,2,72,22483,78,78,45,33,150,8
9272,8,72,22483,80,48,24,24,102,-6
9273,11,72,22483,80,70,37,33,95,30
9274,14,72,22483,46,29,17,12,32,13
9275,17,72,22483,76,48,20,28,91,3
9276,20,72,22483,80,54,29,25,49,11
9277,23,72,22483,26,11,3,8,14,-6
9278,23,86,22483,51,32,13,19,28,0
9279,26,74,22483,82,55,28,27,46,5
9280,29,74,22483,77,42,18,24,52,-2
9281,32,74,22483,2,0,0,0,0,-2
9282,32,70,22483,28,6,4,2,17,0
9283,35,70,22483,20,6,3,3,17,-1
9286,8,81,14033,14,5,2,3,71,-3
9288,11,78,14033,40,3,1,2,103,-7
9289,14,78,14033,21,5,0,5,72,4
9290,17,78,14033,18,2,1,1,40,-5
9291,20,65,14033,8,0,0,0,12,-2
9292,56,62,11394,3,1,0,1,2,-2
9293,62,69,13585,4,2,1,1,0,1
9294,65,69,13585,11,3,1,2,11,1
9295,71,69,13585,1,0,0,0,0,0
9296,62,81,2345,10,3,1,2,2,-2
9297,8,71,3640,40,19,13,6,25,-2
9298,11,71,3640,28,8,3,5,8,3
9299,14,77,3640,44,10,3,7,33,-2
9300,17,77,3640,79,25,15,10,89,25
9301,20,77,3640,82,32,14,18,41,7
9302,23,77,3640,82,24,11,13,53,8
9303,26,77,3640,14,1,1,0,0,-2
9305,29,64,3640,75,19,11,8,29,12
9306,32,64,3640,82,32,15,17,68,7
9307,35,64,3640,41,12,6,6,39,0
9308,35,78,3640,23,6,2,4,2,2
9309,38,78,3640,68,10,4,6,28,7
9310,65,64,12177,9,2,0,2,0,1
9311,68,64,12177,13,2,1,1,16,-7
9312,71,64,12177,32,5,3,2,23,-4
9313,74,66,12177,65,15,7,8,74,-8
9314,77,66,12177,57,6,2,4,75,-11
9315,83,71,12177,7,0,0,0,6,0
9316,86,71,12177,16,0,0,0,4,0
9317,11,75,360,47,14,2,12,26,10
9318,14,75,360,33,5,0,5,8,-10
9319,17,75,360,76,14,2,12,69,21
9320,20,75,360,78,14,1,13,32,9
9322,26,74,360,68,5,1,4,40,-12
9323,29,79,360,54,6,1,5,30,-8
9324,32,63,360,60,7,1,6,48,-5
9325,65,85,12498,14,7,1,6,13,3
9326,68,85,12498,34,8,0,8,36,1
9327,71,85,12498,71,19,5,14,68,-2
9328,74,85,12498,76,13,4,9,68,-2
9329,77,85,12498,63,15,3,12,62,1
9330,80,85,12498,33,5,2,3,34,-1
9331,80,74,12498,18,4,1,3,29,2
9332,83,74,12498,44,8,1,7,69,2
9333,86,74,12498,63,13,4,9,71,-7
9334,2,88,21355,61,39,7,32,221,48
9335,5,88,21355,71,29,7,22,268,-13
9336,8,88,21355,81,41,15,26,399,1
9337,11,79,21355,47,21,3,18,139,-9
9339,14,88,21355,41,21,3,18,83,-14
9340,17,88,21355,59,31,10,21,148,-14
9341,17,74,21355,9,2,0,2,21,-6
9342,20,86,21355,57,16,4,12,186,-6
9343,23,86,21355,56,12,2,10,140,10
9344,26,71,21355,46,5,2,3,101,-5
9345,29,63,21355,27,5,2,3,62,2
9346,56,66,9334,50,6,1,5,16,-1
9347,59,66,9334,72,40,21,19,2,-1
9348,62,66,9334,82,29,14,15,25,13
9349,65,66,9334,82,32,17,15,21,-3
9350,68,79,9334,48,19,11,8,4,3
9351,71,79,9334,81,26,13,13,12,-9
9352,74,79,9334,80,33,21,12,14,6
9353,77,84,9334,20,9,5,4,2,3
9354,80,84,9334,81,34,17,17,12,-20
9356,86,84,9334,26,6,4,2,6,-12
9357,56,72,12554,1,1,0,1,0,-1
9358,59,72,12554,20,2,1,1,2,-4
9359,62,73,12554,27,12,4,8,2,5
9360,65,73,12554,73,28,15,13,27,9
9361,68,73,12554,36,11,5,6,10,1
9362,71,547,12554,46,10,5,5,6,-3
9363,74,547,12554,47,8,3,5,6,5
9364,77,547,12554,30,3,0,3,4,1
9365,62,81,11635,78,15,6,9,12,-5
9366,65,81,11635,26,5,0,5,6,-5
9367,68,81,11635,21,4,1,3,4,-3
9368,71,81,11635,7,0,0,0,4,0
9369,74,82,11635,3,0,0,0,0,-1
9247,20,76,25739,67,13,4,9,75,-6
9248,23,76,25739,7,1,0,1,6,-1
9374,71,73,12459,71,32,13,19,14,2
9375,74,79,12459,82,27,9,18,26,-2
9376,77,83,12459,35,7,1,6,18,-7
9377,77,86,12459,23,6,2,4,6,5
9378,62,70,12568,1,0,0,0,0,-1
9379,68,70,12568,1,1,0,1,0,-1
9380,71,70,12568,26,12,8,4,4,-3
9381,74,70,12568,71,26,9,17,13,1
9382,77,70,12568,71,23,11,12,21,6
9383,80,68,12568,80,24,9,15,25,-16
9384,83,68,12568,76,24,11,13,24,6
9385,86,68,12568,59,15,5,10,15,-2
9386,62,88,12535,6,0,0,0,2,-2
9387,65,88,12535,27,14,5,9,10,3
9388,68,88,12535,47,10,4,6,11,-3
9389,71,88,12535,77,30,15,15,18,16
9391,77,88,12535,47,13,7,6,24,-6
9392,80,88,12535,63,15,8,7,10,0
9393,80,75,12535,17,1,1,0,2,-2
9394,53,78,11119,62,27,13,14,38,16
9395,56,78,11119,81,50,15,35,50,13
9396,59,78,11119,82,47,20,27,60,-10
9397,62,78,11119,10,7,5,2,12,7
9398,65,78,11119,57,42,21,21,28,19
9399,68,78,11119,48,25,10,15,44,0
9400,71,71,11119,78,57,28,29,90,-16
9401,74,71,11119,38,19,5,14,20,-17
9402,74,79,11119,43,22,12,10,42,-8
9403,77,79,11119,43,16,4,12,28,-13
9404,77,1479,11119,28,20,8,12,34,12
9405,80,78,11119,82,46,18,28,54,-2
9406,83,20120,11119,70,66,16,50,50,1
9408,17,88,73226,33,5,3,2,104,-7
9409,20,88,73226,26,5,3,2,93,-8
9410,23,86,73226,9,1,0,1,30,1
9411,29,75,5367,74,16,3,13,38,-7
9412,32,75,5367,29,6,0,6,26,3
9413,35,75,5367,28,5,0,5,33,-5
9414,38,73,5367,4,0,0,0,2,-1
9415,38,75,5367,20,4,3,1,2,-1
9416,41,75,5367,73,18,2,16,70,1
9417,47,75,5367,67,22,3,19,34,-6
9418,50,75,5367,62,14,3,11,52,-10
9419,53,75,5367,74,8,2,6,61,9
9420,56,75,5367,54,9,5,4,53,-7
9421,59,73,5367,81,11,3,8,50,5
9422,62,73,5367,44,10,1,9,27,-3
9423,65,73,5367,66,11,4,7,33,-4
9425,71,75,5367,52,6,2,4,34,-5
9426,2,78,77162,24,4,3,1,6,0
9427,65,67,12184,11,1,1,0,6,0
9428,68,67,12184,10,1,1,0,6,-1
9429,68,68,12184,19,9,2,7,2,-8
9430,74,83,12184,6,1,0,1,9,-7
9431,77,83,12184,7,1,1,0,6,-6
9432,56,88,5501,40,15,7,8,16,-3
9433,59,88,5501,34,7,4,3,4,-6
9434,62,88,5501,13,4,1,3,2,-1
9435,2,77,8565,74,41,20,21,155,8
9436,5,71,8565,80,50,23,27,197,5
9437,8,71,8565,69,32,15,17,147,-4
9438,11,68,8565,80,60,30,30,149,0
9439,14,68,8565,48,25,13,12,90,-16
9440,17,68,8565,79,70,32,38,160,4
9442,23,68,8565,79,39,15,24,127,-14
9443,26,68,8565,67,45,18,27,85,5
9444,29,68,8565,77,46,18,28,126,14
9445,32,68,8565,40,13,4,9,46,-13
9446,32,78,8565,23,8,7,1,25,0
9447,35,78,8565,64,41,15,26,93,-5
9448,38,78,8565,80,57,26,31,176,1
9449,41,78,8565,68,31,14,17,76,-7
9452,74,84,11425,7,1,1,0,0,-2
9453,77,84,11425,51,7,0,7,22,-11
9454,80,84,11425,36,3,0,3,18,-4
9455,83,84,11425,44,9,1,8,32,3
9456,86,84,11425,41,16,2,14,22,0
9457,56,69,11100,45,7,2,5,18,-2
9458,62,69,11100,7,1,1,0,2,-2
9459,65,69,11100,37,2,0,2,10,-5
9461,68,82,11100,27,2,1,1,17,1
9462,59,83,2618,43,15,3,12,10,8
9463,62,83,2618,68,20,4,16,14,-2
9464,65,83,2618,76,19,4,15,20,-9
9465,68,83,2618,37,15,1,14,14,5
9466,71,83,2618,80,17,3,14,34,12
9467,74,78,2618,61,12,2,10,2,10
9468,77,78,2618,72,9,3,6,31,7
9469,80,78,2618,56,6,0,6,4,-5
9470,83,78,2618,63,9,5,4,22,15
9471,86,78,2618,25,7,3,4,6,8
9472,65,71,11847,1,0,0,0,0,0
9473,65,67,12182,34,8,3,5,20,0
9474,71,67,12182,9,1,0,1,0,-8
9475,71,82,12182,44,10,2,8,37,11
9476,74,82,12182,61,8,1,7,76,-14
9478,5,86,76689,8,3,3,0,0,2
9479,8,86,76689,14,7,2,5,4,-4
9480,83,87,4401,18,4,2,2,4,-1
9481,86,87,4401,52,9,4,5,18,5
9482,56,75,10613,3,1,0,1,2,-1
9483,59,75,10613,5,0,0,0,4,-5
9484,62,75,10613,41,11,1,10,14,0
9485,65,75,10613,60,18,4,14,30,-7
9486,68,75,10613,6,2,0,2,2,-1
9487,71,84,10613,49,10,6,4,16,-7
9488,74,84,10613,65,21,11,10,30,4
9489,77,84,10613,45,7,0,7,24,-17
9490,80,73,10613,73,8,1,7,25,1
9491,83,73,10613,47,5,2,3,16,2
9371,62,73,12459,74,14,8,6,20,-10
9372,65,73,12459,77,22,10,12,18,-7
9496,59,66,12517,9,2,2,0,4,-1
9497,62,66,12517,23,1,0,1,12,0
9498,65,66,12517,37,13,6,7,4,2
9499,68,66,12517,37,5,3,2,17,-7
9500,71,66,12517,70,12,4,8,16,-2
9501,74,75,12517,3,0,0,0,0,0
9502,56,79,11106,14,3,1,2,0,4
9503,59,79,11106,1,0,0,0,0,0
9504,62,79,11106,25,12,7,5,4,5
9505,65,79,11106,26,6,4,2,2,-4
9506,68,79,11106,24,6,3,3,2,1
9507,71,79,11106,10,1,0,1,2,-2
9508,71,70,11106,24,3,2,1,0,-2
9509,77,87,11106,7,2,1,1,2,2
9510,65,1479,12513,29,4,1,3,18,-4
9511,53,65,9321,82,72,21,51,52,-5
9513,59,65,9321,82,88,30,58,20,16
9514,62,65,9321,73,73,27,46,28,7
9515,65,65,9321,82,66,23,43,40,7
9516,68,65,9321,47,55,23,32,8,11
9517,71,65,9321,69,69,29,40,22,7
9518,74,65,9321,61,64,27,37,10,10
9519,77,65,9321,82,106,46,60,30,17
9520,80,65,9321,82,89,34,55,32,11
9521,83,65,9321,82,76,27,49,32,-20
9522,86,65,9321,81,110,44,66,22,2
9523,26,84,8544,30,2,0,2,27,-12
9524,29,84,8544,51,12,5,7,39,3
9525,32,84,8544,81,27,14,13,94,5
9526,35,84,8544,82,33,13,20,111,4
9527,38,84,8544,82,42,15,27,82,21
9528,41,84,8544,53,23,11,12,73,5
9530,50,84,8544,81,30,10,20,64,0
9531,53,84,8544,61,16,7,9,64,-4
9532,53,89,8544,17,7,3,4,27,5
9533,56,79,8544,76,31,13,18,101,0
9534,59,79,8544,79,30,15,15,106,17
9535,62,79,8544,67,30,12,18,129,14
9536,65,79,8544,82,38,19,19,44,5
9537,68,79,8544,48,21,8,13,36,-2
9538,71,69,8544,82,28,10,18,54,8
9539,74,69,8544,29,10,4,6,13,0
9540,65,73,11421,1,0,0,0,0,0
9541,65,79,12516,6,0,0,0,2,1
9542,68,79,12516,15,4,2,2,27,3
9543,71,79,12516,54,10,0,10,74,-3
9544,74,79,12516,38,6,2,4,68,-6
9545,74,78,12516,13,2,1,1,25,-3
9547,80,78,12516,38,4,1,3,15,11
9548,83,78,12516,72,13,4,9,41,11
9549,86,78,12516,59,10,2,8,47,9
9550,8,84,6673,1,1,0,1,2,0
9553,65,547,12500,13,9,2,7,7,8
9554,2,71,21311,53,64,12,52,34,15
9555,5,74,21311,79,107,35,72,76,31
9556,8,74,21311,75,91,25,66,72,-6
9557,11,74,21311,76,84,26,58,76,25
9558,14,74,21311,46,53,14,39,40,8
9559,17,74,21311,74,99,47,52,122,29
9560,20,74,21311,71,84,36,48,88,12
9561,23,84,21311,82,60,22,38,58,-10
9562,26,84,21311,59,48,13,35,33,-12
9563,29,84,21311,66,54,17,37,30,-15
9564,32,74,21311,82,67,24,43,89,-25
9566,38,74,21311,78,40,18,22,30,-2
9567,41,74,21311,76,43,18,25,42,3
9568,59,68,11853,4,0,0,0,0,-1
9569,62,68,11853,36,17,8,9,14,0
9570,65,68,11853,15,3,2,1,2,-4
9571,83,68,11853,74,65,28,37,8,10
9572,86,68,11853,82,70,28,42,8,-6
9573,62,74,11453,40,9,1,8,14,16
9574,65,74,11453,82,32,7,25,44,25
9575,68,74,11453,47,19,4,15,22,13
9576,71,74,11453,77,43,14,29,36,11
9577,74,74,11453,71,33,8,25,26,23
9578,77,74,11453,73,34,9,25,22,26
9579,80,74,11453,77,42,6,36,37,20
9580,83,74,11453,49,26,2,24,20,7
9581,83,81,11453,14,3,2,1,0,1
9583,23,74,67483,38,5,2,3,114,4
9584,26,74,67483,5,0,0,0,6,-1
9585,29,74,67483,11,1,0,1,11,1
9586,32,75,67483,20,3,1,2,32,-1
9587,32,77,67483,31,4,1,3,78,-2
9588,35,63,67483,58,3,0,3,122,-2
9589,38,63,67483,71,10,1,9,160,-5
9590,41,63,67483,1,0,0,0,0,0
9591,56,68,10478,5,2,2,0,2,1
9592,59,68,10478,19,5,3,2,6,1
9593,62,68,10478,31,8,2,6,22,-6
9594,65,68,10478,17,5,2,3,6,-3
9595,59,73,4020,22,3,1,2,4,-5
9596,62,73,4020,3,0,0,0,2,-1
9597,56,75,12461,34,11,3,8,27,-3
9598,59,75,12461,52,14,3,11,20,-5
9600,65,75,12461,79,65,33,32,56,2
9601,68,75,12461,44,39,15,24,28,8
9602,71,75,12461,73,60,39,21,35,8
9603,74,75,12461,80,67,37,30,32,38
9604,77,75,12461,82,64,30,34,34,-10
9605,80,75,12461,81,67,35,32,38,15
9606,83,75,12461,64,37,17,20,30,-16
9607,86,20120,12461,66,40,22,18,36,-13
9608,56,62,4288,1,0,0,0,0,0
9609,59,62,4288,23,10,1,9,6,5
9610,62,62,4288,73,25,10,15,18,4
9611,65,62,4288,41,11,4,7,16,-13
9612,68,62,4288,32,16,8,8,29,-6
9613,71,62,4288,76,39,18,21,32,4
9493,68,66,14733,8,2,0,2,7,-2
9494,71,66,14733,64,8,2,6,45,-1
9618,86,62,4288,77,47,21,26,52,34
9619,38,65,4513,2,0,0,0,0,-1
9620,41,65,4513,76,31,11,20,54,-11
9621,47,64,4513,82,40,9,31,51,-7
9622,50,64,4513,78,35,15,20,36,8
9623,53,68,4513,67,37,14,23,34,-5
9624,56,68,4513,80,19,7,12,29,-12
9625,56,82,9277,80,38,9,29,44,11
9626,59,82,9277,81,50,16,34,26,-7
9627,62,82,9277,80,46,14,32,26,-3
9628,65,77,9277,78,49,18,31,32,11
9629,68,77,9277,48,46,22,24,35,-7
9630,71,77,9277,82,62,23,39,22,11
9631,74,77,9277,82,81,22,59,78,1
9632,77,77,9277,73,55,11,44,38,-5
9633,80,77,9277,82,61,20,41,56,-24
9635,86,77,9277,78,66,20,46,25,-16
9636,62,88,13619,11,1,0,1,0,-2
9637,68,88,13619,45,16,7,9,35,16
9638,71,88,13619,76,24,5,19,58,8
9639,74,88,13619,76,41,10,31,22,-4
9640,77,88,13619,82,40,8,32,64,7
9641,80,88,13619,82,28,9,19,46,-21
9642,83,88,13619,74,42,8,34,40,10
9643,86,88,13619,50,21,4,17,33,10
9644,86,83,13619,30,16,5,11,14,11
9645,65,77,12506,10,0,0,0,8,-1
9646,65,89,12506,0,0,0,0,0,0
9647,62,73,11592,23,8,3,5,8,8
9648,65,73,11592,33,7,3,4,6,-14
9649,68,73,11592,35,7,1,6,6,-1
9650,71,69,11592,15,1,0,1,0,-1
9652,2,71,31017,3,1,1,0,2,0
9653,59,88,12530,4,0,0,0,2,-2
9654,62,88,12530,60,16,5,11,18,11
9655,65,88,12530,51,12,6,6,8,-1
9656,68,88,12530,27,5,1,4,10,-2
9657,71,88,12530,61,22,11,11,14,17
9658,74,88,12530,56,22,6,16,10,9
9659,77,88,12530,78,31,10,21,40,16
9660,80,88,12530,82,39,9,30,24,-17
9661,83,88,12530,77,25,9,16,34,3
9662,86,88,12530,60,18,4,14,8,-2
9663,26,68,10953,5,0,0,0,2,-1
9666,35,84,10953,18,5,3,2,2,0
9667,65,85,976,5,0,0,0,0,1
9668,68,85,976,38,8,3,5,8,2
9669,71,85,976,65,17,8,9,12,-11
9671,77,85,976,29,3,1,2,6,1
9672,11,77,729594,83,82,38,44,36,8
9673,14,77,729594,47,57,26,31,20,20
9674,17,77,729594,51,43,23,20,45,8
9675,20,77,729594,77,59,22,37,65,36
9676,23,81,729594,68,38,16,22,34,-37
9677,26,81,729594,20,12,4,8,4,-2
9678,26,77,729594,46,26,11,15,14,7
9679,29,77,729594,62,29,8,21,30,-1
9681,35,83,729594,71,52,14,38,36,11
9682,38,83,729594,67,35,14,21,36,5
9683,41,83,729594,59,25,12,13,50,-1
9684,38,65,11336,13,2,1,1,31,-4
9685,41,65,11336,8,1,1,0,23,2
9686,47,65,11336,10,0,0,0,16,-5
9687,50,1479,11336,48,9,2,7,88,3
9689,56,63,11336,79,11,6,5,123,-2
9690,59,63,11336,74,10,1,9,141,-9
9691,62,63,11336,79,20,10,10,122,8
9692,65,63,11336,81,13,5,8,154,-7
9693,68,63,11336,45,7,3,4,60,1
9694,71,63,11336,64,8,5,3,74,3
9695,74,68,11336,46,5,1,4,50,-13
9696,77,68,11336,50,5,1,4,80,-2
9697,80,68,11336,50,4,2,2,67,-7
9698,26,71,27421,17,5,2,3,20,-1
9699,29,78,27421,56,25,4,21,32,18
9700,32,78,27421,38,6,2,4,43,-2
9703,23,62,18320,1,0,0,0,0,0
9704,29,62,18320,7,3,3,0,0,0
9705,35,78,18320,52,12,5,7,26,4
9706,38,78,18320,3,0,0,0,0,1
9708,68,74,4564,48,24,10,14,18,10
9709,71,74,4564,72,33,17,16,44,8
9710,74,74,4564,82,35,17,18,46,18
9711,77,1479,4564,43,12,4,8,14,-10
9712,77,79,4564,37,27,10,17,18,18
9713,80,79,4564,61,22,6,16,16,10
9714,83,79,4564,81,31,10,21,28,8
9715,86,79,4564,16,3,1,2,12,2
9716,86,88,4564,22,5,1,4,8,-2
9717,86,89,4564,20,11,3,8,10,7
9718,56,77,17715,12,3,1,2,0,-2
9719,59,77,17715,10,2,0,2,0,-2
9720,2,74,27639,4,4,3,1,0,1
9721,5,74,27639,11,5,1,4,10,-1
9722,5,88,27639,46,41,20,21,44,3
9723,8,88,27639,42,39,23,16,42,16
9725,14,72,27639,17,5,2,3,8,2
9726,14,70,27639,28,18,3,15,28,4
9727,17,70,27639,13,7,3,4,8,0
9728,17,62,27639,31,14,4,10,10,8
9729,20,62,27639,61,26,11,15,32,-19
9730,2,74,27823,63,44,17,27,63,1
9731,2,85,27823,11,7,5,2,4,-4
9732,5,85,27823,80,46,20,26,53,6
9733,8,89,27823,10,3,0,3,35,-4
9734,8,78,27823,72,46,24,22,65,6
9735,11,78,27823,75,48,23,25,83,6
9736,14,78,27823,15,7,2,5,0,4
9737,14,86,27823,21,13,6,7,13,0
9738,17,86,27823,68,42,22,20,41,-8
9615,77,62,4288,82,47,21,26,28,10
9616,80,62,4288,81,53,22,31,36,9
9743,29,80,27823,9,5,3,2,2,1
9744,41,85,27823,4,2,0,2,0,2
9745,29,63,9134,1,0,0,0,0,0
9746,32,65,9134,3,0,0,0,6,-1
9747,35,65,9134,36,1,1,0,76,-2
9748,38,70,9134,43,2,1,1,69,1
9749,41,70,9134,37,2,1,1,77,2
9750,47,78,9134,17,2,2,0,45,0
9751,47,75,9134,25,5,1,4,50,2
9752,50,75,9134,21,1,1,0,48,-6
9753,53,85,9134,56,3,0,3,116,0
9754,56,85,9134,4,2,1,1,7,0
9755,2,67,26450,13,0,0,0,67,-1
9756,5,67,26450,42,5,1,4,192,-5
9757,8,80,26450,11,0,0,0,42,-5
9758,11,62,26450,8,1,0,1,14,-2
9760,8,81,41510,3,0,0,0,0,-3
9761,8,63,41510,21,5,1,4,18,-6
9762,11,68,41510,2,1,0,1,0,-1
9763,14,68,41510,1,0,0,0,2,0
9764,59,68,9332,22,0,0,0,2,-1
9765,62,68,9332,54,12,2,10,22,-15
9766,65,68,9332,40,5,0,5,10,-3
9767,68,68,9332,9,0,0,0,36,-2
9768,68,88,9332,35,3,0,3,16,5
9769,71,547,9332,51,6,2,4,2,4
9770,74,547,9332,1,1,0,1,0,-1
9771,17,74,261,4,1,0,1,0,2
9772,20,63,261,50,18,5,13,32,-7
9773,26,76,261,72,24,6,18,34,-4
9774,29,75,261,23,2,0,2,8,-5
9775,32,75,261,2,0,0,0,2,-1
9777,59,88,12515,78,40,16,24,116,22
9778,62,88,12515,80,30,14,16,75,-2
9779,65,77,12515,82,49,28,21,114,-1
9780,68,77,12515,45,32,15,17,82,-7
9781,71,77,12515,82,60,29,31,106,-4
9782,74,77,12515,75,50,28,22,66,-5
9783,77,77,12515,81,60,32,28,147,-7
9784,80,77,12515,82,54,31,23,122,-18
9785,83,77,12515,75,46,24,22,57,-16
9786,86,77,12515,62,27,16,11,90,-20
9787,86,73,12515,17,3,1,2,9,4
9788,59,78,5995,7,2,2,0,4,2
9789,62,75,5995,77,17,7,10,48,-4
9790,65,75,5995,79,28,16,12,66,-5
9791,68,75,5995,46,30,8,22,45,8
9792,71,75,5995,77,26,12,14,68,-15
9794,77,75,5995,79,26,13,13,28,-13
9795,80,89,5995,81,25,12,13,36,15
9796,83,89,5995,81,38,18,20,38,-6
9797,86,89,5995,81,36,13,23,37,-1
9798,62,83,12533,1,0,0,0,0,-1
9799,65,83,12533,56,15,8,7,25,-4
9800,68,83,12533,25,13,7,6,4,6
9801,71,88,12533,40,6,2,4,11,-6
9802,71,82,12533,4,1,0,1,0,2
9803,74,83,12533,9,0,0,0,4,0
9804,20,63,3584,3,0,0,0,0,1
9805,56,82,12462,3,0,0,0,0,0
9806,59,82,12462,4,0,0,0,0,-1
9807,62,82,12462,5,1,1,0,0,0
9808,65,82,12462,10,2,1,1,2,-3
9809,2,89,27133,80,50,24,26,29,10
9811,8,89,27133,84,45,18,27,32,-2
9812,11,89,27133,84,39,14,25,32,8
9813,14,89,27133,48,23,10,13,6,5
9814,17,89,27133,74,20,7,13,30,7
9815,20,89,27133,77,24,10,14,33,4
9816,23,89,27133,76,14,7,7,41,-2
9817,26,89,27133,62,7,2,5,29,-5
9818,11,78,17094,1,0,0,0,2,0
9819,14,78,17094,19,11,6,5,10,2
9820,17,78,17094,28,7,1,6,12,-7
9821,17,71,17094,6,6,2,4,6,0
9822,20,84,17094,58,27,10,17,51,11
9823,23,84,17094,13,2,1,1,4,-1
9824,65,81,14326,14,2,0,2,15,-2
9825,68,81,14326,19,3,2,1,30,2
9826,71,81,14326,13,0,0,0,20,-4
9828,5,88,47097,67,11,4,7,249,-8
9829,62,82,11694,5,0,0,0,0,0
9830,68,82,11694,2,0,0,0,0,1
9831,71,64,11694,54,25,10,15,22,12
9832,74,64,11694,78,14,5,9,28,-11
9833,77,64,11694,82,22,6,16,24,-1
9834,80,74,11694,80,34,11,23,35,13
9835,83,74,11694,55,12,3,9,14,-3
9836,83,63,11694,18,5,1,4,0,-2
9837,86,20120,11694,61,15,3,12,14,5
9838,2,72,27243,1,0,0,0,0,1
9839,5,72,27243,3,0,0,0,0,0
9840,8,72,27243,2,0,0,0,0,-1
9844,11,86,24266,11,4,2,2,6,-1
9845,14,76,24266,8,1,0,1,0,1
9846,17,65,24266,10,5,1,4,2,1
9848,26,79,24266,77,42,19,23,22,1
9849,29,79,24266,44,19,4,15,10,-1
9850,29,1479,24266,30,23,6,17,4,1
9851,32,79,24266,33,11,3,8,6,0
9852,35,76,24266,37,24,7,17,6,2
9853,38,89,24266,72,50,12,38,18,-1
9854,41,89,24266,66,31,9,22,8,-10
9855,5,78,30988,22,1,0,1,8,-4
9856,32,69,69806,3,0,0,0,2,-2
9857,35,69,69806,3,0,0,0,2,1
9858,59,86,12151,51,21,4,17,21,5
9859,62,86,12151,75,24,2,22,28,19
9860,65,86,12151,57,13,4,9,22,-8
9861,68,86,12151,22,3,1,2,10,-4
9740,20,65,27823,69,31,14,17,41,-10
9741,23,65,27823,37,11,4,7,8,-4
9866,80,68,12151,81,28,9,19,53,-14
9867,83,87,12151,69,20,6,14,37,-4
9868,86,87,12151,35,8,2,6,12,9
9869,59,66,14035,7,2,0,2,10,-1
9870,62,66,14035,23,2,0,2,0,0
9871,65,66,14035,16,5,2,3,8,-3
9875,11,70,8959,76,93,50,43,54,-8
9876,14,70,8959,30,29,12,17,8,7
9877,17,70,8959,78,81,36,45,63,-12
9878,20,70,8959,80,83,35,48,42,43
9879,23,70,8959,52,59,21,38,32,25
9880,26,70,8959,77,81,34,47,44,29
9881,29,70,8959,77,81,38,43,48,0
9882,32,70,8959,81,84,33,51,52,26
9883,35,70,8959,78,77,34,43,38,14
9884,38,70,8959,79,85,28,57,30,34
9886,47,70,8959,78,77,27,50,58,23
9887,50,70,8959,59,43,22,21,34,9
9888,53,70,8959,82,57,21,36,48,-11
9889,56,70,8959,80,46,15,31,46,-13
9890,59,70,8959,59,30,14,16,22,-6
9891,62,85,8959,40,15,4,11,8,-4
9892,59,69,12148,1,0,0,0,0,0
9893,62,69,12148,5,0,0,0,0,-1
9894,17,84,185,56,22,6,16,32,0
9895,20,84,185,40,10,2,8,8,4
9896,56,77,9394,1,0,0,0,0,0
9897,14,63,67487,34,11,3,8,39,1
9898,17,63,67487,79,13,1,12,59,-8
9899,20,63,67487,37,8,3,5,31,-14
9900,23,63,8661,81,47,22,25,8,9
9901,26,63,8661,79,51,25,26,18,-6
9903,32,63,8661,82,75,29,46,18,6
9904,35,63,8661,74,70,29,41,27,21
9905,38,63,8661,8,11,5,6,2,8
9906,41,63,8661,58,40,17,23,4,12
9907,47,63,8661,55,37,18,19,22,-3
9908,47,71,8661,19,16,5,11,6,0
9909,50,75,8661,63,26,9,17,10,-4
9910,53,65,8661,23,4,0,4,6,-7
9911,53,66,8661,38,32,14,18,10,6
9912,56,66,8661,81,48,16,32,28,-8
9913,59,66,8661,72,29,14,15,32,-15
9914,62,66,8661,58,26,10,16,12,0
9915,62,68,8661,20,14,3,11,2,-2
9916,2,67,21326,62,64,30,34,16,14
9917,5,67,21326,67,84,39,45,73,7
9918,8,67,21326,77,127,76,51,40,7
9920,14,67,21326,44,47,19,28,36,0
9921,17,84,21326,79,107,55,52,16,14
9922,20,84,21326,76,73,31,42,18,9
9923,23,84,21326,51,45,18,27,36,-6
9924,26,84,21326,59,45,14,31,58,0
9925,29,84,21326,47,38,21,17,16,7
9926,29,72,21326,12,6,3,3,4,-4
9927,32,72,21326,75,83,43,40,43,10
9928,35,83,21326,66,57,24,33,8,1
9929,38,83,21326,73,79,33,46,12,4
9930,41,83,21326,37,30,8,22,12,9
9931,47,72,21326,34,25,12,13,6,-7
9932,59,76,14644,2,0,0,0,9,-3
9933,62,76,14644,27,3,2,1,85,-4
9934,65,76,14644,14,0,0,0,57,-1
9935,68,74,14644,9,0,0,0,12,-1
9937,77,86,14644,16,1,1,0,48,-2
9938,80,86,14644,58,12,2,10,128,6
9939,83,68,14644,75,9,3,6,212,-13
9940,86,68,14644,24,3,1,2,30,-2
9941,86,86,14644,19,3,1,2,45,0
9946,17,77,74535,17,3,3,0,17,-2
9947,5,75,68096,3,0,0,0,0,0
9948,8,75,68096,53,12,5,7,20,6
9949,11,75,68096,61,14,6,8,42,3
9950,14,75,68096,30,5,1,4,12,-7
9952,20,67,68096,18,5,1,4,11,4
9953,38,88,15711,10,3,0,3,4,-4
9954,41,88,15711,15,5,2,3,12,-4
9957,38,69,10646,1,0,0,0,2,0
9958,71,76,40300,4,0,0,0,17,0
9959,2,74,68521,61,23,4,19,161,13
9961,5,67,68521,13,3,1,2,59,1
9962,8,67,68521,35,9,2,7,83,6
9963,11,67,68521,78,13,2,11,154,-5
9964,14,68,68521,17,3,0,3,16,-5
9966,11,1479,1813,3,0,0,0,0,-1
9967,2,78,19223,59,28,10,18,131,12
9968,2,84,19223,11,8,6,2,43,1
9969,5,84,19223,58,43,20,23,198,16
9970,8,84,19223,84,38,18,20,200,11
9971,11,84,19223,68,27,14,13,149,-2
9972,14,84,19223,48,25,10,15,65,-2
9973,17,83,19223,54,15,7,8,112,-11
9974,17,74,19223,19,8,4,4,30,-2
9975,20,74,19223,9,0,0,0,11,-2
9976,20,78,19223,31,4,1,3,37,-4
9977,56,80,14487,1,0,0,0,0,0
9979,62,80,14487,55,9,4,5,120,-11
9980,65,80,14487,81,26,14,12,98,4
9981,68,80,14487,48,15,4,11,56,-9
9982,71,80,14487,82,22,13,9,111,-9
9983,74,80,14487,37,3,2,1,18,-8
9984,77,80,14487,81,36,25,11,80,16
9985,80,80,14487,74,32,16,16,61,6
9986,83,80,14487,68,19,5,14,54,-32
9987,86,80,14487,70,28,9,19,81,-6
9988,2,78,77133,7,2,1,1,0,1
9989,5,78,77133,36,15,3,12,6,-2
9990,8,81,77133,4,2,1,1,2,-2
9991,8,78,32127,7,3,2,1,8,-1
9992,8,81,32127,1,0,0,0,0,0
9863,74,86,12151,20,3,0,3,8,-6
9864,74,70,12151,61,22,5,17,63,3
9997,14,86,54460,45,6,0,6,71,7
9998,17,86,54460,74,9,2,7,147,-32
9999,20,74,54460,14,1,0,1,25,0
10002,23,65,54460,17,2,0,2,8,7
10003,26,73,54460,18,2,0,2,18,2
10006,8,84,462431,1,1,0,1,0,-1
10007,11,84,462431,5,2,1,1,6,0
10008,26,77,74530,2,1,0,1,0,0
10009,11,83,542906,4,2,1,1,4,-2
10010,14,1479,542906,8,2,0,2,0,-3
10011,17,1479,542906,23,14,4,10,18,1
10012,56,89,14818,3,0,0,0,2,-3
10013,59,89,14818,7,2,1,1,2,-1
10014,62,89,14818,31,3,2,1,8,-2
10015,65,89,14818,41,5,4,1,23,-2
10016,68,89,14818,48,8,2,6,14,-1
10018,74,89,14818,62,20,10,10,20,6
10019,77,89,14818,57,17,8,9,24,0
10020,80,89,14818,81,30,13,17,22,20
10021,83,89,14818,79,22,7,15,16,3
10022,86,84,14818,57,13,3,10,18,-8
10023,2,72,67716,53,28,9,19,27,9
10024,5,72,67716,7,3,1,2,6,-6
10025,8,72,67716,2,0,0,0,0,-1
10026,8,86,67716,13,3,0,3,6,-10
10027,11,63,67716,4,0,0,0,0,-2
10028,20,83,5683,13,4,2,2,4,-2
10029,23,83,5683,82,47,15,32,24,-4
10030,26,83,5683,79,44,20,24,35,13
10031,29,83,5683,52,25,11,14,23,8
10032,29,81,5683,28,22,10,12,4,-2
10033,32,81,5683,64,38,11,27,38,-10
10040,53,78,5683,21,5,2,3,8,-4
10041,20,63,8818,1,0,0,0,0,0
10042,23,63,8818,4,0,0,0,0,-2
10043,26,63,8818,4,2,0,2,0,-1
10044,29,73,8818,69,25,11,14,10,-13
10045,32,73,8818,62,26,9,17,12,-11
10046,35,88,8818,18,7,4,3,17,-9
10047,35,79,8818,40,30,10,20,16,-14
10048,38,79,8818,41,17,5,12,8,5
10049,38,76,8818,10,3,1,2,2,0
10051,47,69,8818,67,40,12,28,54,-5
10052,50,77,8818,28,17,5,12,22,-4
10053,50,76,8818,50,23,6,17,22,-2
10054,53,80,8818,68,29,10,19,18,4
10062,23,66,8777,40,17,7,10,14,-4
10063,23,84,8777,9,3,0,3,4,-1
10065,26,67,8777,75,30,12,18,22,8
10066,29,67,8777,67,26,13,13,22,4
10067,32,82,8777,68,56,30,26,46,4
10068,35,82,8777,42,16,11,5,12,-15
10069,38,82,8777,82,67,34,33,34,-4
10070,41,82,8777,67,29,13,16,34,-9
10071,41,84,8777,13,7,3,4,4,-1
10072,47,82,8777,2,0,0,0,0,-1
10074,50,77,8777,58,29,11,18,44,-16
10075,53,71,8777,41,13,3,10,16,-7
10076,23,71,54644,8,0,0,0,6,-4
10077,2,72,22426,80,70,19,51,76,1
10078,5,75,22426,78,77,36,41,86,15
10079,8,75,22426,80,94,37,57,77,8
10080,11,75,22426,76,57,23,34,96,-1
10081,14,75,22426,33,19,8,11,33,-21
10083,17,76,22426,15,7,4,3,15,-10
10084,17,83,22426,36,25,9,16,42,-3
10085,20,83,22426,66,37,20,17,85,-23
10086,20,68,22426,10,3,1,2,4,-2
10087,23,68,22426,70,29,8,21,54,-14
10088,26,68,22426,82,15,4,11,49,-11
10089,29,70,22426,47,22,7,15,24,-3
10090,32,70,22426,55,10,1,9,26,-4
10091,35,70,22426,78,30,10,20,28,-12
10092,38,70,22426,55,6,1,5,18,-6
10093,2,74,26581,79,62,19,43,44,12
10094,5,86,26581,72,46,18,28,66,-14
10095,8,76,26581,81,32,18,14,28,5
10096,2,79,22345,47,39,17,22,6,9
10097,5,79,22345,77,87,42,45,30,12
10098,8,79,22345,72,70,33,37,14,19
10100,14,79,22345,45,37,16,21,6,15
10101,17,63,22345,37,15,8,7,0,-2
10102,20,79,22345,54,22,7,15,4,0
10104,2,79,21498,44,28,5,23,30,2
10105,5,79,21498,77,77,21,56,48,33
10106,8,79,21498,83,85,22,63,73,45
10107,11,79,21498,84,73,17,56,44,10
10108,14,79,21498,48,38,13,25,18,12
10109,17,83,21498,82,61,12,49,34,-2
10110,20,83,21498,69,39,7,32,20,1
10111,20,85,21498,12,6,2,4,0,2
10112,23,85,21498,82,52,11,41,37,35
10113,26,85,21498,80,52,10,42,42,21
10114,29,85,21498,81,40,10,30,45,4
10115,32,85,21498,57,21,2,19,12,-6
10116,26,75,16735,10,0,0,0,0,-3
10118,32,75,16735,18,3,0,3,0,-2
10119,23,76,64237,1,0,0,0,0,0
10120,2,71,26593,76,10,1,9,77,10
10121,5,71,26593,54,7,2,5,34,11
10122,8,71,26593,72,11,0,11,67,-15
10123,8,65,26593,9,0,0,0,8,1
10124,11,65,26593,9,4,0,4,4,3
10125,11,67,26593,73,10,2,8,62,28
10126,14,67,26593,40,6,0,6,36,-4
10127,17,67,26593,47,4,0,4,69,-12
10129,20,79,26593,64,4,0,4,36,-6
10130,23,70,26593,40,2,1,1,25,0
10131,2,71,3589,80,62,27,35,35,2
10132,5,71,3589,80,82,35,47,52,17
9994,5,86,54460,46,17,4,13,85,-32
9995,8,86,54460,73,11,5,6,179,-35
10137,20,78,3589,75,45,20,25,69,-1
10138,23,78,3589,27,13,4,9,22,8
10139,23,86,3589,10,9,5,4,14,1
10140,26,86,3589,76,48,25,23,73,10
10141,29,63,3589,26,14,7,7,41,-7
10142,29,89,3589,29,13,5,8,53,8
10143,32,89,3589,14,6,1,5,20,-5
10144,2,77,67412,80,42,11,31,58,-7
10145,5,77,67412,31,10,2,8,33,-4
10146,5,63,67412,42,9,3,6,51,2
10147,8,63,67412,49,17,5,12,62,-13
10148,11,68,67412,84,43,14,29,71,-11
10149,14,68,67412,46,22,6,16,24,-14
10150,17,68,67412,70,30,8,22,30,5
10151,20,68,67412,80,23,8,15,51,3
10152,23,68,67412,79,17,6,11,46,-3
10156,35,63,67412,15,2,0,2,13,2
10157,23,63,3666,55,7,3,4,19,-6
10158,26,63,3666,81,41,16,25,69,3
10159,29,63,3666,81,60,23,37,82,-5
10160,32,63,3666,72,71,37,34,107,-4
10161,35,63,3666,66,68,22,46,127,7
10162,38,63,3666,77,101,36,65,109,12
10163,41,63,3666,77,73,23,50,98,18
10164,47,63,3666,23,33,9,24,6,0
10165,47,86,3666,58,92,20,72,55,31
10166,50,86,3666,82,114,22,92,44,24
10167,53,86,3666,82,96,29,67,59,18
10168,56,86,3666,82,86,25,61,56,16
10169,59,86,3666,79,89,20,69,54,17
10170,62,86,3666,80,70,21,49,47,4
10171,65,86,3666,82,77,18,59,31,17
10173,71,86,3666,82,76,11,65,32,20
10174,74,86,3666,78,65,16,49,30,-4
10175,77,86,3666,82,82,19,63,54,25
10176,80,86,3666,79,50,7,43,51,7
10177,83,86,3666,47,36,13,23,38,-9
10178,86,86,3666,73,51,16,35,20,8
10179,23,88,2675,8,0,0,0,6,-5
10180,26,88,2675,66,21,9,12,44,-10
10181,29,76,2675,82,21,11,10,80,0
10182,32,68,2675,78,16,6,10,106,-22
10183,35,68,2675,80,29,9,20,98,-16
10184,38,68,2675,81,65,36,29,79,-17
10185,41,68,2675,82,58,26,32,81,-16
10186,47,68,2675,82,89,38,51,88,14
10187,50,68,2675,82,91,39,52,78,18
10188,53,68,2675,82,71,34,37,67,-19
10191,59,62,2675,56,35,11,24,53,2
10192,59,74,2675,26,15,4,11,22,1
10193,62,62,2675,79,54,17,37,44,-17
10194,65,62,2675,82,61,23,38,54,-12
10195,68,547,2675,45,14,7,7,14,-19
10196,71,547,2675,82,43,18,25,62,-8
10197,74,73,2675,48,6,3,3,26,2
10198,74,83,2675,6,1,0,1,2,1
10199,74,78,2675,8,3,1,2,0,3
10200,26,76,9091,63,11,5,6,32,-14
10201,29,76,9091,26,2,0,2,20,-11
10202,32,71,9091,77,21,7,14,53,15
10203,35,71,9091,81,25,7,18,45,-5
10204,38,71,9091,80,29,8,21,45,-11
10205,41,71,9091,77,25,7,18,67,-6
10206,47,78,9091,32,9,6,3,45,-17
10208,53,78,9091,77,22,1,21,91,-18
10209,56,78,9091,28,6,1,5,24,-14
10210,59,78,9091,59,15,8,7,46,-17
10211,62,78,9091,54,14,8,6,57,1
10212,62,81,9091,22,2,1,1,24,5
10213,65,81,9091,82,21,1,20,49,-5
10214,68,81,9091,48,12,4,8,30,3
10215,71,81,9091,77,17,4,13,59,10
10216,74,81,9091,17,4,0,4,18,5
10217,74,1479,9091,9,2,1,1,6,-6
10218,74,83,9091,18,5,2,3,12,-4
10219,2,84,104165,42,6,5,1,90,-11
10220,5,84,104165,6,1,0,1,6,-2
10221,8,80,104165,44,10,3,7,30,-23
10222,11,88,104165,8,1,0,1,22,-3
10223,26,81,8561,1,2,1,1,0,-3
10225,32,81,8561,46,16,6,10,40,-17
10231,50,63,8561,59,18,3,15,95,-22
10232,50,74,8561,19,5,2,3,18,6
10233,53,74,8561,61,17,1,16,52,1
10234,56,74,8561,76,21,5,16,94,2
10235,59,75,8561,42,8,0,8,48,-16
10236,62,1479,8561,33,2,1,1,40,-1
10237,62,75,8561,20,4,0,4,48,2
10238,29,63,8744,5,0,0,0,0,-5
10239,32,63,8744,1,0,0,0,0,-1
10240,35,63,8744,80,18,4,14,107,18
10241,38,63,8744,78,24,7,17,99,8
10242,41,63,8744,81,30,6,24,98,17
10243,47,63,8744,54,12,5,7,93,-7
10246,56,68,8744,68,21,5,16,91,7
10247,59,1479,8744,42,7,1,6,59,1
10249,62,65,8744,41,8,1,7,36,2
10250,62,77,8744,10,0,0,0,4,-3
10251,23,86,3667,74,32,13,19,14,5
10252,26,86,3667,81,45,21,24,24,10
10253,29,86,3667,81,40,17,23,36,-9
10254,32,86,3667,81,52,25,27,22,7
10255,35,86,3667,79,44,21,23,40,9
10256,38,86,3667,82,57,28,29,33,-10
10257,41,86,3667,80,57,28,29,24,-5
10258,47,86,3667,82,86,34,52,26,-12
10259,50,86,3667,77,78,32,46,33,9
10260,53,86,3667,78,48,19,29,33,-19
10261,56,86,3667,76,71,38,33,18,16
10262,59,86,3667,82,83,44,39,22,21
10134,11,65,3589,81,70,31,39,111,1
10135,14,65,3589,40,41,23,18,89,7
10267,74,86,3667,82,57,19,38,12,-17
10268,77,86,3667,82,48,25,23,10,-22
10269,80,86,3667,82,46,27,19,28,4
10270,83,83,3667,82,47,27,20,16,1
10271,86,83,3667,82,37,16,21,28,-6
10272,29,75,8806,32,3,2,1,10,-1
10273,32,75,8806,12,0,0,0,12,3
10274,38,75,8806,8,5,3,2,0,3
10275,41,75,8806,53,12,5,7,21,3
10276,47,74,8806,81,28,10,18,44,-4
10277,50,74,8806,46,10,4,6,26,-3
10278,50,88,8806,7,1,0,1,4,-1
10279,50,81,8806,17,8,4,4,10,-11
10280,53,81,8806,79,14,8,6,42,-18
10281,56,81,8806,1,0,0,0,2,0
10282,23,80,4716,7,1,0,1,0,-1
10284,29,80,4716,78,56,29,27,32,5
10285,32,80,4716,81,75,32,43,44,19
10286,35,80,4716,80,66,31,35,50,11
10287,38,80,4716,80,80,45,35,34,8
10288,41,80,4716,81,82,36,46,46,4
10292,53,79,4716,12,10,3,7,6,0
10293,56,85,4716,74,71,40,31,63,27
10294,59,65,4716,57,51,24,27,18,24
10295,62,65,4716,65,57,25,32,32,9
10296,65,65,4716,81,77,29,48,20,18
10297,68,65,4716,40,31,17,14,16,20
10298,71,65,4716,72,60,30,30,20,28
10299,74,65,4716,82,61,22,39,32,17
10300,77,65,4716,64,33,13,20,24,10
10301,80,65,4716,73,45,26,19,8,7
10302,29,68,8722,13,2,0,2,46,2
10304,35,68,8722,80,17,2,15,254,-13
10305,38,68,8722,60,8,2,6,118,2
10308,50,62,8722,5,0,0,0,2,-1
10309,2,89,74613,17,3,0,3,19,0
10316,5,89,15514,15,1,0,1,0,-4
10317,8,89,15514,7,1,0,1,6,1
10318,11,62,15514,26,7,1,6,4,-4
10319,26,65,41121,8,0,0,0,12,-1
10320,41,68,41121,6,0,0,0,7,0
10321,23,65,4372,6,0,0,0,0,-2
10322,26,65,4372,35,9,4,5,24,-1
10323,29,71,4372,17,5,3,2,8,-1
10324,32,71,4372,81,35,14,21,37,5
10325,35,71,4372,65,29,10,19,51,-1
10326,38,71,4372,57,17,4,13,31,5
10328,47,85,4372,77,15,3,12,40,5
10330,53,85,4372,63,42,20,22,33,21
10331,56,85,4372,74,40,14,26,46,0
10332,59,85,4372,64,34,15,19,29,-3
10333,62,85,4372,68,46,26,20,20,-1
10334,65,85,4372,75,33,12,21,30,2
10335,68,85,4372,48,15,9,6,40,-6
10336,71,85,4372,52,8,4,4,31,-11
10337,74,85,4372,17,2,1,1,6,-4
10338,41,1479,729419,21,2,2,0,25,-6
10339,47,65,729419,72,20,10,10,16,-14
10340,50,65,729419,63,13,6,7,31,-5
10341,32,84,9407,1,0,0,0,5,0
10342,35,84,9407,15,0,0,0,72,1
10343,38,1479,9407,16,2,1,1,44,0
10344,47,65,9407,2,1,0,1,9,0
10345,2,65,26355,75,37,14,23,74,13
10349,11,65,26355,12,1,0,1,6,1
10350,11,80,26355,15,5,2,3,4,1
10351,14,80,26355,33,14,4,10,16,-1
10352,14,79,26355,13,2,0,2,23,-1
10353,17,64,26355,63,21,7,14,22,15
10354,35,66,7304,2,0,0,0,6,-2
10355,2,77,205744,16,3,2,1,15,-5
10356,5,77,205744,9,1,1,0,0,3
10357,29,70,8956,64,33,14,19,81,8
10358,32,70,8956,82,44,20,24,128,18
10359,35,70,8956,72,35,17,18,109,12
10360,38,70,8956,71,43,21,22,134,20
10361,41,70,8956,81,49,25,24,121,10
10362,47,70,8956,81,65,23,42,183,30
10363,50,70,8956,40,31,16,15,33,-2
10364,53,70,8956,82,74,32,42,105,23
10366,59,70,8956,76,46,20,26,69,-3
10367,62,70,8956,82,56,33,23,76,-3
10368,65,70,8956,57,26,11,15,97,1
10369,68,70,8956,29,11,6,5,18,-8
10370,68,79,8956,15,14,6,8,19,5
10371,71,78,8956,71,25,13,12,76,1
10372,74,81,8956,70,8,3,5,64,-1
10373,2,76,54625,1,0,0,0,0,0
10374,11,76,54625,1,0,0,0,0,0
10375,38,66,4318,9,3,3,0,2,-2
10376,29,63,28662,4,0,0,0,2,-1
10377,29,81,8781,60,8,2,6,87,-26
10378,32,81,8781,23,6,5,1,21,-7
10379,35,81,8781,81,34,14,20,36,-10
10380,38,81,8781,65,18,6,12,57,-2
10381,41,81,8781,66,10,2,8,50,5
10383,50,89,8781,66,20,7,13,44,-17
10384,38,88,9685,5,0,0,0,0,-1
10385,41,88,9685,19,11,5,6,4,3
10387,29,84,12147,3,0,0,0,0,-1
10388,35,89,14502,36,4,1,3,20,-1
10389,38,89,14502,33,1,0,1,22,-3
10390,41,89,14502,2,0,0,0,0,0
10391,29,84,38463,33,16,7,9,10,14
10392,32,84,38463,55,30,15,15,14,2
10393,35,84,38463,27,8,4,4,6,-1
10394,38,84,38463,3,2,1,1,0,-1
10395,38,66,38463,10,1,0,1,2,-1
10396,38,83,38463,5,2,0,2,2,1
10397,38,66,38463,4,0,0,0,0,0
10264,65,86,3667,82,64,30,34,26,10
10265,68,86,3667,48,31,17,14,24,-2
10402,41,82,10984,9,1,0,1,20,-3
10403,50,63,10984,32,1,0,1,63,-10
10404,53,63,10984,58,4,2,2,78,-5
10405,5,72,31997,25,11,5,6,0,5
10406,8,72,31997,82,79,37,42,70,24
10407,11,72,31997,54,29,12,17,22,6
10408,14,72,31997,19,8,2,6,13,-4
10409,14,81,31997,22,10,5,5,12,-3
10410,17,76,31997,69,34,20,14,68,-4
10411,20,84,31997,18,3,2,1,2,-2
10416,17,1479,2676,28,36,16,20,4,2
10417,20,1479,2676,78,109,51,58,34,28
10418,23,1479,2676,73,86,52,34,30,12
10419,26,1479,2676,75,107,47,60,30,18
10420,29,1479,2676,79,85,33,52,12,6
10421,32,1479,2676,61,59,26,33,36,-8
10423,35,86,2676,82,54,29,25,40,-11
10424,38,86,2676,82,64,28,36,30,-6
10425,41,64,2676,78,32,16,16,32,2
10426,47,1479,2676,80,90,40,50,44,28
10427,50,1479,2676,82,94,48,46,82,26
10428,53,1479,2676,26,23,12,11,8,5
10429,56,1479,2676,65,54,27,27,36,-3
10430,59,1479,2676,54,48,27,21,16,3
10431,62,1479,2676,73,80,31,49,49,6
10432,65,1479,2676,82,66,26,40,50,-1
10433,68,1479,2676,46,24,12,12,28,-10
10434,71,1479,2676,64,27,9,18,12,8
10435,8,88,73365,1,0,0,0,2,0
10436,29,1479,9595,6,1,0,1,2,2
10437,14,63,1416,34,22,8,14,4,-4
10438,2,62,31970,58,18,5,13,63,-1
10440,5,83,31970,36,16,2,14,32,-1
10441,8,77,31970,44,17,7,10,29,1
10442,35,67,1951,2,0,0,0,0,-1
10443,38,67,1951,46,13,3,10,28,-3
10444,41,67,1951,72,10,1,9,26,5
10445,47,67,1951,82,21,6,15,74,10
10446,50,67,1951,47,14,4,10,34,19
10447,53,67,1951,71,18,1,17,48,5
10448,56,67,1951,66,12,1,11,36,-2
10449,59,67,1951,82,20,4,16,32,13
10450,62,72,1951,82,16,5,11,40,-6
10451,65,72,1951,39,6,0,6,16,-11
10452,68,72,1951,25,4,1,3,10,0
10453,71,67,1951,64,8,2,6,34,-21
10454,11,75,73611,43,9,4,5,42,6
10455,14,75,73611,19,0,0,0,15,-5
10457,23,74,73611,3,0,0,0,2,0
10458,38,84,9008,3,1,1,0,2,2
10459,41,84,9008,3,1,1,0,0,0
10460,47,77,9008,8,0,0,0,2,-2
10461,35,68,729558,79,45,23,22,14,-4
10462,38,68,729558,78,43,20,23,20,-6
10463,41,68,729558,76,31,10,21,24,-6
10464,47,68,729558,24,8,5,3,4,-11
10465,47,62,729558,54,39,15,24,36,2
10466,50,62,729558,81,77,34,43,26,21
10467,53,62,729558,81,66,25,41,40,10
10468,56,82,729558,74,56,21,35,44,1
10469,59,82,729558,74,63,23,40,36,-4
10470,62,82,729558,39,23,14,9,10,-17
10471,65,82,729558,2,0,0,0,2,-2
10472,29,70,28803,58,12,6,6,10,-2
10474,35,70,28803,4,0,0,0,0,-2
10475,35,74,28803,15,2,2,0,0,0
10476,38,74,28803,2,0,0,0,0,-2
10477,29,85,18516,57,8,5,3,12,-6
10478,32,85,18516,15,2,1,1,4,-2
10479,35,85,18516,3,0,0,0,0,-1
10482,32,64,11490,19,4,0,4,38,5
10483,35,64,11490,57,0,0,0,60,1
10484,35,79,11490,13,2,0,2,21,-4
10485,38,89,11490,43,3,2,1,87,-3
10486,41,89,11490,65,6,0,6,108,-5
10487,56,76,12124,17,1,0,1,68,-1
10488,59,76,12124,6,0,0,0,27,-2
10489,65,89,12124,3,0,0,0,10,0
10490,2,84,8676,61,16,10,6,20,-21
10491,5,84,8676,77,37,15,22,36,-3
10493,11,78,8676,19,20,6,14,8,2
10494,14,74,8676,46,23,11,12,26,-1
10495,17,79,8676,80,99,45,54,68,37
10496,20,79,8676,74,71,33,38,66,-2
10497,26,74,8676,56,47,20,27,50,-6
10498,29,74,8676,76,68,24,44,40,2
10499,32,74,8676,79,78,32,46,54,10
10500,35,74,8676,78,46,21,25,36,-8
10501,38,74,8676,78,58,27,31,64,-4
10502,41,74,8676,65,31,14,17,42,-9
10503,41,71,8676,16,15,5,10,4,1
10505,47,77,8676,28,14,5,9,36,-8
10506,50,77,8676,21,7,1,6,18,-20
10507,50,71,8676,19,5,1,4,10,-5
10508,32,83,42310,2,0,0,0,2,-1
10509,35,83,42310,6,2,0,2,4,1
10512,32,81,12290,8,0,0,0,0,-5
10513,2,63,21314,69,91,51,40,98,26
10514,5,63,21314,9,12,9,3,16,9
10515,8,63,21314,13,18,11,7,25,4
10516,11,63,21314,49,74,50,24,54,12
10517,14,63,21314,42,41,27,14,72,7
10518,17,63,21314,49,46,26,20,31,3
10519,32,63,11032,21,2,2,0,7,-3
10520,38,63,11032,14,3,2,1,7,-2
10521,41,68,11032,2,1,0,1,0,-4
10522,47,84,11032,28,3,1,2,30,-6
10523,50,84,11032,2,0,0,0,0,-1
10524,29,81,70157,10,0,0,0,39,-1
10525,32,81,70157,13,1,0,1,36,-1
10399,5,86,64516,13,0,0,0,25,-4
10400,8,86,64516,4,1,0,1,4,-1
10530,47,63,8982,18,1,0,1,10,-6
10531,50,85,8982,33,2,0,2,12,2
10532,53,73,8982,2,0,0,0,0,0
10533,29,67,8668,65,34,16,18,41,-4
10534,32,67,8668,78,36,14,22,40,1
10535,35,67,8668,81,40,21,19,69,-9
10536,38,67,8668,35,11,5,6,21,-12
10537,41,67,8668,73,31,17,14,57,-4
10538,47,67,8668,77,73,22,51,84,6
10539,50,67,8668,56,61,23,38,66,19
10540,53,67,8668,56,28,10,18,42,-16
10541,56,67,8668,48,20,6,14,20,-7
10543,32,79,8678,18,2,0,2,21,-5
10544,35,79,8678,60,3,0,3,68,-1
10545,38,79,8678,8,0,0,0,2,-2
10546,41,79,8678,82,8,3,5,62,-17
10548,50,79,8678,70,12,1,11,44,1
10549,56,66,8678,15,4,0,4,8,-1
10550,56,81,8678,24,5,0,5,29,1
10551,38,65,9751,16,2,0,2,9,-13
10552,41,65,9751,23,6,2,4,24,0
10553,35,68,69593,15,0,0,0,0,-1
10554,26,73,8685,2,0,0,0,0,-1
10555,47,89,8685,10,4,2,2,6,0
10556,32,70,8724,1,0,0,0,0,0
10557,35,70,8724,5,1,0,1,7,-1
10558,41,70,8724,7,0,0,0,7,1
10560,29,64,2658,1,0,0,0,0,0
10561,32,64,2658,50,22,14,8,38,8
10562,35,64,2658,53,24,10,14,30,1
10563,35,79,2658,13,3,1,2,8,-2
10564,38,79,2658,75,21,9,12,93,-25
10566,41,62,2658,19,8,3,5,18,6
10567,47,74,2658,48,17,5,12,53,10
10568,47,86,2658,22,7,3,4,10,-3
10569,50,86,2658,30,2,1,1,14,-7
10570,50,78,2658,14,0,0,0,29,-1
10571,35,73,1929,1,0,0,0,0,0
10572,38,73,1929,1,0,0,0,0,0
10573,41,73,1929,20,3,0,3,34,6
10578,62,80,9684,24,0,0,0,78,0
10579,2,85,27420,6,3,1,2,6,1
10580,8,88,27420,25,6,2,4,16,0
10581,11,88,27420,56,7,3,4,30,-8
10582,14,88,27420,22,9,3,6,6,-2
10583,17,88,27420,33,14,4,10,12,3
10584,38,88,9118,50,12,5,7,14,2
10585,41,88,9118,72,25,8,17,36,7
10587,50,80,9118,76,37,8,29,42,8
10588,53,80,9118,51,27,6,21,18,13
10589,53,66,9118,23,21,7,14,8,4
10590,56,66,9118,81,38,14,24,18,-1
10591,59,66,9118,34,12,4,8,10,-6
10592,59,89,9118,18,6,2,4,2,-4
10593,62,66,9118,82,40,11,29,18,-14
10594,65,63,9118,75,25,4,21,13,10
10595,68,66,9118,40,17,6,11,14,-3
10596,71,80,9118,25,10,3,7,10,-7
10597,29,83,8807,8,1,1,0,6,-1
10598,32,83,8807,16,2,0,2,14,3
10599,32,88,8807,10,0,0,0,6,-3
10600,35,88,8807,18,2,1,1,57,1
10601,38,67,8807,79,17,6,11,146,-4
10602,41,67,8807,81,20,6,14,146,-3
10604,50,67,8807,82,11,2,9,128,-1
10605,53,67,8807,72,17,5,12,66,-2
10606,56,67,8807,75,19,8,11,95,4
10607,59,67,8807,69,14,6,8,73,-2
10608,62,72,8807,65,4,1,3,45,-16
10609,29,76,9624,3,0,0,0,0,-1
10613,17,64,8880,64,34,16,18,250,10
10614,20,89,8880,42,22,9,13,165,-1
10615,23,89,8880,28,17,7,10,38,-1
10616,26,89,8880,23,10,3,7,48,-4
10617,29,89,8880,75,49,29,20,146,11
10618,32,89,8880,60,20,10,10,109,-12
10619,35,89,8880,82,31,14,17,137,-8
10620,38,89,8880,10,2,0,2,23,-3
10621,38,65,8880,61,18,12,6,125,-4
10622,41,74,8880,65,23,14,9,225,14
10624,47,62,8880,72,22,8,14,94,0
10625,50,76,8880,67,27,10,17,75,17
10626,53,76,8880,28,3,1,2,43,-1
10627,53,69,8880,10,0,0,0,16,-1
10628,11,76,74361,4,0,0,0,34,0
10630,29,68,12228,14,3,2,1,8,-3
10631,32,68,12228,38,9,3,6,16,-5
10632,35,68,12228,70,29,13,16,44,-10
10633,38,68,12228,78,27,10,17,30,-16
10634,41,68,12228,17,5,1,4,8,-6
10636,5,77,64763,1,0,0,0,0,0
10638,14,72,64763,9,0,0,0,27,-1
10639,17,72,64763,23,6,1,5,79,2
10640,20,72,64763,27,4,0,4,60,0
10641,23,72,64763,6,0,0,0,16,-2
10642,23,65,64763,38,5,3,2,102,-1
10644,29,81,64763,26,1,1,0,103,-3
10645,32,78,64763,38,3,2,1,96,-3
10646,35,75,64763,25,2,1,1,63,0
10647,35,73,64763,26,5,5,0,69,-1
10648,38,73,64763,26,1,0,1,56,-4
10649,41,79,64763,2,0,0,0,17,0
10650,47,77,8924,7,1,0,1,0,0
10651,41,65,11751,3,1,0,1,0,1
10652,53,89,11751,39,6,1,5,10,4
10653,56,89,11751,1,0,0,0,0,1
10654,59,89,11751,36,4,2,2,21,2
10656,11,70,90000,7,2,0,2,4,-1
10658,41,78,10968,9,0,0,0,6,-1
10659,65,69,9424,6,1,1,0,4,-2
10527,38,80,8982,12,1,0,1,4,2
10528,41,80,8982,38,17,7,10,16,6
10664,20,88,13521,32,14,3,11,4,-10
10666,26,73,13521,46,14,2,12,14,-12
10667,29,79,13521,29,5,1,4,10,-10
10668,35,77,13521,1,0,0,0,0,2
10669,41,77,13521,4,2,0,2,0,0
10673,47,82,705665,13,0,0,0,4,-4
10674,26,81,77154,3,2,0,2,2,-3
10675,8,84,1935,41,26,4,22,109,16
10676,11,84,1935,78,38,5,33,86,0
10677,14,84,1935,19,6,1,5,32,0
10678,14,71,1935,12,6,1,5,14,-5
10679,17,71,1935,57,17,4,13,74,-1
10680,23,79,1935,73,17,5,12,109,10
10681,26,79,1935,63,23,3,20,86,13
10682,29,79,1935,74,31,11,20,82,20
10683,32,79,1935,42,15,5,10,60,-9
10687,41,84,1935,16,7,2,5,8,6
10688,41,63,1935,36,19,4,15,27,5
10689,47,63,1935,32,16,5,11,56,-2
10690,59,75,11440,2,0,0,0,0,-1
10691,23,80,729566,61,26,11,15,36,2
10692,26,80,729566,80,47,21,26,50,33
10693,29,80,729566,47,28,15,13,36,4
10694,32,80,729566,51,33,17,16,24,23
10695,35,80,729566,74,39,12,27,35,27
10696,38,80,729566,80,37,16,21,48,13
10702,23,67,26127,72,20,3,17,62,11
10704,29,67,26127,64,11,2,9,50,13
10705,32,67,26127,56,15,3,12,4,6
10706,35,67,26127,60,9,3,6,22,-9
10708,38,72,26127,12,2,0,2,0,-1
10709,32,71,8758,1,0,0,0,0,0
10710,35,71,8758,3,1,1,0,0,-3
10711,38,71,8758,66,23,14,9,36,-2
10712,41,71,8758,60,12,4,8,57,-1
10713,47,82,8758,80,30,17,13,95,-10
10714,50,82,8758,82,36,15,21,91,2
10715,53,82,8758,81,31,14,17,98,-5
10716,56,82,8758,49,22,8,14,41,8
10717,59,82,8758,39,17,8,9,47,-7
10718,59,89,8758,39,17,7,10,51,6
10719,62,89,8758,81,26,10,16,64,-10
10720,65,89,8758,82,39,20,19,78,4
10722,71,89,8758,82,42,15,27,36,4
10723,74,89,8758,77,19,7,12,51,-1
10724,77,89,8758,82,40,20,20,22,0
10725,80,76,8758,82,33,20,13,40,1
10726,83,76,8758,58,11,2,9,35,-11
10727,83,1479,8758,16,2,1,1,2,-1
10728,29,65,5666,8,2,1,1,2,-3
10729,32,65,5666,43,15,5,10,14,-4
10730,35,65,5666,81,53,17,36,47,8
10731,38,65,5666,82,42,15,27,40,-6
10732,41,65,5666,66,39,21,18,29,-18
10733,47,65,5666,79,59,26,33,52,-4
10734,50,77,5666,59,21,9,12,36,-31
10735,50,85,5666,19,14,5,9,22,6
10736,53,88,5666,65,20,7,13,18,-11
10737,56,88,5666,74,27,8,19,41,-1
10739,32,72,5984,5,1,1,0,4,0
10740,35,72,5984,1,0,0,0,0,-1
10741,38,72,5984,44,11,5,6,25,7
10742,41,72,5984,12,1,0,1,0,0
10743,8,63,8885,9,4,1,3,0,3
10744,11,63,8885,83,51,31,20,82,4
10745,14,63,8885,44,31,18,13,31,-3
10746,17,79,8885,81,64,24,40,69,6
10747,20,76,8885,64,56,28,28,25,9
10748,23,76,8885,81,43,13,30,34,-16
10749,26,76,8885,82,40,16,24,49,-7
10750,29,88,8885,79,56,20,36,48,2
10751,32,88,8885,78,59,27,32,40,10
10752,35,88,8885,80,38,13,25,56,7
10753,38,88,8885,58,38,18,20,18,-1
10754,38,80,8885,10,8,3,5,2,1
10756,47,80,8885,81,48,17,31,46,8
10757,50,65,8885,62,37,14,23,29,10
10758,50,84,8885,20,7,4,3,8,-3
10759,53,75,8885,64,25,8,17,20,-6
10760,14,1479,8996,47,39,18,21,4,-17
10761,17,1479,8996,82,108,50,58,20,9
10762,20,1479,8996,69,99,44,55,6,36
10763,23,1479,8996,22,31,17,14,23,12
10764,26,1479,8996,82,101,39,62,40,17
10765,29,1479,8996,74,86,42,44,24,22
10766,32,1479,8996,66,67,33,34,20,-9
10767,35,1479,8996,82,57,32,25,28,-15
10768,38,1479,8996,82,81,25,56,48,-3
10769,41,64,8996,51,36,11,25,22,-5
10770,47,73,8996,82,85,31,54,40,-6
10771,50,73,8996,82,76,24,52,36,6
10773,56,78,8996,11,15,2,13,2,1
10774,59,78,8996,75,43,18,25,36,-7
10775,23,74,73851,38,4,1,3,28,4
10776,2,74,21626,71,73,25,48,96,5
10777,5,74,21626,1,0,0,0,0,-1
10778,5,71,21626,49,49,20,29,60,5
10779,8,71,21626,46,40,8,32,40,-16
10780,8,72,21626,23,20,5,15,40,3
10781,11,72,21626,61,46,19,27,86,24
10782,14,65,21626,48,51,22,29,32,4
10783,17,65,21626,59,60,19,41,60,11
10784,20,86,21626,65,45,12,33,63,-21
10785,23,86,21626,60,28,6,22,26,-4
10786,26,86,21626,10,2,0,2,4,-4
10661,14,89,13521,16,3,0,3,6,-3
10662,17,64,13521,7,3,0,3,4,2
10791,38,71,8726,71,51,22,29,10,-8
10792,41,71,8726,61,42,16,26,15,18
10793,47,76,8726,75,52,13,39,30,-9
10794,50,76,8726,32,13,6,7,14,-9
10795,50,77,8726,34,8,4,4,8,-9
10797,56,82,8726,1,0,0,0,0,0
10798,2,63,31367,41,15,6,9,277,4
10799,5,63,31367,39,10,5,5,186,-5
10800,5,75,31367,17,4,1,3,74,-1
10801,14,71,1504,6,1,1,0,0,-5
10802,41,71,10821,6,1,1,0,2,2
10803,47,82,10821,1,0,0,0,0,0
10804,2,62,8947,79,85,45,40,36,19
10805,5,62,8947,69,56,22,34,55,-1
10806,8,62,8947,79,75,38,37,52,9
10807,11,62,8947,64,75,36,39,51,19
10809,17,70,8947,52,32,14,18,41,-17
10810,20,70,8947,66,51,30,21,32,-5
10811,23,70,8947,73,69,39,30,30,16
10812,26,70,8947,67,55,28,27,34,11
10813,29,70,8947,48,34,15,19,26,-1
10814,32,70,8947,69,52,29,23,30,5
10815,35,70,8947,67,47,23,24,18,-2
10816,35,72,8947,14,11,2,9,4,2
10817,38,72,8947,80,45,17,28,56,10
10818,41,83,8947,64,50,22,28,26,7
10819,47,68,8947,65,56,26,30,46,-2
10820,50,68,8947,15,8,5,3,4,-4
10821,2,65,53928,7,4,0,4,2,-1
10822,5,65,53928,65,31,19,12,81,9
10823,8,65,53928,63,30,16,14,82,3
10824,11,65,53928,64,35,14,21,57,2
10826,14,74,53928,45,27,14,13,26,-3
10827,17,78,53928,81,35,13,22,84,2
10828,20,78,53928,13,7,2,5,0,2
10829,20,74,53928,44,15,6,9,28,-7
10830,20,84,53928,16,12,4,8,6,2
10831,23,84,53928,82,25,10,15,62,-19
10838,17,64,9672,9,8,4,4,9,-3
10839,17,86,9672,72,61,29,32,137,-30
10840,20,86,9672,72,63,31,32,155,-19
10841,23,86,9672,75,41,14,27,144,-2
10842,26,86,9672,78,45,19,26,129,16
10843,29,86,9672,78,84,44,40,110,-1
10844,32,86,9672,57,49,24,25,75,0
10845,35,86,9672,75,66,23,43,93,7
10846,38,86,9672,61,42,22,20,91,-5
10847,38,83,9672,14,12,7,5,16,2
10850,53,62,9672,77,32,16,16,71,6
10851,56,69,9672,59,45,25,20,26,5
10852,59,69,9672,73,33,16,17,40,-12
10853,26,81,18532,19,2,1,1,10,1
10854,29,81,18532,4,0,0,0,6,-4
10856,2,84,1450,45,8,2,6,63,-10
10857,29,67,8558,12,5,1,4,4,-2
10858,32,67,8558,8,0,0,0,2,-2
10859,35,67,8558,29,6,3,3,12,0
10860,38,67,8558,65,19,2,17,20,-8
10861,41,67,8558,53,11,3,8,12,-8
10862,47,67,8558,79,44,12,32,16,-14
10863,50,67,8558,82,48,6,42,35,28
10864,53,67,8558,63,43,5,38,12,-1
10865,53,86,8558,20,19,3,16,8,9
10866,56,65,8558,82,52,7,45,22,5
10868,62,65,8558,65,27,5,22,6,28
10869,65,68,8558,82,53,4,49,6,-9
10870,68,68,8558,48,27,8,19,12,-22
10871,71,68,8558,82,37,7,30,20,-6
10872,74,68,8558,82,27,3,24,22,4
10873,77,68,8558,82,31,6,25,26,31
10874,80,65,8558,80,17,5,12,24,12
10875,2,76,31350,44,28,3,25,16,-13
10876,5,76,31350,28,19,1,18,18,2
10877,8,76,31350,66,50,12,38,45,-3
10878,11,86,31350,64,40,7,33,36,16
10879,14,86,31350,20,10,1,9,39,1
10880,14,78,31350,28,20,2,18,33,21
10881,17,78,31350,36,11,4,7,26,4
10882,17,71,31350,30,20,4,16,16,5
10883,20,71,31350,62,13,2,11,42,-7
10885,23,81,31350,37,10,4,6,26,-25
10886,23,68,31350,19,7,0,7,18,-7
10887,26,68,31350,3,0,0,0,2,0
10888,26,86,31350,69,22,4,18,42,2
10889,29,86,31350,62,20,0,20,49,-2
10890,32,79,31350,32,12,2,10,20,8
10891,32,86,31350,10,1,0,1,8,4
10892,35,68,31350,29,4,0,4,8,-5
10893,35,63,31350,3,1,0,1,2,0
10894,8,80,74525,1,0,0,0,2,0
10895,32,72,10696,11,0,0,0,4,7
10896,35,72,10696,2,0,0,0,0,-2
10897,35,81,10696,9,0,0,0,0,0
10898,2,85,66114,21,10,3,7,50,6
10899,2,72,66114,28,5,3,2,87,-1
10901,5,78,66114,44,14,3,11,94,14
10903,11,62,66114,16,1,0,1,16,3
10904,29,85,69557,1,0,0,0,0,0
10905,32,77,8523,53,10,5,5,109,0
10906,35,77,8523,55,7,3,4,141,-2
10907,38,77,8523,63,6,1,5,105,1
10908,41,77,8523,49,5,1,4,136,-4
10909,47,1479,8523,76,23,4,19,174,6
10910,50,1479,8523,10,3,0,3,36,2
10911,50,77,8523,48,11,3,8,84,-11
10912,53,70,8523,11,2,0,2,33,2
10913,53,69,8523,58,11,6,5,106,0
10915,59,81,8523,50,6,3,3,54,-12
10916,47,63,10404,1,0,0,0,0,0
10917,50,64,10404,39,11,3,8,16,-4
10788,32,74,8726,79,31,14,17,20,1
10789,35,74,8726,69,57,18,39,16,8
10922,32,78,5519,40,16,8,8,20,-2
10929,50,70,5519,25,14,4,10,6,-3
10930,53,88,5519,38,26,9,17,18,-2
10931,68,83,24180,35,8,0,8,27,-7
10932,71,65,24180,9,3,2,1,8,3
10933,71,81,24180,19,8,2,6,0,7
10934,74,74,24180,7,1,0,1,0,1
10935,77,80,24180,15,1,0,1,4,6
10936,53,80,15309,1,0,0,0,2,0
10937,56,80,15309,76,18,3,15,33,0
10938,59,80,15309,52,13,2,11,22,-1
10939,62,80,15309,72,13,4,9,42,-9
10940,65,80,15309,32,8,2,6,22,2
10941,71,68,15309,52,18,9,9,38,-2
10955,41,70,2682,62,17,3,14,18,-5
10956,47,67,2682,75,40,2,38,36,6
10958,53,67,2682,1,0,0,0,0,0
10959,56,67,2682,57,17,2,15,22,-4
10960,32,74,13948,18,3,0,3,13,-6
10961,35,74,13948,1,0,0,0,0,0
10962,38,62,13948,4,0,0,0,0,-1
10963,53,72,13948,76,17,4,13,48,-11
10964,56,72,13948,80,15,1,14,35,24
10965,59,72,13948,79,18,2,16,41,4
10966,62,76,13948,20,3,0,3,8,-12
10967,65,76,13948,29,2,0,2,15,-10
10968,65,63,13948,6,0,0,0,0,-1
10969,71,68,13948,8,0,0,0,4,-3
10970,2,76,71579,72,23,2,21,105,-8
10971,5,76,71579,7,1,0,1,10,-3
10972,8,76,71579,22,2,1,1,43,-2
10973,65,67,15056,2,0,0,0,0,0
10975,29,63,2669,27,9,6,3,2,3
10976,32,69,2669,82,28,12,16,24,-7
10977,35,69,2669,82,33,16,17,22,-5
10978,38,69,2669,82,31,15,16,26,4
10979,41,69,2669,77,26,12,14,20,0
10980,47,64,2669,81,34,16,18,40,-2
10981,50,64,2669,41,4,3,1,16,-3
10982,8,75,25607,1,0,0,0,0,-1
10983,11,75,25607,2,0,0,0,2,-2
10984,14,75,25607,41,7,6,1,86,0
10985,17,75,25607,80,25,9,16,167,-2
10986,20,75,25607,65,21,8,13,97,-14
10987,23,75,25607,63,10,4,6,110,-8
10988,26,75,25607,69,27,10,17,88,6
10989,29,75,25607,64,21,8,13,61,-1
10990,32,72,25607,69,26,8,18,97,11
10992,38,72,25607,77,20,7,13,115,7
10993,41,72,25607,61,27,14,13,76,0
10994,47,77,25607,31,4,1,3,45,-2
10995,11,63,25635,57,9,3,6,66,-6
10996,14,63,25635,5,0,0,0,2,0
10997,17,63,25635,6,0,0,0,0,-2
10998,20,63,25635,15,1,0,1,4,-2
10999,29,68,25635,65,16,9,7,30,-2
11000,32,69,25635,54,13,4,9,18,-3
11001,59,63,17938,2,0,0,0,0,0
11002,47,66,395,43,6,4,2,30,-4
11003,47,79,395,15,0,0,0,4,-4
11004,38,1479,15727,2,0,0,0,8,0
11005,41,1479,15727,31,3,3,0,50,-3
11006,47,82,15727,4,0,0,0,5,0
11007,2,72,67384,22,4,3,1,41,3
11009,8,72,67384,7,0,0,0,9,-4
11010,11,1479,67384,5,1,0,1,6,0
11011,74,86,9423,2,1,1,0,0,-1
11012,77,86,9423,6,0,0,0,0,1
11013,56,88,17696,17,3,0,3,18,1
11014,59,88,17696,42,8,1,7,14,-4
11015,62,88,17696,38,5,0,5,19,-1
11016,65,88,17696,9,2,2,0,2,0
11017,68,88,17696,20,4,1,3,14,3
11018,68,75,17696,9,3,1,2,0,0
11019,53,76,17778,2,1,0,1,4,1
11020,56,76,17778,40,6,1,5,16,-9
11021,59,76,17778,69,21,3,18,44,-5
11022,62,76,17778,64,22,4,18,45,-5
11023,65,73,17778,55,6,2,4,20,6
11024,68,89,17778,23,9,3,6,14,9
11026,74,89,17778,35,5,0,5,10,1
11027,74,66,17778,3,0,0,0,0,-2
11028,56,68,24170,1,0,0,0,0,0
11029,59,68,24170,39,8,2,6,23,5
11030,62,68,24170,73,18,5,13,26,-2
11031,65,68,24170,77,33,16,17,32,6
11032,68,84,24170,47,16,8,8,28,18
11033,71,84,24170,81,33,7,26,57,-5
11034,74,81,24170,70,30,4,26,19,27
11035,77,81,24170,72,11,5,6,18,-4
11036,80,81,24170,70,9,1,8,14,-8
11037,83,20120,24170,8,1,0,1,4,-2
11038,86,71,24170,17,1,1,0,8,1
11039,29,79,8706,30,6,2,4,20,3
11040,32,79,8706,36,15,4,11,28,6
11041,35,79,8706,75,11,4,7,73,-12
11043,38,62,8706,16,4,0,4,6,1
11044,41,62,8706,72,16,4,12,53,5
11045,47,62,8706,82,31,4,27,85,-12
11046,50,62,8706,54,12,2,10,66,7
11047,50,63,8706,26,3,1,2,31,-2
11048,53,63,8706,59,15,1,14,50,-14
11049,56,63,8706,47,16,1,15,40,7
11050,59,63,8706,51,8,0,8,16,-7
11051,62,63,8706,70,15,3,12,60,22
11052,65,63,8706,72,24,6,18,46,9
11053,68,63,8706,48,13,4,9,35,9
11054,71,71,8706,71,18,3,15,63,-18
11055,74,71,8706,70,14,3,11,39,-17
11056,77,71,8706,6,0,0,0,6,-4
10919,56,64,10404,50,12,5,7,30,2
10920,59,73,10404,6,0,0,0,4,-3
11061,5,78,21364,54,69,10,59,12,-4
11062,5,63,21364,26,30,10,20,10,-5
11063,8,63,21364,84,142,45,97,32,15
11064,11,63,21364,77,112,32,80,45,10
11065,14,63,21364,48,53,12,41,8,-11
11066,17,63,21364,70,92,25,67,18,16
11067,20,63,21364,63,70,18,52,10,-3
11068,20,89,21364,17,12,4,8,4,-2
11069,23,89,21364,82,76,18,58,36,6
11070,26,89,21364,59,54,12,42,22,-1
11071,29,89,21364,82,71,15,56,14,13
11072,32,89,21364,81,82,13,69,28,-9
11073,35,89,21364,66,68,11,57,22,-2
11074,35,77,21364,14,10,3,7,6,-2
11075,38,1479,21364,67,45,9,36,16,-1
11076,41,71,21364,60,18,2,16,8,0
11081,14,70,71759,2,0,0,0,0,0
11082,17,70,71759,1,0,0,0,2,-1
11083,2,75,8934,52,2,0,2,259,7
11084,5,75,8934,71,8,1,7,212,15
11085,8,75,8934,83,16,2,14,205,35
11086,11,75,8934,79,40,11,29,276,8
11087,14,75,8934,48,10,3,7,152,-13
11088,17,75,8934,79,17,3,14,230,8
11089,20,72,8934,79,16,3,13,110,16
11090,23,72,8934,79,23,4,19,171,11
11091,26,72,8934,70,31,5,26,114,6
11092,29,72,8934,57,16,1,15,104,-10
11094,32,82,8934,81,17,3,14,118,-16
11095,35,82,8934,65,16,2,14,89,-28
11096,35,65,8934,12,2,0,2,4,0
11097,38,65,8934,65,11,7,4,76,7
11099,41,68,8934,82,16,4,12,88,-7
11100,47,79,8934,27,1,0,1,50,-10
11101,62,86,17955,6,1,1,0,7,-1
11102,62,73,17850,15,3,0,3,2,0
11103,65,73,17850,4,0,0,0,0,-1
11104,68,73,17850,18,5,2,3,6,-4
11105,71,70,17850,9,0,0,0,0,-2
11106,74,74,17850,7,2,1,1,0,-1
11107,8,72,64992,2,1,0,1,0,-1
11108,2,84,25440,45,8,7,1,296,-6
11109,5,84,25440,65,10,4,6,348,-1
11110,8,84,25440,75,17,4,13,370,3
11111,11,84,25440,76,29,16,13,271,13
11112,14,84,25440,23,9,4,5,109,-3
11113,17,84,25440,55,7,3,4,181,-16
11114,20,84,25440,70,13,5,8,371,-5
11116,23,76,25440,13,0,0,0,31,1
11117,26,76,25440,23,7,4,3,133,-2
11118,29,76,25440,46,15,5,10,90,-7
11119,29,77,25440,13,4,3,1,10,2
11120,32,77,25440,17,4,1,3,28,0
11121,32,75,25440,13,1,1,0,44,0
11122,35,75,25440,36,8,4,4,104,3
11123,32,86,8879,42,4,2,2,51,2
11124,35,86,8879,49,6,3,3,72,-1
11125,38,86,8879,75,15,4,11,64,1
11126,41,86,8879,36,4,1,3,72,-5
11127,47,86,8879,80,24,9,15,97,3
11128,50,86,8879,41,13,3,10,42,-4
11129,53,62,8879,54,4,1,3,59,-6
11130,5,86,11225,64,19,8,11,15,-18
11131,8,86,11225,81,14,6,8,30,-42
11133,11,62,11225,19,5,2,3,6,2
11134,14,62,11225,38,11,4,7,14,-2
11135,17,62,11225,81,21,9,12,24,-6
11136,20,62,11225,67,11,5,6,10,-11
11137,23,63,11225,77,18,5,13,34,-1
11142,8,72,1890,31,13,4,9,14,-2
11143,29,71,69588,15,3,1,2,4,-2
11144,38,1479,483096,4,0,0,0,0,-1
11145,47,1479,483096,79,27,13,14,48,2
11146,38,82,8741,3,0,0,0,0,-1
11147,41,82,8741,29,3,1,2,36,-7
11148,29,80,9626,6,0,0,0,2,0
11149,32,80,9626,71,33,3,30,60,17
11150,35,80,9626,51,18,3,15,24,7
11151,38,80,9626,58,29,4,25,30,23
11152,41,80,9626,60,17,1,16,29,17
11154,50,74,9626,66,26,6,20,38,-9
11155,53,72,9626,47,13,4,9,40,3
11160,11,71,83867,55,28,9,19,20,-4
11161,14,71,83867,33,10,0,10,20,-4
11162,17,71,83867,20,6,0,6,14,-14
11163,17,1479,83867,36,18,2,16,24,7
11164,20,1479,83867,20,11,2,9,8,-5
11165,20,79,83867,51,27,7,20,24,21
11166,23,79,83867,76,33,6,27,42,13
11167,26,1479,83867,74,56,16,40,30,17
11168,29,1479,83867,70,34,15,19,28,-13
11169,35,85,83867,47,15,2,13,22,9
11170,38,1479,83867,44,8,2,6,22,0
11171,2,74,72250,79,54,31,23,10,15
11172,5,74,72250,55,30,17,13,22,6
11173,8,85,72250,19,12,6,6,2,-2
11178,41,73,8881,18,4,3,1,2,2
11179,47,76,8881,42,8,0,8,26,-7
11180,50,69,8881,61,6,3,3,16,-8
11181,53,64,8881,25,3,0,3,8,-4
11182,2,83,27048,18,14,4,10,13,-7
11186,8,74,27048,46,29,13,16,26,9
11187,11,74,27048,37,8,3,5,28,-1
11188,14,74,27048,20,3,2,1,4,-2
11191,20,88,27048,67,44,21,23,45,-22
11192,20,79,27048,12,11,4,7,6,8
11193,23,79,27048,56,22,11,11,35,-9
11194,26,65,27048,61,25,10,15,29,-3
11195,29,65,27048,33,4,2,2,12,-8
11196,56,85,7411,13,9,5,4,6,5
11058,41,81,8630,63,9,2,7,30,-1
11059,47,81,8630,65,8,2,6,22,-9
11201,68,67,7411,8,6,2,4,6,0
11202,71,67,7411,58,15,0,15,10,-16
11203,14,68,438,19,7,2,5,10,5
11204,17,68,438,27,11,2,9,21,-1
11205,68,68,55218,2,1,0,1,17,2
11206,77,87,55218,1,0,0,0,5,0
11207,56,70,6654,55,29,17,12,8,-8
11208,59,70,6654,44,11,2,9,10,-3
11209,65,85,6654,5,1,0,1,4,-2
11210,5,88,8904,18,6,1,5,22,-3
11211,8,88,8904,80,29,6,23,63,-2
11212,11,88,8904,84,35,8,27,94,-9
11213,14,88,8904,48,23,4,19,36,-2
11214,17,88,8904,58,12,1,11,34,-11
11215,17,70,8904,26,8,2,6,41,-1
11216,20,70,8904,82,48,8,40,51,37
11218,26,70,8904,74,48,14,34,50,-1
11219,29,70,8904,74,34,8,26,32,6
11220,32,70,8904,81,47,10,37,34,5
11221,35,70,8904,78,33,4,29,50,3
11222,38,70,8904,81,36,5,31,40,22
11223,41,82,8904,49,15,2,13,26,-19
11224,41,81,8904,31,7,1,6,6,3
11225,47,81,8904,80,23,4,19,30,-18
11226,50,70,8904,74,21,5,16,36,-4
11227,53,79,8904,74,13,1,12,26,1
11228,56,79,8904,8,2,1,1,2,5
11229,56,70,8904,65,13,2,11,16,-2
11230,59,78,8904,47,8,0,8,15,-6
11231,56,72,7553,17,3,0,3,6,1
11234,59,72,7553,9,3,1,2,0,-5
11235,62,72,7553,48,7,1,6,14,-11
11237,29,63,13509,16,4,1,3,9,1
11238,32,63,13509,13,0,0,0,26,-1
11239,26,72,8715,4,1,0,1,0,-2
11240,29,72,8715,74,25,16,9,6,7
11241,32,72,8715,80,38,23,15,12,24
11242,35,72,8715,82,23,15,8,25,6
11243,38,72,8715,80,41,19,22,26,13
11244,41,72,8715,80,35,12,23,22,7
11245,47,72,8715,82,36,16,20,36,-7
11246,50,72,8715,74,32,12,20,14,-7
11247,53,72,8715,80,43,20,23,26,1
11248,56,72,8715,76,23,7,16,26,-7
11249,59,65,8715,79,23,10,13,12,-2
11250,62,69,8715,76,25,12,13,10,-9
11251,65,68,8715,31,3,3,0,4,-4
11252,11,79,27580,12,0,0,0,9,3
11254,17,79,27580,70,14,4,10,153,20
11255,20,79,27580,45,6,2,4,131,-25
11256,23,79,27580,79,7,0,7,181,4
11257,26,79,27580,11,0,0,0,32,-2
11258,26,74,27580,52,6,1,5,92,-12
11264,56,81,11113,79,46,23,23,39,-13
11265,59,81,11113,82,95,51,44,38,-2
11266,62,81,11113,82,91,45,46,74,3
11267,65,81,11113,82,97,60,37,66,7
11268,68,81,11113,48,57,29,28,32,-4
11269,71,81,11113,37,40,25,15,18,9
11270,74,81,11113,82,72,43,29,49,2
11271,77,81,11113,77,64,36,28,38,3
11272,80,81,11113,17,20,9,11,14,3
11273,83,81,11113,78,86,27,59,72,18
11274,86,81,11113,82,98,45,53,37,4
11276,59,82,11863,13,2,2,0,8,0
11277,62,82,11863,23,7,0,7,8,3
11278,65,80,11863,9,1,0,1,4,1
11282,65,547,14434,65,30,5,25,71,-3
11283,68,547,14434,33,14,5,9,29,-5
11284,71,547,14434,55,11,3,8,48,3
11285,74,547,14434,41,13,3,10,40,1
11286,74,67,14434,21,7,0,7,38,-7
11287,77,67,14434,64,24,7,17,68,-11
11288,80,67,14434,56,11,2,9,46,-17
11289,83,67,14434,18,1,0,1,20,-9
11290,86,67,14434,65,19,3,16,52,-5
11291,56,83,11397,70,14,2,12,71,-12
11292,59,83,11397,79,17,5,12,50,2
11293,62,83,11397,82,22,5,17,34,-7
11294,65,83,11397,79,22,2,20,62,-6
11296,71,77,11397,79,12,4,8,58,0
11297,74,77,11397,58,14,3,11,18,-2
11298,77,77,11397,29,5,2,3,30,-7
11299,77,88,11397,43,11,2,9,52,5
11300,80,87,11397,78,8,1,7,85,-9
11301,83,87,11397,64,7,1,6,35,-12
11302,86,1479,11397,8,0,0,0,7,-6
11303,86,84,11397,18,2,0,2,9,-4
11304,14,76,14507,10,3,0,3,2,1
11305,17,76,14507,11,1,0,1,2,1
11306,20,76,14507,1,0,0,0,0,0
11307,26,63,14507,37,8,3,5,12,-3
11308,29,67,14507,11,2,1,1,2,-2
11309,32,67,14507,14,2,0,2,6,1
11310,38,67,14507,11,4,1,3,2,-1
11311,41,67,14507,54,12,6,6,22,-2
11313,29,62,516465,56,18,3,15,22,-5
11314,32,81,516465,78,40,18,22,12,-4
11315,35,81,516465,53,35,16,19,20,4
11316,38,81,516465,82,70,33,37,32,10
11317,41,81,516465,82,94,38,56,24,35
11318,47,81,516465,80,61,31,30,38,-3
11319,50,81,516465,82,102,43,59,28,7
11320,53,81,516465,82,83,25,58,26,-23
11321,56,81,516465,82,80,30,50,14,4
11322,59,81,516465,82,94,29,65,12,-8
11323,62,81,516465,82,99,31,68,12,0
11324,65,81,516465,77,74,25,49,16,-3
11325,68,81,516465,48,60,17,43,14,0
11326,71,81,516465,62,61,29,32,6,12
11198,59,77,7411,13,4,2,2,4,2
11199,62,77,7411,81,53,19,34,22,14
11331,65,67,11253,20,8,3,5,2,-7
11332,68,67,11253,48,34,15,19,20,-4
11333,71,67,11253,72,44,20,24,20,-26
11334,74,67,11253,78,13,6,7,12,-28
11335,77,73,11253,39,8,3,5,6,2
11342,74,87,5998,45,28,14,14,6,-10
11343,77,87,5998,62,39,13,26,10,-28
11344,77,64,5998,18,12,4,8,2,-5
11345,80,86,5998,81,26,10,16,10,0
11346,83,86,5998,74,37,15,22,12,0
11347,86,80,5998,71,35,7,28,6,-23
11348,56,76,14009,68,25,7,18,16,-14
11349,59,76,14009,73,35,16,19,18,5
11350,62,76,14009,70,28,11,17,37,-13
11351,65,76,14009,80,32,13,19,32,-10
11352,68,76,14009,38,19,11,8,6,7
11354,74,76,14009,70,41,15,26,12,3
11355,77,76,14009,81,32,12,20,22,-7
11356,80,76,14009,82,56,13,43,12,5
11357,83,76,14009,76,71,18,53,17,-20
11358,86,76,14009,82,56,16,40,21,8
11359,59,67,17518,82,48,11,37,32,13
11360,62,67,17518,80,37,10,27,40,0
11361,65,67,17518,55,23,8,15,33,5
11362,68,67,17518,39,8,3,5,32,-8
11363,71,67,17518,62,22,9,13,58,-26
11364,74,67,17518,47,13,4,9,61,-15
11365,74,547,17518,24,15,3,12,16,9
11366,77,547,17518,73,27,9,18,72,6
11367,80,547,17518,11,5,2,3,13,5
11368,83,547,17518,82,36,6,30,48,9
11369,86,547,17518,80,31,9,22,63,11
11371,62,73,9322,82,34,16,18,17,9
11372,65,73,9322,68,35,15,20,21,5
11373,68,73,9322,25,19,7,12,4,1
11374,71,73,9322,81,33,11,22,21,-1
11375,74,73,9322,77,42,20,22,22,19
11376,77,73,9322,64,24,6,18,14,-1
11377,80,73,9322,70,35,12,23,18,7
11378,83,64,9322,56,18,6,12,6,-5
11379,86,64,9322,65,27,12,15,8,-6
11380,11,85,8846,1,1,1,0,0,-1
11381,14,85,8846,22,4,0,4,16,3
11382,17,85,8846,72,25,11,14,39,11
11383,20,85,8846,44,7,3,4,52,-6
11384,23,63,8846,79,31,20,11,57,-16
11385,26,63,8846,49,11,4,7,55,-10
11386,29,74,8846,76,20,9,11,72,-4
11388,35,81,8846,48,8,4,4,25,-2
11389,38,81,8846,82,12,4,8,38,-13
11390,41,81,8846,82,22,7,15,25,-5
11391,47,81,8846,82,13,7,6,22,-12
11392,50,81,8846,71,6,1,5,16,-5
11393,56,66,11052,2,0,0,0,0,0
11394,59,66,11052,31,9,3,6,2,1
11395,62,66,11052,23,7,4,3,4,-2
11396,65,66,11052,16,2,0,2,0,-3
11397,68,66,11052,1,0,0,0,0,0
11398,68,79,11052,7,0,0,0,2,-2
11399,68,73,11052,5,2,1,1,4,1
11400,71,66,11052,11,4,1,3,0,2
11401,74,66,11052,31,6,3,3,4,0
11402,59,80,3967,60,26,5,21,24,-5
11403,62,80,3967,75,45,13,32,50,-30
11405,68,80,3967,17,14,6,8,8,8
11406,71,80,3967,82,74,20,54,36,-15
11407,74,80,3967,82,66,21,45,42,7
11408,77,80,3967,82,82,16,66,50,-2
11409,80,80,3967,77,71,17,54,28,10
11410,83,80,3967,71,62,9,53,36,-25
11411,86,86,3967,53,45,3,42,22,6
11412,56,77,13937,39,7,0,7,36,-6
11413,59,1479,13937,8,0,0,0,6,-1
11414,62,1479,13937,68,11,2,9,43,-11
11415,65,1479,13937,80,24,5,19,66,-5
11416,68,1479,13937,41,8,1,7,23,0
11417,71,1479,13937,30,6,1,5,43,0
11418,74,84,13937,76,11,3,8,46,-8
11419,77,84,13937,41,8,2,6,26,5
11420,80,84,13937,82,13,2,11,40,-1
11422,86,76,13937,9,1,0,1,4,0
11423,62,83,18588,1,1,0,1,0,1
11424,65,83,18588,10,5,1,4,4,2
11425,68,83,18588,5,0,0,0,2,-1
11426,71,62,18588,80,28,10,18,34,-17
11427,74,62,18588,64,28,8,20,43,7
11428,77,62,18588,73,44,19,25,27,-9
11429,80,64,18588,62,8,4,4,34,-21
11430,65,83,18589,75,30,7,23,18,-2
11431,68,83,18589,12,4,0,4,0,0
11432,71,83,18589,80,31,10,21,19,-3
11433,74,83,18589,79,24,4,20,24,-23
11434,77,83,18589,79,31,7,24,32,-15
11435,80,83,18589,82,43,9,34,34,24
11436,83,83,18589,82,52,5,47,32,9
11437,86,83,18589,62,30,3,27,26,19
11439,65,72,6011,43,6,1,5,16,-15
11440,68,72,6011,4,1,0,1,2,0
11441,71,72,6011,15,1,1,0,10,-8
11442,8,65,64502,1,0,0,0,0,0
11443,59,74,12111,80,37,9,28,32,-20
11444,62,74,12111,47,11,2,9,20,-5
11445,65,74,12111,77,41,10,31,36,20
11446,68,74,12111,46,21,3,18,18,6
11447,71,74,12111,42,11,2,9,10,-5
11448,71,73,12111,25,5,1,4,8,-4
11449,74,77,12111,64,32,10,22,34,-5
11450,77,77,12111,52,13,4,9,16,-8
11451,80,77,12111,51,18,6,12,28,-5
11452,83,84,12111,82,22,6,16,48,-8
11328,74,74,516465,74,52,21,31,20,12
11329,62,84,11253,8,2,1,1,0,1
11457,35,69,8780,76,27,15,12,16,-10
11458,38,69,8780,80,48,20,28,44,17
11459,41,69,8780,59,26,11,15,20,5
11460,47,69,8780,67,26,10,16,40,-10
11461,50,69,8780,48,13,10,3,38,-7
11462,50,74,8780,6,1,1,0,0,-4
11465,53,79,8780,16,12,2,10,8,4
11466,56,79,8780,71,28,12,16,30,1
11467,59,79,8780,81,38,18,20,16,5
11468,62,79,8780,81,37,17,20,59,16
11469,65,79,8780,82,59,25,34,34,18
11470,68,79,8780,48,38,20,18,26,31
11471,71,79,8780,39,20,7,13,8,6
11472,74,79,8780,16,11,6,5,4,2
11473,77,79,8780,18,4,2,2,12,-1
11474,14,77,8844,48,13,3,10,38,8
11476,20,77,8844,71,24,2,22,64,27
11477,23,77,8844,78,19,3,16,80,5
11478,26,77,8844,74,18,3,15,48,16
11479,29,77,8844,80,13,4,9,66,11
11480,32,77,8844,73,14,2,12,48,22
11481,35,77,8844,77,14,4,10,30,16
11482,38,77,8844,67,7,1,6,36,10
11483,41,77,8844,56,10,1,9,50,2
11484,41,70,8844,11,0,0,0,2,4
11485,47,77,8844,47,4,0,4,34,-7
11486,62,71,11095,69,43,18,25,22,-12
11487,65,71,11095,78,76,34,42,10,4
11488,68,71,11095,48,37,16,21,16,-4
11489,71,71,11095,80,65,28,37,18,-11
11490,74,71,11095,81,63,24,39,24,-16
11491,77,71,11095,69,47,25,22,14,-12
11493,83,76,11095,81,59,25,34,21,5
11494,86,76,11095,78,37,19,18,17,-6
11495,23,65,5526,7,1,1,0,2,0
11496,26,65,5526,35,13,5,8,20,-1
11497,29,65,5526,1,0,0,0,0,0
11498,29,77,5526,3,1,1,0,0,-1
11499,32,80,5526,16,5,4,1,4,5
11500,35,80,5526,81,50,20,30,24,12
11501,38,80,5526,80,60,25,35,28,19
11502,41,80,5526,53,29,9,20,22,12
11503,47,69,5526,61,40,19,21,18,-1
11504,50,69,5526,77,44,13,31,24,8
11508,62,74,5526,18,2,1,1,2,-2
11509,59,67,11662,10,9,3,6,6,1
11510,62,67,11662,82,49,20,29,30,0
11511,65,67,11662,48,34,15,19,14,11
11513,71,67,11662,80,43,21,22,42,-25
11514,74,67,11662,78,46,20,26,37,-19
11515,77,67,11662,23,11,3,8,11,-9
11516,80,67,11662,51,13,5,8,12,-10
11517,83,69,11662,73,22,8,14,12,-1
11518,86,83,11662,51,18,12,6,2,-6
11519,35,79,9016,11,3,1,2,9,-1
11520,38,79,9016,8,1,0,1,0,-4
11521,41,79,9016,60,22,9,13,67,-14
11522,47,88,9016,76,22,8,14,100,-8
11523,50,88,9016,76,22,7,15,73,-2
11524,53,75,9016,67,13,7,6,113,-3
11525,56,75,9016,78,22,8,14,106,-1
11526,59,66,9016,82,21,8,13,106,4
11527,62,66,9016,17,4,1,3,30,-1
11528,62,62,9016,59,14,7,7,44,-3
11530,68,72,9016,15,1,1,0,18,0
11531,41,81,327633,4,0,0,0,0,-1
11532,50,81,327633,82,36,13,23,30,-7
11535,8,67,80764,7,2,1,1,15,2
11536,11,67,80764,32,4,2,2,8,-6
11537,32,88,80764,24,4,3,1,9,0
11538,59,89,18586,22,6,1,5,8,11
11539,62,89,18586,82,37,7,30,44,21
11540,65,89,18586,82,32,9,23,22,-15
11541,68,89,18586,48,22,6,16,18,11
11542,71,89,18586,82,37,10,27,22,-3
11543,74,89,18586,82,55,12,43,28,11
11544,77,89,18586,56,39,8,31,14,16
11545,80,89,18586,72,37,9,28,10,7
11546,83,89,18586,82,68,15,53,32,0
11547,86,89,18586,80,70,13,57,34,21
11550,77,87,15232,39,6,3,3,14,-6
11551,65,82,18590,1,0,0,0,0,1
11552,68,82,18590,11,1,1,0,0,-3
11553,71,82,18590,5,0,0,0,2,0
11554,74,82,18590,36,9,0,9,19,12
11555,77,82,18590,43,8,1,7,20,-3
11556,80,64,18590,33,5,0,5,25,-11
11557,86,80,18590,5,0,0,0,2,0
11558,71,89,16711,3,0,0,0,0,-1
11559,62,78,13502,15,3,1,2,2,-10
11560,65,73,12669,52,16,5,11,14,1
11561,68,73,12669,48,18,5,13,8,-7
11562,71,73,12669,72,40,13,27,18,-2
11563,74,73,12669,81,55,15,40,26,15
11564,77,73,12669,81,61,14,47,43,-3
11565,80,73,12669,72,49,12,37,18,7
11567,86,73,12669,82,56,15,41,42,9
11568,68,71,18236,48,27,8,19,8,-17
11569,71,71,18236,74,33,11,22,16,-22
11570,74,71,18236,81,31,6,25,12,-17
11571,77,71,18236,45,10,3,7,14,-22
11572,77,79,18236,18,8,1,7,2,7
11573,80,79,18236,78,51,12,39,34,27
11574,83,79,18236,63,27,4,23,14,22
11575,86,79,18236,29,15,2,13,4,0
11576,8,65,42305,13,1,0,1,30,7
11577,14,76,42305,2,0,0,0,2,-1
11578,17,76,42305,8,4,0,4,8,3
11579,65,76,17496,9,0,0,0,2,0
11580,71,76,17496,20,3,1,2,10,-13
11454,86,1479,12111,12,3,0,3,0,-3
11455,86,78,12111,7,3,0,3,0,-2
11585,68,80,15526,42,19,5,14,39,9
11586,71,80,15526,53,23,4,19,20,-1
11587,74,80,15526,56,13,3,10,28,3
11588,77,80,15526,52,5,0,5,24,2
11589,80,64,15526,57,12,4,8,23,-18
11590,65,68,17513,3,0,0,0,0,1
11591,68,68,17513,16,1,0,1,17,-1
11592,71,68,17513,16,2,0,2,6,-4
11593,74,68,17513,7,0,0,0,2,-1
11594,74,1479,17513,5,1,0,1,0,3
11595,65,63,229850,1,0,0,0,0,0
11596,62,84,11321,5,0,0,0,0,-2
11597,71,84,11321,3,0,0,0,0,-2
11598,62,67,13786,19,4,3,1,12,-6
11599,65,67,13786,52,20,10,10,14,-6
11600,68,67,13786,4,1,1,0,2,1
11602,74,82,13786,3,0,0,0,4,0
11603,62,66,18247,15,4,3,1,0,0
11604,65,66,18247,16,3,1,2,4,-3
11605,68,66,18247,10,3,1,2,0,-7
11606,71,84,18247,55,7,4,3,6,-7
11607,74,67,18247,21,3,1,2,4,-11
11608,77,69,18247,2,1,1,0,0,0
11609,80,69,18247,9,3,1,2,9,0
11610,83,82,18247,12,0,0,0,13,-3
11611,86,82,18247,1,1,0,1,0,1
11612,62,64,16586,11,1,1,0,16,-3
11613,71,70,16586,9,0,0,0,7,1
11614,80,79,16586,12,4,1,3,13,1
11615,86,81,16586,2,0,0,0,7,3
11616,62,76,17533,62,26,5,21,103,4
11617,65,76,17533,73,24,2,22,73,6
11619,71,76,17533,69,18,3,15,68,2
11620,74,76,17533,71,33,5,28,85,15
11621,77,76,17533,72,21,5,16,35,-5
11622,80,76,17533,49,14,3,11,60,-21
11623,83,62,17533,74,11,1,10,79,-9
11624,86,62,17533,69,19,7,12,33,21
11625,62,74,19039,82,45,21,24,20,8
11626,65,74,19039,82,51,17,34,22,14
11627,68,74,19039,48,44,18,26,12,25
11628,71,74,19039,82,57,17,40,18,12
11629,74,74,19039,68,55,16,39,22,26
11630,77,74,19039,72,53,22,31,20,5
11631,80,74,19039,81,55,17,38,16,19
11632,83,87,19039,82,56,14,42,26,-7
11633,86,87,19039,72,35,15,20,14,-2
11634,32,68,8903,43,6,5,1,21,0
11636,47,68,8903,71,6,2,4,26,-7
11637,50,80,8903,5,0,0,0,0,-1
11638,68,66,10157,2,0,0,0,2,-2
11649,32,78,8852,12,8,6,2,14,-3
11650,35,78,8852,73,75,38,37,117,21
11651,38,78,8852,56,55,31,24,139,1
11652,41,78,8852,75,71,33,38,83,8
11653,47,78,8852,41,36,15,21,46,-15
11654,50,78,8852,61,43,20,23,92,3
11656,53,78,8852,79,58,27,31,69,-2
11657,56,78,8852,79,49,25,24,61,-11
11658,59,78,8852,67,32,13,19,56,-2
11660,65,547,19044,9,0,0,0,0,1
11661,68,547,19044,10,0,0,0,7,-3
11662,71,547,19044,9,3,0,3,7,2
11663,74,547,19044,1,0,0,0,0,0
11665,62,69,17515,20,2,0,2,2,-9
11666,65,69,17515,63,12,3,9,19,-22
11667,68,69,17515,6,1,1,0,4,-1
11668,71,69,17515,76,17,3,14,20,10
11669,74,69,17515,64,23,11,12,56,8
11670,77,69,17515,73,21,5,16,22,6
11671,80,69,17515,71,13,4,9,25,-2
11672,83,67,17515,82,22,5,17,37,-15
11673,86,67,17515,63,13,6,7,26,-13
11674,5,83,382028,3,0,0,0,2,-1
11675,8,83,382028,3,0,0,0,2,0
11677,14,68,382028,5,0,0,0,0,-2
11678,29,84,9526,2,0,0,0,2,-2
11679,35,84,9526,2,0,0,0,0,1
11680,41,83,9526,1,0,0,0,0,-1
11681,65,65,11460,31,9,5,4,16,-3
11683,71,65,11460,2,0,0,0,0,1
11684,71,68,11460,53,18,11,7,18,-6
11685,74,68,11460,72,35,19,16,20,-4
11686,77,63,11460,75,29,13,16,60,-12
11687,80,63,11460,58,5,2,3,29,-3
11688,83,72,11460,33,9,3,6,6,-2
11689,74,78,8037,75,44,14,30,48,21
11690,77,78,8037,79,34,9,25,38,12
11691,80,78,8037,64,22,7,15,34,-6
11692,83,77,8037,62,8,3,5,14,-8
11693,86,77,8037,27,3,1,2,33,-7
11694,26,79,8490,44,2,1,1,19,-2
11695,29,79,8490,14,3,1,2,0,0
11696,41,62,8490,5,0,0,0,2,-2
11697,68,65,11245,1,0,0,0,0,1
11698,26,78,5850,32,16,5,11,6,4
11700,32,78,5850,50,13,5,8,12,-1
11703,65,77,19071,45,7,4,3,52,4
11707,74,87,11705,81,18,3,15,60,-24
11708,77,87,11705,75,36,6,30,62,-10
11709,80,87,11705,45,9,1,8,12,-5
11710,80,62,11705,19,6,2,4,20,5
11711,83,62,11705,82,10,3,7,28,-11
11712,86,62,11705,14,5,0,5,10,0
11713,62,74,16742,8,0,0,0,0,-3
11714,65,78,16742,26,4,1,3,2,-4
11720,47,82,8614,79,8,1,7,30,-8
11721,17,71,58051,2,0,0,0,4,2
11722,71,88,19226,3,0,0,0,0,0
11723,74,87,19226,33,1,0,1,10,-13
11582,80,89,17496,2,0,0,0,0,-1
11583,83,89,17496,8,1,0,1,8,2
11728,71,72,19038,77,43,25,18,20,3
11729,74,72,19038,75,43,16,27,34,-6
11730,77,72,19038,80,50,30,20,23,10
11731,80,72,19038,82,40,20,20,38,-20
11732,83,72,19038,24,14,4,10,6,-6
11733,83,1479,19038,57,36,20,16,14,17
11734,86,1479,19038,82,42,18,24,24,-5
11735,62,62,16499,16,1,0,1,2,-1
11736,65,62,16499,27,3,1,2,11,-5
11737,71,62,16499,78,15,5,10,41,-4
11738,74,62,16499,78,34,16,18,54,10
11739,77,62,16499,44,7,2,5,31,-6
11740,80,62,16499,61,7,3,4,35,-2
11741,83,65,16499,53,9,3,6,36,1
11742,23,65,2004,12,4,1,3,12,0
11743,65,69,20723,6,2,0,2,2,-2
11745,71,69,20723,21,5,4,1,2,2
11746,74,69,20723,51,26,21,5,18,-9
11747,77,69,20723,71,23,13,10,20,-4
11748,80,69,20723,79,47,22,25,30,34
11749,83,69,20723,82,64,33,31,44,8
11750,86,69,20723,81,42,21,21,28,-9
11751,62,1479,14739,60,21,11,10,18,-5
11752,65,1479,14739,25,4,0,4,20,-10
11753,68,1479,14739,6,1,0,1,2,-1
11755,74,87,14739,50,3,1,2,16,-18
11756,74,84,14739,8,1,0,1,0,-1
11757,8,81,38883,11,2,1,1,8,-1
11758,2,83,26348,18,6,3,3,4,-10
11761,5,83,26348,11,4,3,1,8,-2
11762,8,83,26348,76,26,12,14,89,-7
11763,11,83,26348,73,24,9,15,145,2
11765,65,89,13650,5,0,0,0,2,0
11766,68,89,13650,25,7,1,6,8,-5
11767,5,76,31015,3,0,0,0,0,1
11768,62,63,11385,1,0,0,0,0,-1
11769,65,76,14125,3,0,0,0,0,-3
11770,71,76,14125,52,16,2,14,26,-9
11771,74,76,14125,12,3,0,3,0,4
11772,86,73,14125,2,1,0,1,2,0
11773,71,63,17494,6,2,1,1,0,1
11774,74,63,17494,4,1,0,1,0,1
11775,77,79,17494,12,1,1,0,0,-6
11776,77,72,17494,10,1,0,1,2,-3
11777,80,79,17494,7,1,0,1,6,-3
11778,83,64,17494,16,5,0,5,0,4
11779,68,66,12562,5,0,0,0,2,-2
11780,74,66,12562,38,6,2,4,4,-7
11782,59,71,6949,1,0,0,0,0,-1
11783,2,62,22113,76,39,19,20,183,-4
11784,5,62,22113,78,34,13,21,161,-10
11785,8,62,22113,75,52,19,33,150,2
11786,11,62,22113,81,23,11,12,92,-17
11787,14,62,22113,47,21,8,13,130,8
11788,17,77,22113,67,41,12,29,115,11
11789,20,77,22113,78,32,13,19,99,12
11790,23,77,22113,68,7,3,4,78,-2
11791,2,79,73314,3,0,0,0,9,2
11792,5,79,73314,49,8,1,7,36,0
11793,8,79,73314,77,18,3,15,64,13
11794,11,79,73314,41,4,0,4,8,-7
11795,11,88,73314,18,2,1,1,10,-1
11796,14,80,73314,29,2,0,2,28,-5
11797,65,76,6914,29,8,4,4,6,-2
11799,20,76,73791,1,0,0,0,0,-1
11800,62,74,15723,10,0,0,0,19,-1
11801,65,84,15723,68,8,4,4,81,-1
11802,68,84,15723,40,6,3,3,43,-7
11803,71,84,15723,44,12,3,9,42,-1
11804,71,75,15723,17,4,3,1,17,4
11805,74,75,15723,79,29,10,19,34,21
11806,77,75,15723,56,26,14,12,22,0
11807,77,65,15723,15,1,0,1,2,4
11808,80,77,15723,64,15,8,7,39,1
11809,83,77,15723,46,8,4,4,21,-7
11810,86,77,15723,42,11,5,6,15,-6
11811,86,75,15723,9,0,0,0,4,-2
11812,65,80,342610,1,0,0,0,0,0
11813,11,75,54552,1,0,0,0,0,0
11814,68,88,23810,10,5,2,3,2,3
11816,74,88,23810,76,49,23,26,37,25
11817,77,88,23810,82,58,31,27,20,35
11818,80,88,23810,63,34,16,18,22,6
11819,83,88,23810,82,47,24,23,16,9
11820,86,88,23810,82,34,13,21,23,-16
11821,62,62,19168,3,0,0,0,2,-3
11822,65,62,19168,54,14,2,12,14,3
11823,68,62,19168,47,14,2,12,8,-9
11824,71,62,19168,81,31,4,27,20,0
11825,74,62,19168,81,41,11,30,30,15
11826,77,62,19168,70,45,6,39,18,4
11827,80,62,19168,82,36,6,30,24,-16
11828,83,62,19168,73,32,4,28,18,-16
11829,86,62,19168,79,34,9,25,24,29
11830,59,81,18596,48,5,2,3,18,-9
11831,62,81,18596,1,0,0,0,0,-2
11833,71,547,18596,59,2,0,2,15,-3
11834,65,85,6217,18,7,1,6,2,2
11835,68,85,6217,22,6,3,3,6,0
11836,71,85,6217,57,48,28,20,10,16
11837,74,85,6217,82,54,27,27,26,-11
11838,77,85,6217,82,43,17,26,34,-2
11839,80,85,6217,76,48,12,36,18,0
11840,83,85,6217,82,40,21,19,20,-2
11841,86,85,6217,62,49,16,33,8,0
11842,86,86,6217,19,11,6,5,4,1
11843,59,88,11864,1,0,0,0,0,0
11844,62,88,11864,19,7,4,3,2,2
11845,65,88,11864,39,7,3,4,2,-4
11846,68,72,11864,28,12,8,4,4,-2
11725,62,72,19038,1,0,0,0,0,1
11726,65,72,19038,74,51,16,35,7,8
11848,71,66,11864,20,10,3,7,2,-4
11849,68,80,18238,5,0,0,0,0,-1
11851,77,62,18238,15,1,0,1,2,-7
11852,80,67,18238,35,3,0,3,19,-3
11853,80,73,18238,6,1,0,1,5,-2
11854,80,67,18238,5,0,0,0,0,0
11855,83,1479,18238,66,24,12,12,11,3
11856,86,79,18238,25,5,2,3,6,3
11857,86,1479,18238,31,9,2,7,8,-9
11858,2,76,67477,5,0,0,0,2,4
11869,68,82,17023,42,16,9,7,32,-9
11870,71,82,17023,56,24,9,15,53,-1
11871,74,82,17023,56,23,13,10,28,1
11872,77,82,17023,73,24,11,13,51,1
11873,80,82,17023,65,15,10,5,48,-4
11874,83,82,17023,69,24,9,15,33,-10
11875,86,64,17023,82,26,11,15,58,-10
11876,77,70,19054,14,3,1,2,6,-6
11877,80,70,19054,61,10,4,6,36,-10
11878,83,70,19054,75,15,8,7,41,10
11984,17,62,664,41,8,3,5,44,-2
11985,20,62,664,40,13,5,8,49,-3
11986,23,62,664,64,9,4,5,122,-1
11987,26,62,664,68,8,3,5,67,-4
11989,29,1479,664,8,1,1,0,15,-2
11990,32,72,664,4,1,0,1,6,2
11991,8,84,27548,70,52,22,30,82,34
11992,11,84,27548,33,7,6,1,37,-14
11993,11,88,27548,34,8,6,2,45,-8
11994,14,83,27548,22,3,0,3,31,-4
11995,17,67,27548,8,4,2,2,6,1
11996,20,67,27548,79,45,13,32,36,17
11997,23,67,27548,71,23,10,13,42,9
11998,26,67,27548,78,44,20,24,44,10
11999,29,67,27548,71,20,11,9,41,1
12000,32,63,27548,63,18,5,13,65,-1
12001,38,74,27548,8,0,0,0,2,-2
12002,65,77,19069,66,9,2,7,232,-1
12003,68,77,19069,32,5,3,2,85,-7
12004,71,77,19069,67,4,2,2,153,-13
12005,74,77,19069,58,6,1,5,102,-9
12006,77,63,19069,52,3,1,2,83,-5
12007,83,87,19069,53,7,5,2,44,-7
12008,86,73,19069,23,3,1,2,20,1
12009,62,86,19224,5,0,0,0,0,-1
12010,65,86,19224,33,9,3,6,18,-1
12011,68,86,19224,42,13,5,8,26,-9
12012,71,86,19224,77,38,16,22,35,11
12013,74,86,19224,75,36,15,21,40,-7
12014,77,86,19224,68,18,7,11,63,-10
12015,80,86,19224,37,8,5,3,15,-2
12016,80,80,19224,36,4,2,2,12,-9
12017,83,65,19224,57,12,7,5,43,-10
12018,83,63,19224,18,5,2,3,2,-1
12019,11,1479,67390,3,0,0,0,0,-3
12020,68,547,12198,8,4,1,3,12,0
12021,71,547,12198,10,3,1,2,0,1
12022,74,64,12198,59,20,5,15,24,-1
12023,77,64,12198,37,6,2,4,10,5
12024,80,75,12198,16,5,0,5,2,6
12025,83,67,12198,3,0,0,0,2,1
12026,68,82,11712,5,0,0,0,6,-2
12027,71,82,11712,6,1,0,1,0,1
12028,74,82,11712,8,2,0,2,2,0
12029,77,89,11712,2,0,0,0,2,-1
12030,5,74,8730,53,30,8,22,23,-3
12031,8,74,8730,65,40,15,25,55,4
12032,8,71,8730,13,8,2,6,10,-2
12033,11,71,8730,84,74,24,50,47,-22
12034,14,71,8730,48,40,7,33,69,-17
12035,17,71,8730,82,104,25,79,95,-19
12036,20,71,8730,80,82,21,61,80,1
12037,23,71,8730,79,70,26,44,69,1
12038,26,71,8730,43,37,6,31,12,-8
12039,29,71,8730,77,72,21,51,54,6
12040,32,71,8730,82,90,25,65,91,12
12041,35,78,8730,61,49,15,34,40,20
12042,38,78,8730,70,67,15,52,52,-6
12043,41,78,8730,75,65,14,51,37,-3
12044,47,78,8730,47,44,11,33,50,-11
12045,47,66,8730,23,13,4,9,25,-6
12046,50,78,8730,82,59,16,43,56,10
12047,53,78,8730,29,11,4,7,12,4
12048,53,1479,8730,38,14,6,8,20,0
12049,56,76,8730,53,38,10,28,55,-15
12050,59,76,8730,36,17,1,16,8,-1
12051,62,76,8730,18,9,2,7,10,-3
12052,74,83,19169,12,2,0,2,12,-6
12053,62,63,16703,6,0,0,0,4,-1
12054,65,63,16703,3,0,0,0,0,-2
12055,68,63,16703,11,2,0,2,6,0
12056,71,63,16703,64,18,0,18,30,22
12057,74,63,16703,47,4,0,4,37,-6
12058,77,84,16703,80,18,6,12,50,-19
12059,80,62,16703,24,2,1,1,26,-4
12060,83,62,16703,18,3,0,3,4,-3
12061,86,69,16703,2,1,1,0,0,2
12062,8,71,68720,27,9,5,4,24,1
12063,11,71,68720,15,4,0,4,14,-1
12065,17,65,68720,9,0,0,0,8,-2
12066,23,79,68720,71,18,3,15,46,15
12067,26,79,68720,81,24,6,18,93,17
12068,29,79,68720,61,11,3,8,69,15
12069,29,62,68720,12,2,1,1,21,-2
12070,32,62,68720,33,5,1,4,16,-3
12071,62,78,19164,7,0,0,0,11,0
12072,11,71,8461,26,8,3,5,2,1
12073,14,71,8461,9,6,2,4,0,1
12074,17,71,8461,26,8,5,3,0,-14
12075,17,83,8461,1,0,0,0,0,0
12076,26,77,8461,3,0,0,0,0,0
12077,29,77,8461,21,6,1,5,6,1
12078,32,77,8461,77,25,9,16,16,1
12079,35,65,8461,48,6,3,3,10,-8
12080,38,65,8461,6,1,0,1,0,0
12081,41,77,8461,3,0,0,0,2,-1
12082,65,74,19440,51,9,0,9,108,2
12083,68,74,19440,16,0,0,0,49,-2
12084,74,69,19440,9,1,0,1,46,1
12085,2,76,202260,20,3,1,2,4,0
12086,5,76,202260,1,0,0,0,2,0
12087,8,76,202260,2,0,0,0,0,0
12088,65,82,22625,5,0,0,0,0,1
12089,68,82,22625,28,7,1,6,25,15
11981,62,76,13842,8,1,0,1,2,-2
11983,14,62,664,2,2,1,1,2,-2
12094,80,72,22625,14,3,0,3,30,-5
12095,83,72,22625,4,0,0,0,13,-2
12096,86,62,22625,20,2,1,1,8,1
12097,71,70,10376,8,0,0,0,6,-3
12098,74,70,10376,22,3,0,3,6,0
12099,77,70,10376,38,8,0,8,14,-1
12100,80,70,10376,40,3,0,3,14,-4
12101,83,64,10376,68,15,3,12,41,27
12102,86,64,10376,74,10,1,9,53,5
12104,2,67,68626,12,3,2,1,4,0
12106,8,77,68626,60,33,14,19,12,0
12107,8,62,68626,13,9,4,5,0,3
12108,11,62,68626,15,2,2,0,2,-4
12109,5,88,73574,3,0,0,0,0,-1
12110,8,88,73574,18,2,0,2,12,1
12111,74,87,14425,5,1,1,0,2,-2
12113,74,71,40077,17,2,2,0,4,-3
12114,80,71,40077,31,11,8,3,6,0
12115,83,70,40077,80,27,14,13,34,9
12116,86,70,40077,47,12,8,4,6,-2
12117,8,88,73360,2,0,0,0,10,0
12118,2,74,32599,74,59,10,49,58,-5
12119,5,74,32599,80,71,14,57,54,34
12120,8,74,32599,60,26,5,21,61,1
12121,11,74,32599,6,3,0,3,2,1
12123,11,62,32599,15,4,2,2,6,6
12124,14,62,32599,43,10,0,10,14,-3
12125,17,62,32599,80,35,3,32,30,3
12126,20,62,32599,19,4,3,1,6,2
12127,23,62,32599,60,17,6,11,26,-2
12128,26,67,32599,45,8,1,7,16,12
12129,29,67,32599,66,13,5,8,22,8
12131,35,67,32599,56,13,5,8,16,3
12132,38,67,32599,69,16,4,12,26,-3
12133,41,67,32599,55,11,4,7,12,11
12134,5,65,70937,2,0,0,0,4,0
12135,5,67,39217,52,12,4,8,30,-4
12136,8,67,39217,36,6,4,2,22,-2
12137,5,63,46316,24,4,1,3,6,-6
12138,8,63,46316,5,1,0,1,0,1
12139,11,77,46316,4,2,0,2,0,1
12140,65,70,19740,3,2,0,2,0,1
12141,68,70,19740,26,6,1,5,10,-4
12142,71,70,19740,78,20,3,17,30,16
12143,74,70,19740,73,16,2,14,34,-5
12144,77,70,19740,64,12,3,9,21,2
12145,80,70,19740,58,15,2,13,24,-3
12146,80,75,19740,13,2,2,0,4,-1
12148,86,75,19740,81,22,5,17,39,15
12149,65,69,36725,9,3,0,3,6,1
12150,71,69,36725,5,0,0,0,2,-2
12151,77,69,36725,3,0,0,0,7,-1
12152,5,86,29052,2,1,0,1,4,-2
12153,2,89,74522,1,0,0,0,15,0
12155,8,80,74522,6,0,0,0,20,-7
12156,11,80,74522,9,1,0,1,8,-6
12157,68,62,14359,4,3,1,2,2,-2
12158,71,62,14359,4,0,0,0,0,-4
12159,5,89,8830,1,0,0,0,0,1
12160,8,89,8830,26,2,0,2,10,3
12161,11,89,8830,10,3,1,2,4,2
12162,14,68,8830,34,13,4,9,18,-1
12163,17,68,8830,52,34,6,28,32,-9
12164,20,68,8830,3,0,0,0,2,1
12166,23,67,8830,71,35,9,26,35,8
12167,26,67,8830,80,43,10,33,62,16
12168,29,67,8830,74,33,8,25,52,14
12169,32,67,8830,67,23,5,18,46,0
12170,35,67,8830,59,28,8,20,34,-6
12171,38,67,8830,14,3,0,3,29,-1
12172,38,85,8830,62,23,6,17,22,12
12173,41,85,8830,55,19,4,15,28,19
12174,47,85,8830,53,19,1,18,28,3
12175,11,62,31600,5,0,0,0,2,1
12176,2,83,53468,12,0,0,0,20,-5
12180,11,71,53468,72,37,19,18,165,-4
12181,14,71,53468,28,5,1,4,54,-11
12182,14,67,53468,14,3,2,1,20,-3
12183,17,67,53468,27,4,4,0,67,-4
12184,20,83,53468,1,0,0,0,2,0
12186,68,62,15734,2,0,0,0,0,0
12187,2,75,1631,47,23,8,15,18,3
12188,2,77,1631,12,3,2,1,5,-8
12189,5,77,1631,58,40,15,25,22,14
12190,8,77,1631,14,7,3,4,6,-2
12191,8,86,1631,27,10,7,3,22,-20
12192,11,85,1631,2,0,0,0,2,-1
12193,2,63,68086,57,8,2,6,107,15
12197,2,79,27542,46,14,6,8,21,2
12199,5,63,27542,32,9,3,6,8,-5
12200,77,88,31277,14,2,1,1,17,-1
12201,80,88,31277,82,18,2,16,54,8
12202,83,88,31277,78,18,1,17,49,18
12203,86,88,31277,81,14,2,12,52,-13
12204,68,70,12121,39,14,7,7,85,3
12205,71,70,12121,81,29,14,15,209,-1
12207,77,70,12121,80,29,13,16,123,11
12208,80,70,12121,60,27,12,15,115,1
12209,83,70,12121,73,17,5,12,126,1
12210,86,84,12121,65,31,9,22,118,5
12211,62,86,18615,13,0,0,0,17,-2
12212,68,74,18615,4,0,0,0,0,-2
12213,71,74,18615,6,0,0,0,10,-1
12214,77,65,18615,41,5,4,1,23,-7
12215,8,85,10234,2,0,0,0,0,0
12216,11,85,10234,7,3,1,2,2,0
12217,14,85,10234,10,3,1,2,2,0
12218,14,1479,10234,15,8,0,8,12,4
12219,17,1479,10234,79,24,3,21,88,-7
12220,20,80,10234,75,21,4,17,67,-8
12091,74,82,22625,63,8,0,8,85,-14
12092,77,82,22625,64,9,3,6,102,-6
12225,35,1479,10234,74,25,5,20,60,-11
12226,38,73,10234,74,19,4,15,52,13
12227,41,73,10234,67,15,2,13,64,-4
12228,50,63,10234,49,8,1,7,32,-14
12229,8,62,67938,28,5,3,2,20,-7
12230,8,63,67938,15,9,4,5,12,1
12231,62,1479,31271,76,40,10,30,20,-25
12232,65,1479,31271,82,29,5,24,18,-28
12233,68,1479,31271,37,11,1,10,4,-4
12234,71,1479,31271,70,36,6,30,14,15
12235,74,1479,31271,80,34,7,27,14,4
12236,77,1479,31271,69,28,5,23,27,-8
12237,80,1479,31271,80,39,11,28,20,7
12238,83,1479,31271,67,32,8,24,28,3
12239,86,1479,31271,59,23,5,18,20,-14
12240,5,74,38187,9,3,1,2,2,0
12242,11,81,38187,59,12,6,6,42,-9
12243,14,81,38187,43,15,9,6,24,-3
12244,17,81,38187,72,35,15,20,62,11
12245,20,81,38187,82,50,17,33,56,3
12246,23,81,38187,77,26,14,12,41,-31
12247,26,81,38187,58,19,8,11,24,-15
12248,29,80,38187,57,21,9,12,32,-6
12249,32,80,38187,79,37,19,18,52,7
12250,35,63,38187,66,25,12,13,24,6
12251,38,63,38187,55,16,10,6,18,2
12252,41,63,38187,57,9,4,5,16,3
12253,11,71,72770,2,0,0,0,0,-2
12254,5,72,27546,44,31,13,18,28,11
12255,8,72,27546,78,64,23,41,70,19
12256,11,72,27546,82,57,26,31,70,36
12257,14,72,27546,4,3,1,2,6,3
12259,20,72,27546,71,38,14,24,36,-10
12260,23,72,27546,35,10,2,8,32,0
12261,23,71,27546,33,12,2,10,57,-2
12262,26,77,27546,74,25,16,9,48,0
12263,29,77,27546,77,32,11,21,55,-3
12264,32,65,27546,36,7,3,4,18,-14
12265,2,65,31346,53,7,6,1,320,-3
12266,5,65,31346,63,9,6,3,408,1
12267,8,80,31346,81,25,15,10,318,-35
12268,11,72,31346,69,20,4,16,238,19
12269,14,72,31346,46,11,2,9,167,5
12270,17,72,31346,57,11,3,8,146,4
12271,20,72,31346,20,2,0,2,68,0
12272,20,78,31346,44,5,2,3,158,0
12273,23,62,31346,23,0,0,0,113,-6
12274,20,80,74517,22,6,3,3,9,5
12276,26,77,74517,2,0,0,0,0,0
12281,20,65,8568,74,62,20,42,56,18
12282,23,65,8568,70,49,21,28,61,16
12283,26,65,8568,76,61,20,41,50,-10
12284,29,65,8568,71,60,23,37,61,7
12285,32,65,8568,63,49,13,36,40,-12
12286,35,65,8568,77,67,22,45,67,8
12287,38,65,8568,74,58,15,43,70,0
12288,41,65,8568,23,18,6,12,14,-8
12289,41,77,8568,20,18,5,13,14,7
12290,47,63,8568,24,10,1,9,30,-4
12291,68,81,12074,14,6,3,3,4,3
12292,71,81,12074,82,50,24,26,26,23
12293,74,81,12074,77,72,29,43,24,33
12294,77,81,12074,69,38,14,24,20,4
12295,80,81,12074,66,45,19,26,28,-5
12297,86,81,12074,80,47,29,18,28,15
12298,68,85,15479,31,5,1,4,15,-10
12299,71,85,15479,75,6,1,5,36,-2
12300,74,85,15479,11,2,0,2,6,4
12301,80,85,15479,5,0,0,0,0,-3
12302,83,85,15479,1,0,0,0,0,0
12303,86,85,15479,4,1,0,1,2,-1
12304,8,86,54519,84,15,5,10,229,-50
12305,11,86,54519,68,4,0,4,122,-9
12306,11,70,54519,7,1,1,0,11,1
12307,14,70,54519,42,5,0,5,67,-6
12308,17,70,54519,42,6,1,5,65,1
12309,17,88,54519,16,1,1,0,22,-6
12310,20,88,54519,57,1,1,0,116,-22
12311,23,88,54519,46,8,0,8,111,0
12312,26,65,54519,62,14,0,14,102,1
12314,8,74,8504,49,31,8,23,4,-1
12315,11,74,8504,78,89,12,77,39,20
12316,14,74,8504,38,36,10,26,18,-2
12317,17,79,8504,64,66,11,55,22,28
12318,20,70,8504,78,43,13,30,24,19
12319,23,70,8504,73,57,10,47,16,16
12320,26,70,8504,81,51,10,41,20,9
12321,29,70,8504,77,42,9,33,18,-2
12322,32,70,8504,79,51,10,41,24,22
12323,35,70,8504,80,44,12,32,22,-4
12324,38,70,8504,82,55,11,44,26,21
12325,41,70,8504,77,42,7,35,20,0
12326,47,70,8504,78,71,13,58,46,20
12327,50,70,8504,78,54,12,42,26,0
12328,53,70,8504,46,35,4,31,12,6
12329,56,70,8504,10,4,0,4,0,-4
12331,65,80,14078,1,0,0,0,0,-1
12332,68,80,14078,3,0,0,0,2,-1
12333,71,80,14078,25,6,3,3,2,-2
12334,74,80,14078,79,48,27,21,14,16
12335,77,80,14078,78,59,29,30,18,1
12336,80,80,14078,74,61,26,35,51,17
12337,83,80,14078,82,56,22,34,32,-20
12338,86,68,14078,82,70,36,34,30,-24
12339,5,86,40324,56,28,3,25,40,-13
12340,8,86,40324,40,12,1,11,49,-27
12341,11,1479,40324,56,20,5,15,42,8
12342,14,1479,40324,21,4,2,2,26,-5
12343,5,88,350,71,19,7,12,101,12
12344,8,88,350,8,2,1,1,6,-2
12222,26,80,10234,79,35,4,31,48,17
12223,29,80,10234,79,30,8,22,60,-3
12349,17,77,69970,16,2,1,1,28,0
12350,20,80,69970,26,1,0,1,30,0
12351,23,80,69970,9,3,3,0,24,3
12352,26,80,69970,8,1,0,1,4,1
12353,29,73,69970,4,0,0,0,10,0
12354,62,77,23002,3,1,0,1,2,1
12355,65,77,23002,24,9,5,4,2,12
12356,68,77,23002,4,0,0,0,0,0
12357,23,70,324051,7,0,0,0,7,0
12358,8,77,8997,61,75,41,34,147,28
12359,11,77,8997,65,97,44,53,103,16
12360,14,77,8997,46,70,29,41,60,27
12361,17,77,8997,73,115,47,68,163,26
12362,20,77,8997,52,79,32,47,136,31
12363,23,77,8997,63,71,30,41,134,14
12364,26,77,8997,71,93,40,53,120,35
12366,35,74,8997,72,73,37,36,138,19
12367,38,74,8997,81,53,19,34,141,5
12368,41,74,8997,39,32,10,22,60,7
12369,47,83,8997,33,22,11,11,43,-3
12370,50,70,8997,49,26,5,21,70,-1
12371,5,86,25640,79,59,25,34,16,-32
12372,8,86,25640,41,28,14,14,12,-25
12373,11,86,25640,83,53,22,31,18,-3
12374,14,86,25640,46,19,12,7,25,-4
12375,17,86,25640,9,3,3,0,4,-1
12376,17,77,25640,62,48,22,26,6,15
12377,20,77,25640,52,23,11,12,10,-8
12378,23,77,25640,30,12,5,7,8,3
12379,23,80,25640,28,6,3,3,8,-11
12380,26,71,25640,82,40,17,23,20,-4
12381,29,71,25640,33,18,5,13,4,6
12383,5,72,8519,4,1,0,1,2,1
12384,8,72,8519,80,40,11,29,47,8
12385,11,72,8519,81,46,10,36,42,34
12386,14,72,8519,48,19,4,15,18,19
12387,17,72,8519,79,33,8,25,46,5
12388,20,72,8519,81,35,5,30,64,-4
12389,23,72,8519,81,57,14,43,27,5
12390,26,72,8519,72,46,11,35,26,16
12391,29,72,8519,71,38,7,31,48,19
12392,32,72,8519,57,35,6,29,22,14
12393,35,72,8519,76,33,11,22,30,12
12394,38,72,8519,81,39,11,28,62,23
12395,41,72,8519,81,54,14,40,44,20
12396,47,1479,8519,82,63,13,50,96,8
12397,50,1479,8519,79,69,15,54,86,6
12398,53,1479,8519,48,25,8,17,16,-2
12400,59,1479,8519,80,48,10,38,38,-9
12401,5,76,21477,17,5,1,4,9,13
12402,8,76,21477,75,24,7,17,67,-1
12403,11,76,21477,74,14,3,11,70,-5
12404,14,76,21477,26,13,6,7,26,2
12405,17,76,21477,55,13,3,10,54,-19
12406,20,76,21477,81,14,3,11,47,-7
12407,23,76,21477,63,13,2,11,45,-11
12408,26,76,21477,59,9,1,8,30,-19
12409,26,75,21477,17,2,1,1,11,-2
12410,29,75,21477,57,6,0,6,22,-4
12411,32,84,21477,76,14,3,11,46,5
12412,35,84,21477,81,11,1,10,50,15
12413,38,82,21477,61,1,0,1,46,-20
12414,41,82,21477,77,4,0,4,44,-23
12415,11,85,8738,5,1,1,0,4,2
12417,20,85,8738,49,7,2,5,52,-9
12418,23,85,8738,52,10,5,5,47,-1
12419,26,85,8738,60,11,3,8,52,-5
12420,29,85,8738,36,4,1,3,24,-4
12421,32,85,8738,73,9,4,5,57,-4
12422,35,66,8738,79,14,3,11,74,0
12423,38,66,8738,77,9,3,6,90,-23
12424,41,66,8738,49,8,3,5,37,1
12425,47,66,8738,71,25,6,19,62,2
12426,50,74,8738,60,13,3,10,57,-3
12427,50,63,8738,20,3,1,2,18,-8
12428,53,63,8738,65,13,5,8,54,9
12429,56,63,8738,65,10,3,7,44,16
12430,59,66,8738,60,11,1,10,54,-17
12431,59,1479,8738,17,2,0,2,8,2
12433,17,64,2577,82,116,30,86,47,26
12435,23,64,2577,72,91,25,66,94,6
12436,26,64,2577,78,97,30,67,108,27
12437,29,64,2577,49,51,14,37,52,9
12438,32,64,2577,73,89,27,62,54,23
12439,38,64,2577,75,106,29,77,70,52
12440,41,64,2577,39,55,18,37,30,16
12441,47,77,2577,60,75,19,56,46,21
12442,50,77,2577,40,40,11,29,72,2
12443,50,73,2577,17,15,2,13,16,5
12444,53,64,2577,9,14,1,13,8,7
12445,62,64,2577,2,0,0,0,4,-4
12446,14,84,25749,4,0,0,0,13,-2
12447,17,84,25749,58,1,0,1,123,-12
12448,17,79,25749,10,1,1,0,7,-1
12449,20,79,25749,35,5,1,4,79,3
12451,11,70,8966,25,3,0,3,22,1
12453,17,70,8966,73,22,6,16,71,4
12454,20,70,8966,57,12,5,7,87,1
12455,23,70,8966,74,18,3,15,63,7
12456,26,70,8966,64,12,3,9,51,23
12457,29,70,8966,70,25,4,21,42,7
12458,32,70,8966,78,20,4,16,62,5
12459,35,70,8966,82,21,9,12,52,11
12460,38,70,8966,68,6,1,5,58,1
12461,41,70,8966,75,21,1,20,36,0
12462,47,72,8966,62,11,1,10,40,2
12463,50,72,8966,1,0,0,0,0,-1
12467,11,65,27224,58,25,12,13,40,0
12468,14,65,27224,45,30,15,15,53,13
12469,17,65,27224,38,15,7,8,16,7
12346,8,86,350,20,5,2,3,16,-6
12347,11,62,350,2,0,0,0,0,0
12474,26,75,27224,81,25,8,17,21,6
12475,29,75,27224,82,15,10,5,17,-15
12476,32,75,27224,52,20,9,11,13,1
12477,35,75,27224,28,5,0,5,6,6
12478,5,85,8984,4,1,0,1,5,2
12479,8,85,8984,3,0,0,0,0,-2
12480,11,85,8984,50,16,8,8,55,7
12481,14,85,8984,39,10,4,6,73,1
12482,17,85,8984,58,9,6,3,93,0
12483,20,85,8984,78,33,16,17,167,-14
12484,23,85,8984,79,34,15,19,106,0
12485,26,85,8984,77,29,16,13,141,7
12486,29,85,8984,82,41,16,25,121,17
12487,32,85,8984,82,57,27,30,127,3
12488,35,63,8984,68,40,17,23,101,12
12489,38,63,8984,59,18,8,10,87,-19
12491,47,65,8984,82,31,14,17,106,-30
12492,50,65,8984,82,24,13,11,98,-14
12493,53,65,8984,52,7,3,4,47,-3
12494,53,80,8984,18,6,3,3,23,-2
12495,14,72,8919,40,18,7,11,17,5
12496,17,72,8919,58,24,13,11,8,9
12497,20,72,8919,81,45,18,27,20,6
12498,23,72,8919,76,30,16,14,16,7
12499,26,72,8919,82,57,24,33,14,11
12500,29,72,8919,11,4,3,1,0,-2
12501,29,64,8919,50,18,8,10,12,-6
12502,29,63,8919,16,9,5,4,6,-4
12503,32,63,8919,77,58,19,39,28,6
12504,35,63,8919,82,62,31,31,30,11
12505,38,63,8919,81,59,27,32,32,1
12506,41,63,8919,82,48,19,29,40,9
12508,50,69,8919,78,64,31,33,46,6
12509,53,69,8919,81,59,31,28,53,-1
12510,56,72,8919,64,32,15,17,30,2
12511,59,72,8919,80,37,20,17,22,2
12512,62,72,8919,65,34,14,20,34,-6
12513,65,76,8919,49,9,4,5,6,-12
12514,65,63,8919,21,15,3,12,8,7
12515,8,71,9662,7,2,1,1,19,-4
12516,11,71,9662,5,0,0,0,4,-3
12517,14,71,9662,6,1,1,0,14,1
12518,17,71,9662,23,1,1,0,33,-7
12519,20,79,9662,45,4,2,2,70,-7
12520,23,79,9662,82,7,3,4,112,-3
12521,26,79,9662,61,0,0,0,90,-2
12522,29,79,9662,50,22,12,10,45,4
12523,32,82,9662,76,32,16,16,140,-9
12525,38,82,9662,70,30,19,11,113,-25
12526,41,82,9662,68,18,9,9,63,-19
12527,47,82,9662,18,4,0,4,20,-3
12528,47,1479,9662,25,4,2,2,31,2
12529,8,67,9082,18,4,0,4,14,1
12530,11,67,9082,38,14,6,8,29,-1
12531,14,67,9082,9,5,1,4,0,6
12532,14,88,9082,6,1,1,0,4,-3
12533,17,88,9082,53,23,7,16,31,-26
12534,20,88,9082,60,25,7,18,25,0
12535,23,88,9082,45,16,6,10,49,6
12536,26,88,9082,45,8,2,6,32,-12
12537,29,88,9082,1,0,0,0,0,0
12538,32,88,9082,22,6,2,4,20,4
12539,35,88,9082,80,30,7,23,94,0
12540,38,70,9082,80,27,7,20,94,28
12542,47,70,9082,66,43,16,27,77,28
12543,50,70,9082,76,51,19,32,104,2
12544,53,70,9082,38,14,2,12,26,3
12545,56,70,9082,16,3,0,3,15,-4
12546,56,79,9082,25,6,3,3,24,10
12547,11,89,25755,49,29,11,18,39,1
12548,14,89,25755,18,4,0,4,12,-6
12549,17,89,25755,62,36,17,19,46,7
12550,20,89,25755,4,0,0,0,4,1
12551,23,89,25755,1,0,0,0,4,0
12552,8,74,8666,65,38,20,18,79,-10
12553,11,74,8666,76,56,23,33,154,18
12554,14,74,8666,48,28,13,15,30,-6
12555,17,74,8666,81,58,24,34,98,5
12556,20,74,8666,45,35,13,22,42,11
12557,23,74,8666,73,53,23,30,44,-22
12559,26,79,8666,63,46,20,26,37,8
12560,29,79,8666,82,66,26,40,94,-3
12561,32,79,8666,79,95,44,51,96,12
12562,35,79,8666,67,76,32,44,80,2
12563,38,79,8666,54,64,27,37,50,-11
12564,38,74,8666,24,13,10,3,20,2
12565,41,74,8666,66,42,13,29,54,-5
12566,41,75,8666,12,3,1,2,12,-4
12567,47,75,8666,69,65,23,42,76,-1
12568,50,75,8666,73,47,18,29,78,-19
12569,53,75,8666,82,84,35,49,70,18
12570,56,75,8666,78,65,26,39,74,-5
12571,59,80,8666,77,49,18,31,54,-8
12572,62,80,8666,54,27,14,13,28,-9
12573,62,79,8666,20,7,2,5,16,3
12574,68,68,8666,14,5,2,3,6,-1
12576,14,79,67254,14,4,2,2,2,0
12577,17,79,67254,66,52,19,33,36,17
12578,17,84,67254,10,3,3,0,6,3
12579,20,84,67254,78,41,21,20,30,-15
12580,23,84,67254,76,34,14,20,56,5
12581,26,84,67254,80,66,36,30,74,-13
12582,29,84,67254,82,65,27,38,64,-5
12583,32,84,67254,72,75,41,34,58,-2
12584,35,84,67254,81,90,40,50,50,22
12585,38,84,67254,82,104,48,56,52,6
12586,41,84,67254,78,84,35,49,58,24
12587,47,84,67254,81,79,32,47,66,-19
12588,50,84,67254,82,60,24,36,54,3
12589,53,84,67254,82,55,25,30,46,-7
12471,20,81,27224,73,26,12,14,56,-16
12472,23,81,27224,44,9,2,7,19,-3
12594,14,63,8573,35,7,5,2,46,-11
12595,17,79,8573,69,29,14,15,57,4
12596,20,79,8573,66,22,11,11,24,-19
12597,20,88,8573,11,8,5,3,8,-2
12598,23,88,8573,81,60,29,31,54,6
12599,26,88,8573,61,31,16,15,36,-14
12600,29,88,8573,78,62,29,33,60,13
12601,32,88,8573,64,39,18,21,32,9
12602,35,88,8573,9,11,6,5,0,5
12603,35,63,8573,73,60,35,25,40,26
12604,38,63,8573,82,92,44,48,64,9
12605,41,63,8573,81,60,32,28,56,17
12606,47,63,8573,64,53,24,29,52,-8
12607,50,63,8573,59,45,28,17,44,-12
12608,53,63,8573,63,30,17,13,50,-4
12609,17,62,729599,2,0,0,0,0,0
12615,17,64,8691,22,15,4,11,14,10
12616,17,75,8691,56,60,25,35,54,8
12617,20,75,8691,70,55,28,27,62,1
12618,23,75,8691,78,53,21,32,84,13
12619,26,75,8691,73,34,17,17,50,-25
12620,29,75,8691,80,49,25,24,70,1
12621,32,75,8691,57,38,16,22,66,-5
12622,35,75,8691,18,8,2,6,12,-1
12623,35,70,8691,42,17,6,11,24,3
12624,35,74,8691,15,13,3,10,6,6
12625,38,78,8691,61,30,16,14,38,-1
12626,41,74,8691,69,42,13,29,62,13
12627,41,84,8691,13,3,1,2,10,2
12628,47,74,8691,52,55,16,39,56,10
12629,50,78,8691,52,33,12,21,48,-3
12630,53,78,8691,40,16,5,11,40,-9
12632,11,71,8967,45,27,6,21,16,12
12633,14,71,8967,6,0,0,0,0,-1
12634,17,71,8967,53,30,15,15,23,6
12635,20,71,8967,57,29,12,17,28,-15
12636,23,71,8967,77,50,19,31,46,9
12637,26,71,8967,65,25,9,16,36,5
12638,26,65,8967,12,5,1,4,2,3
12639,29,65,8967,76,32,14,18,72,11
12640,32,65,8967,61,26,10,16,43,4
12641,32,77,8967,10,2,1,1,0,-1
12642,35,62,8967,73,51,21,30,60,2
12643,38,64,8967,41,18,10,8,10,1
12644,41,62,8967,64,30,17,13,18,9
12645,47,78,8967,78,37,15,22,32,-25
12646,50,80,8967,81,29,14,15,28,11
12647,53,80,8967,68,22,9,13,12,1
12649,56,76,8967,18,9,2,7,8,5
12650,59,72,8967,62,17,8,9,40,-1
12651,5,86,8819,2,3,0,3,0,-1
12652,8,86,8819,26,10,4,6,4,-14
12653,11,86,8819,61,40,14,26,14,2
12654,14,86,8819,39,25,13,12,14,-7
12655,17,86,8819,60,41,17,24,16,-23
12656,20,86,8819,12,2,0,2,4,-6
12657,23,71,8819,9,4,1,3,0,-1
12658,23,68,8819,68,61,32,29,28,10
12659,26,68,8819,81,64,26,38,18,-3
12660,29,68,8819,81,71,29,42,35,16
12661,32,68,8819,43,31,10,21,28,-16
12662,32,82,8819,3,3,0,3,2,-1
12663,35,82,8819,67,61,21,40,12,-22
12664,38,82,8819,81,76,24,52,22,-26
12666,47,66,8819,63,55,17,38,42,0
12667,50,66,8819,81,83,32,51,46,-5
12668,53,66,8819,66,61,25,36,30,-6
12669,56,66,8819,82,77,24,53,32,2
12670,59,66,8819,80,58,21,37,26,-6
12673,68,70,8819,32,29,11,18,4,1
12674,71,70,8819,69,32,9,23,14,-6
12677,17,64,20910,33,9,3,6,33,10
12678,20,64,20910,76,27,12,15,67,14
12679,23,64,20910,68,28,16,12,133,8
12680,26,64,20910,53,22,8,14,58,3
12681,26,62,20910,20,9,5,4,10,-2
12682,29,62,20910,48,14,4,10,60,-7
12683,29,79,20910,4,1,1,0,0,-4
12684,32,79,20910,43,17,8,9,57,-3
12685,26,89,39665,17,4,0,4,28,-5
12687,14,76,12625,33,17,10,7,6,3
12688,17,76,12625,81,87,43,44,56,-17
12689,20,76,12625,80,90,48,42,43,21
12690,23,76,12625,82,87,45,42,34,-2
12691,26,76,12625,50,50,22,28,34,-6
12692,29,88,12625,64,66,27,39,32,18
12693,32,88,12625,73,89,38,51,20,22
12694,35,88,12625,63,59,32,27,26,5
12695,38,88,12625,76,85,37,48,47,22
12696,41,88,12625,35,41,16,25,12,18
12697,47,79,12625,42,42,11,31,12,5
12698,17,63,5671,12,0,0,0,4,-5
12699,20,63,5671,54,11,3,8,71,-26
12700,20,84,5671,9,6,0,6,20,2
12701,23,84,5671,77,7,3,4,134,-3
12702,26,84,5671,57,2,0,2,54,-12
12706,38,71,5671,76,26,5,21,96,13
12707,41,71,5671,82,28,6,22,86,17
12708,47,71,5671,82,28,8,20,84,10
12709,50,71,5671,58,17,2,15,97,-5
12710,53,71,5671,82,16,7,9,121,-14
12711,56,71,5671,80,14,2,12,92,-5
12712,59,71,5671,40,7,0,7,59,-19
12713,59,62,5671,18,3,1,2,16,-8
12714,62,62,5671,39,10,3,7,24,6
12715,65,76,5671,65,8,0,8,53,-19
12717,2,83,20595,54,28,9,19,132,-19
12718,5,83,20595,34,14,1,13,85,-17
12719,5,62,20595,36,13,3,10,79,2
12720,8,62,20595,35,12,3,9,54,-5
12591,5,63,8573,5,4,3,1,0,2
12592,8,63,8573,27,7,3,4,8,-6
12725,20,71,20595,18,6,2,4,20,-13
12726,20,77,20595,20,3,0,3,51,2
12729,14,84,9124,34,3,1,2,39,-2
12730,17,84,9124,27,2,1,1,21,4
12731,20,84,9124,3,0,0,0,2,-2
12732,20,75,9124,49,8,2,6,42,4
12733,23,75,9124,3,0,0,0,4,0
12734,23,81,9124,25,3,1,2,22,-4
12735,26,81,9124,78,17,5,12,81,-22
12736,29,81,9124,46,2,1,1,66,-12
12737,32,81,9124,74,7,1,6,80,-6
12738,35,81,9124,78,13,4,9,58,-1
12739,38,81,9124,28,4,1,3,31,3
12740,41,81,9124,79,7,2,5,58,8
12741,47,65,9124,54,7,1,6,53,-24
12742,50,65,9124,65,7,1,6,64,-6
12744,56,68,9124,68,10,2,8,37,-10
12745,62,65,9124,36,8,0,8,8,4
12746,8,86,92447,37,23,7,16,40,-9
12747,11,86,92447,81,64,26,38,24,16
12748,14,86,92447,48,25,9,16,30,-6
12749,17,86,92447,7,4,1,3,4,2
12750,17,64,92447,66,50,13,37,50,0
12751,20,64,92447,80,68,23,45,88,4
12752,23,64,92447,66,51,13,38,65,-12
12753,26,64,92447,39,32,7,25,22,10
12754,29,64,92447,82,52,16,36,46,17
12755,32,66,92447,72,44,12,32,71,-25
12756,35,66,92447,46,23,4,19,34,-4
12757,35,68,92447,37,29,10,19,24,-3
12758,38,68,92447,51,26,7,19,40,-16
12759,38,1479,92447,31,18,5,13,16,10
12761,47,1479,92447,17,6,3,3,8,-4
12762,47,74,92447,19,14,3,11,20,2
12763,50,74,92447,21,3,0,3,8,-8
12764,53,86,92447,39,16,3,13,24,-11
12765,17,1479,27215,16,5,2,3,36,0
12766,20,78,27215,68,43,23,20,68,3
12767,23,78,27215,76,41,22,19,55,0
12768,26,78,27215,55,25,4,21,41,-8
12769,29,78,27215,2,0,0,0,9,0
12770,32,75,27215,57,20,9,11,53,-3
12771,35,65,27215,9,2,1,1,4,-3
12772,38,68,27215,1,0,0,0,0,0
12773,47,81,27215,1,0,0,0,2,0
12774,17,85,11559,5,1,0,1,17,2
12775,20,85,11559,75,11,4,7,129,1
12776,23,85,11559,54,7,2,5,71,2
12778,26,1479,11559,70,3,1,2,112,-20
12779,29,70,11559,62,8,0,8,53,0
12780,32,82,11559,75,13,3,10,94,7
12781,35,82,11559,61,6,0,6,54,-10
12782,35,79,11559,15,2,0,2,30,-3
12783,38,79,11559,76,4,3,1,76,-28
12784,41,82,11559,7,0,0,0,2,-2
12785,41,74,11559,7,0,0,0,0,-3
12786,47,82,11559,4,3,1,2,0,1
12787,14,88,24104,1,0,0,0,0,-1
12788,11,67,3729,32,13,6,7,12,1
12789,14,67,3729,42,11,7,4,19,-6
12790,17,67,3729,67,50,25,25,33,-8
12791,20,67,3729,81,48,22,26,32,14
12792,23,67,3729,68,36,19,17,36,10
12793,23,76,3729,13,3,1,2,6,-2
12795,26,75,3729,37,9,4,5,14,0
12796,29,74,3729,3,1,0,1,2,0
12797,35,74,3729,1,0,0,0,0,-1
12800,8,86,1798,25,4,4,0,24,-17
12801,14,80,1798,24,13,5,8,14,-1
12802,17,80,1798,17,8,2,6,10,-1
12803,23,78,1798,16,9,1,8,29,3
12804,26,78,1798,45,22,11,11,16,5
12805,29,71,1798,2,0,0,0,2,0
12806,32,77,1798,7,5,1,4,0,6
12807,14,89,21473,10,1,1,0,2,-2
12808,17,89,21473,33,7,0,7,16,3
12809,26,73,21473,9,3,2,1,2,-1
12810,14,79,76239,4,1,1,0,0,2
12811,17,79,76239,21,3,1,2,12,7
12812,5,63,8644,4,1,1,0,0,1
12814,11,63,8644,59,23,8,15,14,4
12815,14,63,8644,44,18,5,13,8,4
12816,17,63,8644,76,54,18,36,14,-8
12817,20,63,8644,78,76,21,55,14,-22
12818,23,88,8644,77,79,21,58,53,17
12819,26,88,8644,64,34,13,21,10,-18
12820,29,88,8644,57,58,17,41,10,23
12821,32,88,8644,63,55,16,39,14,20
12822,35,88,8644,9,4,1,3,4,1
12823,35,63,8644,72,54,7,47,14,21
12824,38,63,8644,78,51,14,37,12,0
12825,41,88,8644,64,37,8,29,16,5
12826,47,68,8644,74,52,15,37,26,11
12827,50,68,8644,73,57,23,34,22,2
12828,53,68,8644,52,20,7,13,10,-11
12829,17,75,15728,2,1,0,1,2,2
12831,23,75,15728,1,0,0,0,0,1
12832,71,73,15067,1,0,0,0,0,0
12833,14,75,14732,10,2,0,2,0,-5
12834,14,76,14732,3,0,0,0,0,-1
12835,17,76,14732,10,2,0,2,0,-1
12836,20,77,14732,9,5,1,4,2,2
12837,23,77,14732,3,1,1,0,0,0
12838,29,75,14732,76,17,7,10,14,-14
12839,32,75,14732,78,28,12,16,16,-17
12840,35,75,14732,2,0,0,0,0,0
12841,38,72,14732,3,1,0,1,0,-1
12842,41,72,14732,2,0,0,0,0,-1
12843,8,88,73361,12,3,2,1,19,-4
12844,11,88,73361,5,1,0,1,2,1
12722,14,88,20595,40,17,5,12,84,4
12723,17,88,20595,9,1,0,1,27,-1
12849,23,86,25746,8,0,0,0,40,-3
12850,20,64,13638,2,0,0,0,0,0
12851,23,86,13638,11,3,1,2,2,-4
12852,26,74,13638,24,4,1,3,23,-4
12853,32,88,13638,2,0,0,0,0,-3
12854,35,73,13638,4,0,0,0,2,0
12855,38,63,13638,7,1,0,1,6,3
12856,11,83,8906,13,6,3,3,0,1
12857,14,88,8906,26,7,2,5,20,3
12858,17,88,8906,78,49,25,24,16,-11
12859,20,88,8906,41,25,11,14,20,0
12860,23,88,8906,79,48,28,20,32,6
12861,26,88,8906,64,27,10,17,30,-3
12862,26,83,8906,12,15,7,8,12,10
12863,29,83,8906,58,45,18,27,22,3
12864,32,83,8906,76,52,24,28,52,0
12866,38,75,8906,73,46,24,22,30,-11
12867,41,75,8906,69,31,16,15,40,-10
12868,47,73,8906,69,57,22,35,30,-3
12870,50,83,8906,17,5,2,3,4,1
12871,53,65,8906,53,14,9,5,24,-1
12872,11,80,32149,30,5,1,4,18,-10
12873,5,77,41660,1,0,0,0,0,0
12874,14,77,41660,22,0,0,0,8,-7
12875,17,77,41660,12,2,2,0,8,0
12876,17,1479,26138,7,1,0,1,6,0
12877,20,1479,26138,39,14,7,7,20,6
12878,23,1479,26138,62,20,5,15,30,-9
12879,23,79,26138,5,1,1,0,2,-1
12880,26,79,26138,2,0,0,0,0,0
12881,26,74,26138,14,3,0,3,4,-3
12882,26,88,26138,13,1,0,1,4,2
12884,35,82,26138,26,4,3,1,4,-4
12885,38,82,26138,78,13,7,6,72,-26
12886,41,84,26138,3,1,0,1,4,-1
12887,11,62,25717,79,10,5,5,173,-3
12888,14,62,25717,37,8,5,3,101,1
12889,17,62,25717,75,16,9,7,173,-8
12890,20,62,25717,33,8,3,5,113,-8
12891,23,62,25717,52,13,8,5,170,-18
12892,23,81,25717,14,5,0,5,71,-1
12893,26,81,25717,67,12,5,7,135,-22
12894,26,77,25717,13,1,0,1,25,-2
12895,29,77,25717,58,11,6,5,111,-5
12896,29,66,25717,13,0,0,0,9,2
12897,32,74,25717,81,21,11,10,171,3
12898,35,74,25717,82,23,10,13,171,-8
12899,38,74,25717,82,15,6,9,81,-4
12901,41,74,25717,13,1,1,0,2,-8
12902,26,71,315,8,0,0,0,2,-2
12903,5,89,9014,1,0,0,0,0,0
12904,8,89,9014,36,11,4,7,16,4
12905,11,89,9014,62,26,12,14,33,9
12906,14,89,9014,46,25,11,14,44,7
12907,17,89,9014,70,45,23,22,92,13
12908,20,89,9014,78,42,17,25,67,-3
12909,23,89,9014,80,34,10,24,80,9
12910,26,89,9014,45,24,12,12,26,0
12911,29,89,9014,82,43,16,27,80,19
12912,32,89,9014,82,47,24,23,87,8
12913,35,89,9014,28,14,2,12,23,-2
12914,38,89,9014,77,30,15,15,71,3
12915,41,89,9014,6,1,0,1,0,-5
12916,41,64,9014,76,39,19,20,70,2
12920,11,62,119949,15,11,2,9,6,10
12921,14,62,119949,6,1,0,1,2,1
12922,17,62,119949,73,55,17,38,20,0
12923,23,62,119949,65,36,13,23,24,10
12924,26,62,119949,9,5,2,3,2,1
12925,26,81,119949,24,9,2,7,6,-10
12926,29,81,119949,11,3,1,2,4,-3
12927,29,65,119949,66,51,23,28,26,9
12928,32,65,119949,82,64,25,39,32,7
12929,35,65,119949,82,61,15,46,50,28
12930,38,65,119949,9,4,0,4,4,0
12931,38,89,119949,71,56,17,39,36,3
12932,41,89,119949,3,2,0,2,8,1
12933,41,63,119949,15,12,1,11,14,3
12934,47,74,119949,81,79,23,56,76,31
12935,50,74,119949,79,83,26,57,42,12
12937,56,89,119949,72,33,9,24,32,0
12938,14,75,12581,8,1,0,1,0,-1
12939,17,75,12581,14,0,0,0,4,-7
12940,17,62,12581,11,3,2,1,4,-2
12941,20,64,12581,28,3,2,1,6,0
12942,23,64,12581,2,1,1,0,0,1
12943,26,80,12581,11,1,0,1,4,1
12944,29,80,12581,11,2,0,2,7,-3
12946,35,73,12581,1,0,0,0,0,0
12947,11,78,26871,38,5,2,3,14,-9
12948,11,84,26871,11,2,1,1,4,2
12949,14,84,26871,27,8,4,4,2,2
12950,14,74,26871,12,0,0,0,0,1
12951,17,74,26871,5,0,0,0,2,-1
12952,17,88,26871,12,6,2,4,6,-3
12953,20,88,26871,15,4,1,3,8,-8
12955,26,88,26871,33,4,2,2,35,0
12956,2,76,31894,60,5,1,4,126,-12
12957,5,76,31894,65,7,1,6,183,-1
12958,8,76,31894,44,4,1,3,164,-4
12959,11,76,31894,28,5,1,4,75,-4
12960,14,76,31894,20,2,1,1,40,-3
12961,17,76,31894,27,3,0,3,72,-9
12962,20,76,31894,52,5,1,4,179,4
12963,23,76,31894,76,7,0,7,291,1
12964,26,76,31894,52,4,0,4,88,-8
12965,29,76,31894,9,2,0,2,34,-2
12966,29,74,31894,45,4,0,4,36,0
12967,32,74,31894,69,11,2,9,175,-2
12968,35,78,31894,8,2,0,2,9,-1
12846,14,86,25746,9,2,1,1,29,0
12847,17,86,25746,32,9,3,6,138,0
12977,26,66,25726,33,2,0,2,55,1
12978,29,66,25726,27,5,1,4,52,9
12979,32,66,25726,80,10,4,6,159,-19
12980,35,74,25726,75,11,1,10,131,-9
12981,38,74,25726,19,2,0,2,14,-1
12982,5,65,27226,18,9,1,8,4,-3
12983,8,65,27226,38,15,6,9,30,11
12984,8,71,27226,17,12,4,8,2,-8
12985,11,71,27226,81,50,12,38,16,-12
12986,14,71,27226,36,18,7,11,29,-15
12987,17,71,27226,26,8,4,4,10,-13
12988,17,78,27226,40,15,3,12,24,-6
12989,20,78,27226,82,28,4,24,35,7
12990,23,80,27226,81,35,8,27,8,-19
12991,26,80,27226,79,25,4,21,32,14
12992,29,80,27226,64,18,6,12,20,-5
12994,32,62,27226,37,8,0,8,4,-12
12995,35,62,27226,78,26,4,22,19,3
12996,38,68,27226,7,1,0,1,4,-3
12997,14,67,41144,12,1,0,1,0,-1
12998,5,75,3724,2,0,0,0,0,-1
12999,8,71,3724,30,11,1,10,8,-1
13000,11,71,3724,40,19,4,15,14,-7
13001,23,81,3724,30,6,2,4,16,-2
13003,38,79,3724,5,1,0,1,0,-4
13006,17,70,69168,10,3,1,2,17,-1
13007,20,85,4320,9,1,1,0,0,-1
13008,23,85,4320,53,13,7,6,16,2
13009,26,74,4320,82,35,15,20,26,-7
13010,29,74,4320,59,14,9,5,18,-5
13011,29,63,4320,14,6,3,3,8,-2
13012,32,63,4320,82,20,7,13,37,0
13014,38,63,4320,75,59,30,29,45,18
13015,41,63,4320,82,46,21,25,32,19
13016,47,77,4320,82,65,34,31,80,25
13017,50,77,4320,64,54,24,30,56,2
13018,53,77,4320,82,55,29,26,72,-3
13019,56,77,4320,82,47,27,20,62,5
13020,59,89,4320,69,53,29,24,59,23
13021,62,89,4320,79,40,24,16,36,10
13022,65,89,4320,72,18,6,12,32,-15
13023,68,77,4320,28,8,4,4,20,-4
13024,11,88,39662,12,1,1,0,20,-3
13025,8,88,8690,78,48,12,36,80,-3
13026,11,88,8690,81,52,12,40,101,-11
13027,14,88,8690,11,7,2,5,27,-3
13028,14,67,8690,21,7,2,5,34,-3
13029,17,67,8690,80,36,6,30,58,-25
13031,23,67,8690,78,45,15,30,102,19
13032,26,67,8690,81,33,7,26,96,-6
13033,29,67,8690,74,13,2,11,95,-6
13034,32,67,8690,78,37,8,29,75,-3
13035,35,67,8690,82,34,1,33,80,-1
13036,38,67,8690,70,21,3,18,85,-5
13037,41,67,8690,68,28,4,24,102,-13
13038,47,76,8690,59,29,5,24,88,4
13039,50,76,8690,30,11,2,9,40,13
13040,50,77,8690,31,13,3,10,38,-16
13045,32,77,15729,2,0,0,0,0,-1
13046,11,77,10829,1,0,0,0,0,-1
13047,17,77,10829,17,2,0,2,12,-1
13048,20,77,10829,3,1,0,1,0,0
13049,29,76,10829,18,3,2,1,6,-5
13050,32,76,10829,56,8,0,8,26,-12
13052,41,78,10829,13,0,0,0,4,0
13053,2,89,31122,79,70,20,50,34,3
13054,5,89,31122,80,80,23,57,47,10
13055,8,89,31122,69,74,21,53,66,14
13056,11,89,31122,82,50,14,36,38,2
13057,14,89,31122,46,33,10,23,50,3
13058,17,89,31122,73,81,16,65,36,18
13059,20,89,31122,54,23,7,16,22,-15
13060,23,89,31122,33,9,3,6,20,5
13061,26,89,31122,36,11,5,6,12,-6
13062,14,70,24153,1,0,0,0,0,0
13063,17,70,24153,2,0,0,0,0,0
13069,35,81,2702,65,13,3,10,8,-10
13070,35,80,2702,15,2,1,1,2,-1
13071,11,76,17935,5,0,0,0,0,0
13072,11,84,25833,19,6,2,4,18,-3
13074,26,79,25833,67,10,2,8,27,-9
13075,29,81,25833,50,14,4,10,21,-11
13076,14,70,4328,44,18,6,12,33,4
13077,17,70,4328,61,26,9,17,48,-7
13078,20,70,4328,24,7,1,6,13,3
13079,23,83,4328,13,1,0,1,14,-2
13080,23,70,4328,2,0,0,0,2,1
13081,26,76,4328,1,0,0,0,2,0
13083,11,76,38783,23,3,2,1,4,4
13084,14,76,38783,2,2,1,1,0,2
13085,11,83,21075,25,1,1,0,4,-3
13088,11,68,27311,84,12,6,6,97,-2
13089,14,68,27311,48,19,10,9,46,1
13090,17,68,27311,73,34,12,22,57,13
13091,20,68,27311,81,34,11,23,120,1
13092,23,68,27311,82,28,12,16,80,-2
13094,29,62,27311,80,20,8,12,86,-7
13095,32,62,27311,52,10,1,9,97,-8
13096,32,86,27311,16,4,0,4,29,2
13097,35,68,27311,63,11,4,7,117,-11
13098,35,75,27311,13,4,1,3,23,0
13099,38,75,27311,19,2,0,2,23,-1
13101,65,82,45534,67,21,9,12,24,-2
13102,68,82,45534,40,12,5,7,12,-7
13103,71,82,45534,82,63,33,30,43,3
13104,74,82,45534,82,71,26,45,40,-6
13105,77,82,45534,38,26,6,20,25,-4
13106,77,73,45534,42,34,8,26,36,10
13107,80,73,45534,82,61,14,47,60,1
13108,83,73,45534,79,54,15,39,78,13
12974,17,1479,25726,72,19,3,16,270,-3
12975,20,1479,25726,69,13,2,11,210,11
13113,17,71,1427,37,29,12,17,8,7
13114,20,71,1427,76,47,26,21,16,0
13115,23,76,1427,68,25,12,13,23,11
13116,26,76,1427,78,38,21,17,14,-10
13117,29,76,1427,79,70,35,35,34,-16
13118,32,76,1427,82,62,30,32,48,-24
13119,35,76,1427,82,51,22,29,48,-8
13120,38,75,1427,43,14,5,9,16,-7
13121,41,76,1427,81,49,25,24,16,8
13122,47,83,1427,19,5,4,1,6,-2
13123,47,63,1427,16,5,4,1,4,-4
13124,26,73,12672,19,6,4,2,2,4
13125,29,73,12672,80,25,14,11,21,-11
13126,32,73,12672,60,14,8,6,26,-2
13127,35,88,12672,17,2,1,1,8,-4
13128,38,1479,12672,10,1,1,0,2,1
13130,11,84,31544,17,5,0,5,10,-2
13131,14,84,31544,16,3,0,3,4,2
13132,20,84,31544,2,0,0,0,4,-1
13133,23,76,31544,6,1,0,1,4,-1
13134,29,73,31544,2,0,0,0,2,0
13135,14,70,26311,2,0,0,0,0,0
13136,17,70,26311,13,1,0,1,17,0
13137,23,76,26311,2,0,0,0,2,0
13138,26,76,26311,60,30,14,16,38,-8
13139,29,76,26311,29,6,1,5,26,-13
13140,32,76,26311,36,7,3,4,32,-9
13141,8,77,18646,82,32,5,27,71,12
13142,11,77,18646,75,30,5,25,86,-8
13143,14,77,18646,40,14,5,9,47,-4
13144,17,83,18646,69,11,1,10,54,-14
13145,20,83,18646,74,14,4,10,56,-24
13147,26,83,18646,78,28,6,22,88,25
13148,29,83,18646,77,27,3,24,55,2
13149,32,83,18646,81,24,5,19,52,-2
13150,35,83,18646,55,19,6,13,26,14
13151,38,68,18646,23,7,1,6,14,-12
13152,38,88,18646,42,3,0,3,24,-4
13153,38,77,18646,18,4,2,2,8,7
13154,14,88,8533,15,2,0,2,49,-2
13155,17,88,8533,71,7,2,5,127,3
13156,20,88,8533,55,17,5,12,144,-13
13157,23,88,8533,80,17,2,15,179,7
13158,26,88,8533,80,14,1,13,186,1
13159,29,88,8533,80,14,2,12,114,4
13160,32,69,8533,63,16,4,12,128,-2
13161,32,72,8533,17,1,0,1,33,2
13162,35,63,8533,80,25,3,22,89,27
13164,41,63,8533,82,11,1,10,110,10
13166,47,1479,8533,21,3,1,2,26,3
13167,50,1479,8533,79,17,2,15,92,9
13168,53,1479,8533,82,9,2,7,84,9
13169,56,88,8533,82,12,0,12,71,2
13170,59,88,8533,78,15,3,12,70,14
13171,62,77,8533,81,18,1,17,87,8
13172,65,65,8533,51,7,0,7,23,-6
13173,14,67,25643,4,3,0,3,0,2
13174,17,67,25643,58,20,10,10,37,-21
13175,20,67,25643,81,51,22,29,54,9
13176,23,67,25643,69,35,14,21,36,-2
13177,26,67,25643,81,34,17,17,45,2
13178,29,67,25643,59,24,7,17,30,4
13179,29,81,25643,14,6,3,3,21,-7
13180,32,81,25643,70,36,11,25,64,-9
13182,38,81,25643,5,1,0,1,2,1
13183,38,79,25643,9,3,1,2,6,-6
13184,41,79,25643,61,21,6,15,38,-27
13185,41,82,25643,13,1,1,0,2,-4
13186,8,75,10839,9,3,2,1,10,2
13187,11,75,10839,55,27,12,15,2,7
13188,14,75,10839,12,5,2,3,4,-7
13189,17,75,10839,36,11,4,7,23,-9
13190,29,75,10839,44,26,2,24,8,10
13191,32,75,10839,81,47,17,30,24,-11
13192,35,75,10839,75,41,24,17,12,-4
13193,38,75,10839,53,23,7,16,16,-2
13194,38,73,10839,17,4,2,2,2,-4
13195,20,80,3568,67,21,11,10,49,4
13196,23,80,3568,55,18,7,11,50,2
13197,26,80,3568,59,12,4,8,43,6
13199,29,81,3568,41,9,3,6,37,-21
13200,32,82,3568,73,22,7,15,78,-1
13201,35,72,3568,7,3,2,1,2,-1
13202,8,86,56683,7,2,0,2,0,-6
13203,11,86,56683,9,5,3,2,2,-5
13204,23,83,211589,29,6,2,4,8,-1
13206,17,76,2191,3,1,0,1,0,1
13207,20,76,2191,15,4,2,2,0,-6
13208,20,79,2191,27,9,2,7,20,-6
13209,23,79,2191,50,15,5,10,20,4
13210,26,80,2191,69,37,21,16,34,1
13211,29,81,2191,12,5,2,3,8,1
13212,29,62,2191,28,10,3,7,14,-3
13213,35,74,2191,70,24,14,10,46,6
13214,38,73,2191,56,37,20,17,22,-4
13215,41,73,2191,47,27,12,15,26,-2
13217,8,77,27216,51,20,8,12,34,15
13218,11,68,27216,76,47,19,28,26,1
13219,14,68,27216,31,7,1,6,6,-5
13220,14,71,7222,44,30,16,14,20,-11
13221,17,71,7222,80,39,20,19,34,-22
13222,20,71,7222,17,3,1,2,4,-8
13223,20,74,7222,14,3,2,1,4,3
13224,26,80,7222,17,7,2,5,4,1
13226,32,80,7222,7,0,0,0,2,0
13227,38,70,7222,6,3,0,3,2,1
13228,41,70,7222,36,12,7,5,12,6
13229,47,70,7222,3,0,0,0,0,-1
13230,11,83,50116,2,0,0,0,2,-1
13231,14,88,50116,32,9,2,7,22,-7
13110,11,63,1427,4,3,2,1,0,-2
13111,14,63,1427,47,26,12,14,31,4
13236,20,79,74679,6,0,0,0,8,0
13237,2,84,12648,48,12,2,10,62,-23
13238,5,84,12648,16,10,1,9,14,4
13239,8,84,12648,57,27,6,21,53,28
13240,11,84,12648,47,10,1,9,6,-5
13248,35,64,15427,10,2,2,0,2,1
13249,11,78,76947,2,0,0,0,0,1
13250,14,78,76947,5,0,0,0,2,-1
13251,5,83,27211,7,1,1,0,0,-4
13252,8,83,27211,59,31,7,24,40,-1
13253,11,83,27211,76,36,9,27,78,5
13254,14,83,27211,33,17,5,12,28,6
13255,17,79,27211,72,34,3,31,88,19
13256,20,79,27211,15,6,1,5,24,-4
13257,20,1479,27211,62,46,12,34,77,20
13258,23,1479,27211,66,36,6,30,115,-7
13259,23,85,27211,11,7,2,5,4,0
13260,26,89,27211,46,16,2,14,80,-5
13261,29,89,27211,73,22,3,19,28,7
13262,32,89,27211,36,8,3,5,6,-7
13263,2,72,61693,14,10,4,6,10,8
13264,5,72,61693,7,3,1,2,6,-1
13265,62,72,33738,17,5,3,2,2,-2
13266,65,72,33738,30,7,1,6,4,6
13267,68,81,33738,2,0,0,0,0,-1
13268,71,81,33738,7,0,0,0,0,0
13269,77,81,33738,3,0,0,0,0,0
13272,11,81,70156,71,9,3,6,118,3
13273,14,81,70156,25,2,1,1,92,0
13274,17,81,70156,57,4,1,3,88,-2
13275,20,81,70156,60,6,0,6,120,-3
13276,23,78,70156,50,8,1,7,64,-5
13277,26,78,70156,16,0,0,0,33,0
13278,29,78,70156,12,0,0,0,24,-3
13279,11,75,8868,3,1,1,0,0,0
13280,14,75,8868,37,19,12,7,27,5
13281,17,75,8868,75,33,25,8,28,-8
13282,20,75,8868,81,60,23,37,39,-14
13283,23,75,8868,64,43,26,17,36,11
13284,26,75,8868,54,26,16,10,20,-14
13285,29,75,8868,38,29,17,12,19,-4
13286,32,75,8868,62,45,21,24,26,-13
13287,35,75,8868,47,29,14,15,30,-14
13291,41,78,8868,13,7,4,3,2,-3
13292,47,77,8868,66,14,9,5,28,-18
13293,56,77,34042,1,0,0,0,0,0
13294,23,78,70042,5,2,0,2,0,1
13295,29,74,70042,2,0,0,0,0,-1
13296,71,65,16153,16,3,1,2,2,-2
13297,74,65,16153,38,3,0,3,4,-5
13298,77,66,16153,71,24,10,14,12,1
13299,80,66,16153,82,12,7,5,17,-12
13300,83,66,16153,75,7,2,5,6,-11
13301,86,63,16153,70,12,7,5,13,0
13302,56,81,34108,1,0,0,0,0,-1
13303,71,82,37557,17,1,0,1,2,0
13304,74,82,37557,33,5,1,4,21,-8
13305,77,82,37557,8,2,1,1,5,3
13306,80,84,37557,68,9,4,5,29,-12
13307,83,84,37557,9,0,0,0,5,-4
13308,86,75,37557,32,5,0,5,14,-4
13309,2,85,53933,9,0,0,0,55,-4
13310,5,85,53933,5,1,1,0,52,-2
13311,8,88,53933,20,1,0,1,61,-10
13312,11,88,53933,3,0,0,0,26,-3
13314,14,63,53933,6,1,0,1,4,1
13315,17,63,53933,27,0,0,0,12,-2
13316,59,1479,24914,8,0,0,0,0,0
13317,59,88,18744,3,1,1,0,0,-2
13318,56,83,31223,5,2,1,1,2,-1
13319,59,83,31223,31,7,2,5,16,-2
13320,62,83,31223,6,0,0,0,4,0
13321,74,79,20711,14,2,1,1,4,-3
13322,77,79,20711,41,11,4,7,12,1
13323,80,79,20711,57,28,15,13,8,4
13324,83,79,20711,69,38,13,25,26,11
13325,86,79,20711,72,35,18,17,24,10
13326,17,75,56761,14,2,2,0,4,-1
13327,23,71,56761,29,23,12,11,6,6
13328,26,74,56761,28,6,2,4,14,-12
13329,2,63,42515,31,20,8,12,25,5
13330,5,63,42515,18,8,4,4,18,-2
13331,8,63,42515,84,49,16,33,62,29
13332,11,89,42515,63,25,6,19,52,-1
13333,14,89,42515,29,9,4,5,10,2
13334,11,62,30915,4,0,0,0,4,-2
13335,5,63,64996,3,0,0,0,2,-1
13336,32,70,13637,2,0,0,0,0,-1
13337,5,86,76685,32,16,5,11,8,-3
13338,8,86,76685,8,4,3,1,4,-4
13339,11,86,76685,58,9,3,6,16,-13
13340,59,83,11584,37,27,8,19,6,-5
13341,62,83,11584,82,32,15,17,14,-29
13342,65,83,11584,73,47,18,29,22,-7
13343,68,83,11584,46,28,12,16,6,-1
13344,71,83,11584,58,49,19,30,14,2
13345,74,83,11584,82,49,23,26,44,-34
13346,77,83,11584,57,35,12,23,18,-9
13347,80,83,11584,78,55,18,37,30,-1
13348,83,83,11584,81,43,11,32,28,6
13349,86,78,11584,72,38,13,25,20,-3
13350,2,65,53891,71,34,15,19,122,11
13351,5,86,53891,47,22,8,14,76,-29
13352,5,67,53891,12,4,2,2,57,2
13353,8,67,53891,79,32,15,17,96,5
13354,11,67,53891,65,25,17,8,103,18
13355,14,67,53891,46,19,14,5,41,5
13356,17,74,53891,61,10,4,6,71,7
13357,17,83,53891,19,4,2,2,14,-4
13233,29,75,69904,1,0,0,0,5,0
13234,11,79,74679,27,4,3,1,10,-5
13366,23,81,8839,45,9,2,7,85,-5
13367,23,75,8839,4,1,0,1,12,-2
13368,26,75,8839,76,12,3,9,109,-3
13369,29,75,8839,43,6,1,5,76,-11
13370,29,71,8839,14,3,0,3,10,-3
13371,32,71,8839,67,23,3,20,90,15
13372,35,74,8839,39,6,0,6,53,-4
13373,35,68,8839,14,4,0,4,11,-3
13374,38,68,8839,56,2,1,1,39,7
13375,41,71,8839,42,18,5,13,28,19
13376,47,71,8839,37,9,3,6,29,-11
13377,65,67,33265,3,1,1,0,5,0
13378,59,84,34937,2,0,0,0,0,0
13379,62,84,34937,2,0,0,0,0,0
13380,65,81,34937,3,0,0,0,0,2
13381,59,1479,31236,41,19,9,10,16,-3
13383,71,547,73828,1,0,0,0,0,-1
13384,77,547,73828,11,0,0,0,0,1
13385,80,547,73828,18,2,0,2,8,0
13386,56,77,35355,1,0,0,0,0,1
13387,8,65,41167,1,0,0,0,0,0
13388,59,74,16715,69,15,4,11,23,0
13389,62,74,16715,58,11,3,8,14,5
13390,65,81,16715,53,17,2,15,16,2
13391,65,80,16715,14,3,1,2,2,0
13392,68,74,16715,15,0,0,0,6,-3
13393,71,68,16715,16,2,1,1,6,-2
13394,71,79,35633,20,0,0,0,12,-4
13395,74,79,35633,42,3,1,2,60,-3
13396,74,83,35633,21,1,0,1,24,-2
13397,77,89,35633,10,1,1,0,2,0
13398,23,71,69975,16,0,0,0,20,0
13400,2,62,27829,24,7,1,6,0,-3
13401,2,85,8858,58,15,3,12,106,-12
13402,5,85,8858,35,16,6,10,83,9
13403,8,85,8858,73,32,15,17,152,-6
13404,11,85,8858,78,73,31,42,173,34
13405,14,85,8858,45,42,15,27,99,17
13406,17,85,8858,74,52,27,25,168,19
13408,23,66,8858,81,63,26,37,110,19
13409,26,66,8858,78,62,30,32,75,8
13410,29,77,8858,23,17,7,10,31,10
13411,32,77,8858,71,73,34,39,76,17
13412,35,77,8858,75,48,19,29,128,-3
13413,38,77,8858,80,46,19,27,93,4
13414,41,77,8858,54,22,7,15,80,11
13415,47,77,8858,9,7,1,6,6,0
13416,59,74,7542,7,0,0,0,0,2
13418,2,79,68712,2,1,0,1,0,0
13419,5,79,68712,49,10,2,8,4,5
13420,2,85,21360,55,39,16,23,315,-3
13421,5,85,21360,63,44,20,24,276,16
13422,8,85,21360,80,43,14,29,292,-9
13423,11,85,21360,66,17,7,10,275,-1
13424,17,65,21360,78,40,19,21,237,15
13425,20,65,21360,82,23,9,14,326,-3
13426,23,65,21360,14,3,2,1,48,-7
13427,26,65,21360,78,21,7,14,206,-11
13428,29,65,21360,69,15,4,11,114,10
13429,32,65,21360,79,19,7,12,103,-13
13430,35,65,21360,61,4,1,3,176,-9
13431,77,86,16031,76,36,11,25,20,4
13432,80,86,16031,61,17,6,11,10,-5
13433,83,86,16031,66,32,14,18,26,10
13435,11,86,76684,6,1,1,0,0,1
13436,8,86,10959,5,1,1,0,0,-1
13437,68,84,11463,31,9,3,6,4,0
13438,71,84,11463,25,6,3,3,2,-7
13439,74,69,11463,25,8,3,5,2,9
13440,77,69,11463,26,4,2,2,2,2
13441,80,69,11463,37,13,6,7,0,5
13442,83,82,11463,21,2,1,1,4,-4
13443,65,74,6047,18,2,0,2,8,-2
13444,68,82,6047,31,5,0,5,14,4
13445,71,82,6047,2,0,0,0,2,2
13446,74,82,6047,19,6,1,5,4,-3
13447,74,65,6047,8,0,0,0,4,1
13448,74,83,6047,15,1,1,0,6,-5
13449,62,89,882,69,27,13,14,10,2
13450,65,89,882,80,46,14,32,8,-5
13452,71,89,882,80,44,8,36,4,-21
13453,74,89,882,82,47,20,27,10,6
13454,77,89,882,74,46,17,29,16,12
13455,80,89,882,82,58,24,34,10,25
13456,83,72,882,29,14,5,9,14,-11
13457,86,72,882,48,27,12,15,8,-15
13458,86,63,882,10,3,1,2,0,-1
13459,62,63,32878,23,7,3,4,6,3
13460,65,63,32878,48,15,7,8,14,0
13461,68,63,32878,17,3,1,2,4,1
13462,71,63,32878,35,3,1,2,36,-8
13463,74,63,32878,11,0,0,0,16,-1
13464,74,64,32878,19,0,0,0,2,-1
13465,77,78,32878,4,0,0,0,0,-3
13466,62,1479,17498,10,1,1,0,0,-1
13467,65,1479,17498,18,7,4,3,6,3
13469,71,1479,17498,71,31,14,17,38,9
13470,74,1479,17498,57,29,14,15,37,-2
13471,77,72,17498,82,57,30,27,39,3
13472,80,72,17498,80,53,26,27,46,2
13473,83,72,17498,62,44,24,20,30,-1
13474,86,72,17498,74,50,27,23,42,-9
13475,65,65,19292,28,1,0,1,6,-5
13476,71,68,19292,44,12,3,9,8,-3
13477,74,68,19292,44,8,2,6,20,-7
13478,77,68,19292,8,1,0,1,2,-1
13479,65,83,21053,15,0,0,0,13,-10
13480,71,83,21053,32,3,0,3,19,1
13481,74,83,21053,7,0,0,0,0,-3
13482,65,79,30918,18,4,1,3,10,5
13363,17,65,8839,53,9,1,8,92,12
13364,17,81,8839,11,3,2,1,24,-1
13487,77,1479,30918,32,4,0,4,8,2
13488,80,1479,30918,1,0,0,0,0,0
13489,71,85,13929,4,0,0,0,2,0
13490,74,85,13929,3,1,1,0,0,1
13491,77,85,13929,10,0,0,0,7,-3
13492,77,63,13929,58,10,5,5,20,-8
13493,83,69,13929,2,1,1,0,0,1
13494,59,64,14368,81,26,8,18,18,4
13495,62,64,14368,74,26,13,13,16,-7
13496,65,64,14368,81,55,18,37,12,-1
13497,68,64,14368,29,20,6,14,4,-3
13498,71,64,14368,80,64,28,36,2,-1
13499,74,64,14368,82,55,17,38,12,-5
13500,77,67,14368,71,60,21,39,8,-16
13501,80,67,14368,72,55,20,35,10,-1
13502,83,67,14368,81,61,24,37,2,-23
13504,8,74,67317,24,12,7,5,16,4
13505,11,1479,67317,36,11,8,3,44,-7
13506,17,1479,67317,7,2,2,0,15,-1
13507,29,88,38336,50,12,6,6,17,4
13508,32,88,38336,4,1,1,0,2,-2
13509,35,88,38336,46,16,7,9,40,5
13510,38,88,38336,62,14,8,6,33,-10
13511,41,88,38336,53,7,3,4,30,-3
13514,71,89,31307,6,2,1,1,0,0
13515,74,89,31307,5,1,1,0,2,1
13516,77,89,31307,1,0,0,0,0,0
13517,17,79,40995,8,0,0,0,8,2
13518,68,70,32992,7,7,6,1,0,3
13519,71,70,32992,79,35,13,22,38,-21
13520,74,80,32992,76,26,11,15,67,-5
13521,77,80,32992,77,14,8,6,45,2
13523,83,89,32992,61,18,9,9,26,1
13524,86,71,32992,73,38,22,16,32,-1
13525,68,80,6555,48,19,10,9,12,9
13526,71,1479,6555,52,23,10,13,12,2
13527,74,1479,6555,81,39,13,26,24,15
13528,77,1479,6555,82,39,20,19,32,8
13529,80,1479,6555,79,49,23,26,20,10
13530,83,1479,6555,77,40,17,23,18,6
13531,86,1479,6555,73,43,24,19,28,-9
13532,26,70,6808,14,0,0,0,10,-1
13533,29,70,6808,67,17,4,13,50,11
13534,32,70,6808,33,4,2,2,4,-2
13535,32,82,6808,14,1,1,0,13,-2
13536,35,82,6808,60,9,2,7,46,-18
13537,35,62,6808,7,2,0,2,4,1
13538,38,62,6808,67,10,2,8,28,-5
13540,59,76,9219,82,54,24,30,22,-15
13541,62,76,9219,79,67,29,38,53,-16
13542,65,76,9219,82,81,31,50,26,-6
13543,68,76,9219,48,47,28,19,18,-2
13544,71,76,9219,59,66,24,42,40,-6
13545,74,76,9219,82,86,38,48,46,5
13546,77,76,9219,78,70,33,37,38,6
13547,80,76,9219,77,66,28,38,38,4
13548,83,76,9219,82,84,37,47,26,-12
13549,86,83,9219,82,88,47,41,34,19
13550,59,81,6002,74,20,4,16,79,-3
13551,62,81,6002,79,26,3,23,70,3
13552,65,81,6002,61,23,5,18,65,-9
13553,68,81,6002,44,20,4,16,31,1
13554,71,81,6002,75,55,13,42,53,5
13555,74,81,6002,59,38,10,28,40,12
13557,80,81,6002,79,72,16,56,47,3
13558,83,81,6002,77,63,17,46,54,32
13559,86,81,6002,70,54,12,42,44,24
13560,59,64,12574,81,55,24,31,16,1
13561,62,64,12574,80,67,27,40,33,-8
13562,65,64,12574,58,28,14,14,8,-11
13563,68,64,12574,47,43,17,26,12,-12
13564,71,64,12574,71,70,23,47,19,8
13565,74,64,12574,82,55,21,34,16,3
13566,77,64,12574,76,59,30,29,24,-8
13567,80,64,12574,77,41,18,23,12,-34
13568,83,64,12574,14,10,4,6,4,1
13569,83,80,12574,68,49,23,26,14,-23
13570,86,80,12574,50,58,27,31,6,-2
13571,86,82,12574,23,12,4,8,2,-1
13574,65,547,14651,74,57,30,27,53,11
13576,71,547,14651,63,41,19,22,66,-7
13577,74,547,14651,37,22,10,12,56,-1
13578,77,67,14651,65,35,20,15,91,-14
13579,80,67,14651,70,43,28,15,113,-17
13580,83,67,14651,61,40,20,20,57,-14
13581,83,86,14651,17,14,9,5,25,5
13582,86,86,14651,75,56,30,26,153,-4
13583,59,88,14737,1,0,0,0,0,-1
13584,62,88,14737,8,2,0,2,0,-1
13585,65,77,14737,54,18,12,6,34,-7
13586,68,77,14737,47,26,8,18,24,-8
13587,71,77,14737,82,41,20,21,54,0
13588,74,77,14737,82,47,18,29,34,-5
13589,77,77,14737,80,59,26,33,33,3
13590,80,77,14737,79,55,25,30,38,-13
13591,83,78,14737,82,70,28,42,56,10
13593,2,62,31547,19,2,0,2,30,-4
13594,2,84,31547,10,1,1,0,8,-3
13595,5,84,31547,70,14,3,11,147,15
13596,8,84,31547,79,16,5,11,196,34
13597,11,84,31547,80,20,6,14,109,4
13598,14,84,31547,40,8,0,8,129,14
13599,17,84,31547,69,12,2,10,130,9
13600,20,84,31547,61,8,1,7,118,7
13601,23,84,31547,31,7,5,2,42,-3
13602,26,84,31547,12,2,0,2,21,1
13603,59,83,14720,1,0,0,0,0,-1
13604,62,83,14720,29,12,3,9,8,-3
13605,65,83,14720,21,7,5,2,8,2
13606,68,83,14720,48,44,18,26,23,15
13484,71,79,30918,34,5,0,5,26,4
13485,74,79,30918,59,17,2,15,64,9
13611,83,83,14720,80,55,32,23,42,2
13612,86,83,14720,73,44,16,28,43,-2
13613,65,71,6010,56,6,2,4,12,-8
13614,68,71,6010,11,1,0,1,2,-4
13615,71,71,6010,27,1,0,1,4,-10
13616,74,71,6010,38,20,6,14,14,-12
13617,77,71,6010,61,3,1,2,18,-9
13618,80,71,6010,22,4,1,3,6,2
13619,59,80,12106,1,0,0,0,2,0
13620,65,80,12106,82,17,5,12,56,-4
13621,68,80,12106,7,1,1,0,10,1
13622,71,80,12106,68,15,6,9,45,0
13623,74,80,12106,54,9,3,6,45,-11
13624,77,80,12106,37,4,0,4,16,7
13625,62,71,6009,80,34,15,19,16,-13
13626,65,71,6009,41,8,2,6,4,-7
13628,71,78,6009,55,12,6,6,6,-6
13629,74,78,6009,10,1,0,1,6,-2
13630,77,78,6009,48,9,3,6,8,-9
13631,80,78,6009,32,13,8,5,6,9
13632,83,78,6009,44,4,2,2,8,-3
13633,83,80,6009,35,8,6,2,4,-8
13634,86,80,6009,80,19,11,8,6,-14
13635,65,73,14006,32,11,3,8,4,5
13636,68,73,14006,32,6,2,4,15,-2
13637,71,73,14006,80,27,6,21,24,9
13638,74,73,14006,58,27,9,18,27,8
13639,77,73,14006,79,32,10,22,35,13
13640,80,73,14006,71,38,16,22,29,17
13641,83,73,14006,44,32,9,23,6,26
13642,86,73,14006,82,41,7,34,20,21
13643,65,76,23809,1,0,0,0,0,1
13645,74,76,23809,65,12,1,11,24,3
13646,77,76,23809,72,16,2,14,20,3
13647,80,76,23809,82,25,5,20,36,15
13648,83,76,23809,33,12,1,11,8,11
13649,86,66,23809,74,14,1,13,20,1
13650,65,67,15388,27,7,3,4,20,-1
13651,65,84,15388,17,3,1,2,31,-1
13652,68,84,15388,39,11,7,4,51,-7
13653,71,84,15388,73,29,14,15,124,-4
13654,74,84,15388,42,16,10,6,81,-5
13655,77,71,15388,36,8,3,5,114,-7
13656,80,71,15388,79,24,7,17,101,4
13657,83,71,15388,74,19,7,12,92,-8
13658,86,71,15388,79,26,15,11,102,-6
13659,59,68,11862,68,16,3,13,32,-5
13660,62,68,11862,72,26,6,20,45,-5
13662,68,68,11862,34,10,3,7,22,-5
13663,71,68,11862,81,19,8,11,66,-26
13664,74,68,11862,73,22,3,19,48,0
13665,77,68,11862,74,17,1,16,51,8
13666,80,67,11862,47,5,2,3,26,-26
13667,83,547,11862,62,11,3,8,22,6
13668,86,547,11862,57,6,0,6,47,4
13669,65,1479,24659,4,1,1,0,2,0
13670,68,1479,24659,21,5,3,2,4,4
13671,71,1479,24659,4,1,1,0,2,-1
13672,71,83,24659,39,10,5,5,16,1
13673,74,83,24659,62,25,11,14,31,0
13674,77,83,24659,65,27,9,18,28,-16
13675,80,83,24659,8,1,0,1,4,-2
13676,80,87,24659,40,11,5,6,18,-14
13677,83,74,24659,23,4,1,3,7,-10
13679,65,65,38082,82,37,3,34,10,-12
13680,68,65,38082,48,18,6,12,10,15
13681,71,65,38082,82,31,7,24,10,10
13682,74,76,38082,78,37,10,27,14,18
13683,77,76,38082,81,40,5,35,25,-9
13684,80,76,38082,81,46,11,35,12,-3
13685,83,76,38082,80,42,10,32,20,-42
13686,86,76,38082,82,26,4,22,18,0
13687,65,80,7069,24,4,1,3,6,-11
13691,71,65,7069,5,0,0,0,0,-1
13692,74,65,7069,49,14,3,11,12,17
13693,77,65,7069,9,2,0,2,6,-2
13694,65,75,31628,42,10,5,5,28,3
13695,71,75,31628,8,0,0,0,4,1
13696,68,74,38007,23,3,2,1,6,-1
13697,71,74,38007,66,37,17,20,72,14
13699,77,74,38007,79,43,21,22,58,10
13700,80,74,38007,75,53,28,25,58,6
13701,83,74,38007,58,37,16,21,44,-2
13702,86,74,38007,79,52,28,24,57,4
13703,62,72,7652,28,10,3,7,6,5
13704,65,72,7652,41,9,2,7,6,10
13705,68,72,7652,22,3,1,2,2,-10
13706,71,72,7652,27,3,1,2,4,0
13707,74,72,7652,62,11,6,5,24,0
13708,77,72,7652,58,14,4,10,20,-21
13709,80,72,7652,38,10,1,9,16,-1
13710,83,67,7652,39,4,2,2,6,-4
13711,62,82,30916,2,0,0,0,0,0
13712,65,82,30916,67,7,2,5,8,-23
13713,68,82,30916,17,1,0,1,2,-5
13714,68,74,30916,13,6,1,5,5,9
13716,74,74,30916,38,6,1,5,19,7
13717,74,87,30916,19,5,1,4,11,-11
13718,77,72,30916,73,19,4,15,28,-12
13719,80,72,30916,63,22,12,10,39,-7
13720,83,72,30916,81,18,7,11,47,3
13721,86,63,30916,61,13,4,9,26,0
13722,65,67,31090,25,8,1,7,15,-1
13723,71,67,31090,12,0,0,0,6,1
13724,74,88,31090,71,24,2,22,52,11
13725,77,88,31090,81,14,2,12,92,11
13726,80,88,31090,49,4,2,2,54,1
13727,83,20120,31090,76,15,5,10,52,26
13728,86,20120,31090,81,16,4,12,52,11
13730,17,64,2655,3,1,1,0,0,-1
13608,74,83,14720,73,39,18,21,28,-7
13609,77,83,14720,76,45,17,28,73,-15
13735,29,80,2655,60,12,1,11,55,14
13736,29,79,2655,11,8,1,7,12,3
13737,32,79,2655,50,20,3,17,34,9
13738,35,79,2655,47,13,6,7,28,-18
13739,38,79,2655,17,7,1,6,8,-3
13740,38,81,2655,2,1,1,0,0,1
13741,71,83,37720,2,0,0,0,0,-1
13742,65,70,33916,3,0,0,0,2,-3
13743,68,70,33916,37,9,3,6,8,0
13744,71,63,33916,82,51,20,31,14,28
13745,74,63,33916,81,40,13,27,20,7
13746,77,68,33916,82,50,25,25,31,19
13747,80,68,33916,80,37,15,22,17,-13
13748,83,20120,33916,67,60,22,38,24,31
13749,86,20120,33916,74,53,19,34,14,13
13750,68,73,24646,16,7,3,4,2,0
13752,74,73,24646,62,16,8,8,18,-4
13753,77,76,24646,2,0,0,0,2,0
13754,80,71,24646,3,0,0,0,4,-1
13755,80,74,24646,2,0,0,0,0,-2
13756,62,85,17745,9,1,1,0,0,0
13757,68,85,17745,18,7,4,3,4,2
13758,71,85,17745,73,39,19,20,30,12
13759,74,85,17745,82,56,29,27,28,6
13760,77,85,17745,81,45,21,24,24,4
13761,80,85,17745,82,46,25,21,26,-8
13762,83,85,17745,62,28,16,12,24,-8
13763,83,20120,17745,20,6,4,2,10,-11
13764,86,75,17745,80,58,25,33,34,21
13765,71,79,10803,5,0,0,0,0,-1
13766,74,87,10803,4,0,0,0,0,-3
13767,77,87,10803,4,0,0,0,2,0
13769,5,63,9660,49,14,4,10,77,-8
13770,5,78,9660,26,6,0,6,32,-3
13771,8,78,9660,75,11,1,10,100,-6
13774,17,75,9660,68,16,2,14,117,-4
13775,20,75,9660,71,22,7,15,100,1
13776,23,75,9660,71,16,6,10,97,13
13777,26,75,9660,82,27,8,19,84,-23
13778,29,74,9660,75,16,2,14,77,-10
13779,32,65,9660,72,19,1,18,60,-9
13780,35,75,9660,75,16,6,10,87,-7
13781,38,75,9660,67,10,5,5,70,-4
13782,41,75,9660,73,8,3,5,82,10
13783,68,62,38073,5,1,1,0,0,0
13784,71,62,38073,11,2,0,2,2,-2
13785,71,75,16045,1,0,0,0,0,0
13786,68,72,37545,1,0,0,0,0,-1
13788,74,72,37545,61,19,6,13,42,-2
13789,77,72,37545,34,6,1,5,16,-8
13790,77,64,37545,6,0,0,0,0,2
13791,80,64,37545,27,1,0,1,12,-4
13792,2,89,82220,7,1,1,0,0,-3
13793,65,89,17751,60,19,3,16,18,1
13794,68,89,17751,5,1,0,1,0,5
13795,71,89,17751,54,11,3,8,19,-1
13796,77,89,17751,82,29,8,21,26,8
13797,80,89,17751,82,33,6,27,51,30
13798,83,89,17751,82,31,10,21,22,10
13799,86,89,17751,82,29,3,26,33,3
13800,65,64,15128,10,0,0,0,0,-2
13801,68,64,15128,32,13,2,11,10,-11
13802,71,64,15128,64,38,13,25,20,17
13803,74,64,15128,80,53,12,41,26,5
13805,80,64,15128,74,38,7,31,18,-34
13806,83,64,15128,68,57,14,43,22,-15
13807,86,64,15128,78,59,14,45,36,-3
13808,62,65,33934,1,0,0,0,0,-1
13809,65,65,33934,5,2,0,2,0,2
13810,68,65,33934,1,0,0,0,0,0
13811,71,65,33934,28,11,6,5,6,6
13812,71,68,33934,21,14,7,7,2,0
13813,74,68,33934,49,24,22,2,14,6
13814,77,68,33934,52,24,11,13,30,-4
13815,77,1479,33934,9,5,3,2,0,0
13816,80,74,33934,60,18,8,10,25,-8
13817,83,20120,33934,2,3,3,0,0,3
13818,86,20120,33934,31,18,12,6,6,7
13820,14,62,67303,3,0,0,0,12,0
13821,20,1479,67303,2,0,0,0,5,0
13823,65,64,15732,39,13,4,9,8,2
13824,68,64,15732,18,4,1,3,2,-3
13825,71,64,15732,1,1,1,0,0,0
13826,74,64,15732,5,0,0,0,2,-2
13827,77,87,15732,19,6,2,4,4,-2
13828,77,73,15732,2,0,0,0,0,-1
13829,86,80,15732,3,1,0,1,0,1
13830,71,62,40270,1,0,0,0,0,-1
13831,71,79,33908,6,1,0,1,4,1
13832,74,79,33908,8,1,1,0,2,0
13833,77,79,33908,79,16,0,16,14,11
13834,80,79,33908,70,15,1,14,14,0
13835,83,79,33908,80,18,5,13,30,-5
13836,86,79,33908,76,23,3,20,20,31
13837,68,81,11842,25,9,5,4,4,-2
13838,71,81,11842,50,13,3,10,21,-9
13840,77,65,11842,30,8,6,2,6,4
13841,80,65,11842,82,44,22,22,58,14
13842,83,65,11842,37,16,6,10,26,3
13843,83,87,11842,35,19,8,11,12,4
13844,86,87,11842,75,33,14,19,44,-3
13845,8,81,39897,4,2,0,2,2,-2
13846,2,84,29259,64,49,18,31,46,-28
13847,2,78,29259,14,11,4,7,20,-5
13848,5,77,29259,67,37,11,26,26,-13
13850,11,80,29259,13,7,7,0,6,0
13851,14,88,29259,44,31,14,17,32,-3
13852,17,80,29259,28,24,6,18,24,-8
13853,17,77,29259,35,21,7,14,22,2
13854,20,79,29259,16,3,0,3,10,-6
13732,20,80,2655,76,21,3,18,76,-14
13733,23,80,2655,60,21,4,17,64,-15
13859,77,62,31272,2,1,0,1,2,0
13860,80,84,31272,14,2,0,2,4,-3
13861,62,65,17501,9,3,2,1,9,2
13862,65,65,17501,3,0,0,0,0,-1
13863,68,65,17501,3,2,1,1,0,1
13864,71,65,17501,24,11,5,6,32,5
13865,74,65,17501,15,0,0,0,15,0
13866,74,82,17501,28,6,2,4,13,1
13867,80,84,7080,3,1,0,1,0,1
13868,41,1479,52997,39,3,1,2,184,0
13869,2,83,39567,80,35,10,25,173,2
13871,8,81,39567,66,17,5,12,138,-21
13872,8,75,39567,8,1,0,1,8,-3
13873,11,75,39567,6,1,0,1,2,-1
13874,11,77,39567,15,1,0,1,14,-11
13875,65,73,8371,2,0,0,0,0,-1
13877,71,73,8371,62,9,1,8,10,-8
13878,74,73,8371,80,18,7,11,52,12
13879,77,73,8371,82,35,8,27,44,14
13880,80,73,8371,82,23,3,20,34,4
13881,83,73,8371,81,34,10,24,46,25
13882,86,73,8371,80,44,8,36,47,27
13883,65,67,18598,14,13,6,7,9,6
13884,68,67,18598,47,18,5,13,41,-4
13885,71,67,18598,74,19,7,12,82,-17
13886,74,67,18598,57,20,8,12,50,-5
13887,77,67,18598,75,23,10,13,79,4
13888,80,67,18598,80,23,13,10,73,-1
13889,83,69,18598,77,23,8,15,72,2
13890,86,69,18598,82,19,7,12,55,-1
13891,2,67,22716,71,20,6,14,46,14
13892,5,67,22716,66,17,3,14,67,8
13894,8,79,22716,12,3,1,2,8,13
13895,11,79,22716,65,4,2,2,22,-4
13896,14,85,22716,33,3,1,2,23,11
13897,17,85,22716,47,6,2,4,35,17
13898,20,85,22716,2,0,0,0,0,0
13899,68,1479,16047,8,2,2,0,0,3
13900,71,1479,16047,48,21,6,15,22,9
13901,74,1479,16047,67,37,12,25,36,5
13902,77,1479,16047,71,38,9,29,20,8
13909,32,65,8911,36,5,2,3,12,3
13910,35,65,8911,56,8,1,7,30,6
13911,38,65,8911,75,13,2,11,50,14
13912,41,65,8911,53,4,2,2,26,-16
13913,47,79,8911,21,4,0,4,10,-5
13914,47,78,8911,41,1,0,1,37,-21
13916,74,87,23103,9,1,1,0,2,-2
13917,83,63,23103,12,3,0,3,2,-4
13918,65,73,27054,72,36,14,22,30,-9
13919,68,73,27054,44,12,4,8,20,-11
13920,71,73,27054,79,52,24,28,22,16
13921,74,73,27054,82,44,23,21,44,11
13922,77,73,27054,82,37,21,16,40,4
13923,80,73,27054,78,29,12,17,30,7
13924,83,73,27054,79,51,25,26,24,20
13925,86,73,27054,76,38,21,17,20,11
13926,2,78,64593,32,6,3,3,52,4
13929,8,81,64593,2,0,0,0,2,0
13930,11,80,64593,29,0,0,0,52,-13
13931,77,80,38091,64,13,6,7,34,4
13932,80,80,38091,76,17,5,12,46,7
13933,83,80,38091,16,8,3,5,6,5
13934,86,80,38091,19,5,2,3,12,-9
13935,86,71,38091,5,2,0,2,4,-2
13936,86,68,38091,1,0,0,0,2,-1
13937,2,62,31368,39,30,14,16,4,20
13938,5,62,31368,80,43,23,20,32,16
13939,8,62,31368,83,43,21,22,26,-4
13940,11,62,31368,67,24,10,14,20,-7
13945,23,66,31368,73,14,5,9,28,-11
13946,26,66,31368,78,19,9,10,39,4
13947,29,66,31368,79,22,9,13,6,-14
13948,32,77,31368,80,17,10,7,14,2
13949,35,77,31368,79,9,5,4,36,5
13950,38,77,31368,28,4,0,4,6,-4
13952,71,88,28435,18,5,0,5,0,0
13953,74,84,28435,75,24,10,14,18,-3
13954,77,84,28435,41,15,4,11,6,-14
13955,80,62,28435,4,0,0,0,0,-2
13956,65,76,14955,15,4,0,4,6,1
13957,68,76,14955,45,15,6,9,14,0
13958,71,76,14955,80,16,6,10,30,-12
13959,74,76,14955,70,18,9,9,24,-2
13960,77,76,14955,80,29,8,21,31,4
13961,80,76,14955,59,25,8,17,30,9
13962,83,76,14955,64,17,7,10,23,-12
13963,86,76,14955,73,33,20,13,36,22
13964,2,85,32141,62,47,7,40,33,1
13965,5,85,32141,61,24,2,22,94,-6
13966,8,85,32141,80,40,9,31,80,10
13967,11,77,32141,67,52,9,43,48,-11
13968,14,75,32141,47,11,4,7,42,-1
13969,17,75,32141,25,3,0,3,26,-7
13970,17,86,32141,32,17,1,16,28,-3
13971,20,62,32141,46,16,1,15,24,4
13972,23,81,32141,60,8,0,8,41,-23
13973,71,67,37451,17,1,1,0,18,-10
13974,74,67,37451,82,15,5,10,71,-24
13975,77,67,37451,70,12,6,6,59,-14
13976,80,67,37451,42,2,0,2,38,-6
13977,83,75,37451,58,14,10,4,55,7
13978,86,75,37451,48,5,2,3,22,-12
13979,65,89,23165,30,8,4,4,4,2
13980,68,70,23165,48,24,7,17,31,1
13981,71,70,23165,81,35,16,19,36,-9
13982,74,70,23165,78,40,19,21,26,-1
13983,77,70,23165,82,35,16,19,42,3
13856,68,68,31272,43,13,3,10,14,-10
13857,71,68,31272,24,7,5,2,8,-1
13988,68,82,32892,4,0,0,0,0,-3
13989,71,82,32892,70,15,5,10,28,2
13990,74,82,32892,82,36,11,25,71,0
13991,77,82,32892,65,25,4,21,45,-7
13992,80,82,32892,74,23,6,17,44,33
13993,83,82,32892,81,16,4,12,32,2
13994,86,82,32892,82,24,8,16,36,19
13995,74,74,17492,1,0,0,0,0,-1
13996,80,86,10067,1,0,0,0,0,0
13997,83,86,10067,29,11,3,8,8,0
13998,86,86,10067,37,13,2,11,10,9
13999,35,89,69528,16,1,0,1,14,-2
14000,41,82,69528,24,2,0,2,8,-12
14001,41,89,69528,35,3,0,3,18,-5
14002,71,89,14427,17,4,1,3,12,0
14003,74,89,14427,53,6,0,6,68,4
14005,62,72,7041,8,1,1,0,0,-2
14006,65,72,7041,5,1,1,0,9,1
14007,68,72,7041,1,0,0,0,0,-1
14008,71,89,7041,20,2,1,1,19,1
14015,50,70,3664,41,11,5,6,10,5
14016,74,85,19352,13,2,0,2,4,-3
14017,74,66,19352,41,18,7,11,4,2
14018,77,66,19352,55,23,9,14,8,4
14019,80,66,19352,19,5,1,4,2,-3
14020,71,70,38048,36,8,1,7,16,-6
14021,74,70,38048,8,2,0,2,6,4
14022,74,82,38048,54,19,9,10,29,1
14023,77,82,38048,27,8,1,7,21,10
14024,77,87,38048,38,9,4,5,39,-3
14025,80,87,38048,24,1,0,1,24,-1
14026,83,87,38048,73,21,11,10,20,3
14028,71,68,23805,3,0,0,0,0,-1
14029,74,68,23805,2,0,0,0,0,-2
14030,77,68,23805,29,0,0,0,24,-3
14031,86,79,23805,50,8,2,6,18,2
14032,2,67,42530,66,16,8,8,350,-11
14033,5,67,42530,63,8,5,3,354,-9
14034,8,67,42530,68,5,3,2,211,-3
14035,11,67,42530,82,7,3,4,274,2
14036,14,67,42530,47,3,0,3,173,-4
14037,17,67,42530,71,9,3,6,287,-8
14038,20,67,42530,82,10,7,3,286,3
14039,23,67,42530,63,6,2,4,234,2
14040,26,67,42530,76,4,0,4,261,-2
14041,29,67,42530,69,4,1,3,158,0
14042,32,67,42530,63,10,4,6,210,2
14043,35,67,42530,71,5,2,3,200,-3
14045,38,80,42530,5,0,0,0,4,0
14046,41,80,42530,6,1,1,0,14,0
14047,65,75,36748,3,0,0,0,0,-1
14048,68,75,36748,10,3,1,2,13,1
14049,71,75,36748,2,0,0,0,0,0
14050,74,75,36748,3,0,0,0,0,-1
14051,80,81,36748,39,4,2,2,29,1
14052,83,81,36748,7,0,0,0,4,0
14053,83,80,36748,23,2,1,1,2,1
14054,71,62,38075,7,1,1,0,0,-1
14055,74,62,38075,2,0,0,0,0,0
14056,77,68,38075,20,7,2,5,4,3
14057,86,77,38075,23,4,1,3,0,-5
14058,8,81,76452,15,5,0,5,34,1
14059,11,81,76452,27,4,0,4,77,1
14060,14,81,76452,1,0,0,0,0,2
14062,20,86,76452,8,0,0,0,22,-2
14063,80,78,38064,3,1,1,0,0,1
14064,83,78,38064,1,0,0,0,0,0
14065,86,85,38064,11,1,0,1,2,-4
14066,65,62,53887,61,11,3,8,14,3
14067,68,62,53887,20,7,2,5,2,-5
14068,71,62,53887,1,0,0,0,0,0
14069,71,71,53887,2,1,1,0,0,-1
14070,62,70,12559,24,2,1,1,4,-5
14071,65,70,12559,47,10,4,6,2,-2
14072,68,70,12559,15,3,2,1,2,0
14073,68,64,12559,2,1,0,1,2,-1
14074,74,64,12559,7,1,0,1,2,-1
14075,5,65,68091,2,0,0,0,2,1
14076,17,67,68091,28,7,2,5,18,-9
14077,65,73,28437,43,19,7,12,6,-2
14079,71,73,28437,74,26,9,17,8,-5
14080,74,73,28437,69,13,3,10,10,-13
14081,77,73,28437,22,4,1,3,18,0
14082,80,64,28437,6,0,0,0,0,0
14083,83,64,28437,58,11,5,6,12,-6
14084,86,64,28437,55,8,2,6,10,3
14085,59,76,17569,1,0,0,0,0,0
14086,14,1479,67160,13,4,1,3,4,3
14087,17,1479,67160,33,8,0,8,55,-2
14088,20,80,67160,80,20,4,16,217,-4
14089,23,80,67160,72,19,9,10,250,4
14090,26,73,67160,76,16,5,11,218,-3
14093,35,1479,67160,73,7,2,5,213,1
14094,74,72,33907,22,2,0,2,18,4
14095,77,72,33907,19,1,0,1,17,-5
14096,80,72,33907,9,1,1,0,15,2
14098,77,83,31098,56,5,2,3,16,-11
14099,80,83,31098,2,0,0,0,5,0
14100,80,81,31098,4,0,0,0,0,-3
14101,83,75,31098,48,11,3,8,26,0
14102,71,547,33893,1,0,0,0,0,-3
14103,74,547,33893,40,8,2,6,22,5
14104,77,547,33893,70,10,1,9,43,-9
14105,80,547,33893,59,12,2,10,33,2
14106,83,547,33893,57,14,2,12,32,15
14107,86,547,33893,78,20,5,15,62,6
14108,65,63,23003,5,0,0,0,5,-2
14109,68,63,23003,3,0,0,0,10,0
14110,68,70,23003,6,2,2,0,9,1
14111,71,70,23003,6,2,0,2,5,2
13985,83,20120,23165,80,27,11,16,22,-6
13986,86,20120,23165,78,41,22,19,16,19
14116,80,69,16032,72,26,15,11,28,5
14117,83,20120,16032,76,55,29,26,37,-16
14118,86,20120,16032,15,7,2,5,10,1
14119,26,68,5366,22,8,3,5,6,0
14120,29,68,5366,13,3,0,3,4,-2
14121,32,68,5366,69,22,4,18,28,-14
14122,35,68,5366,25,6,3,3,12,-1
14123,35,81,5366,41,20,5,15,27,-15
14124,38,81,5366,77,53,13,40,44,9
14125,41,81,5366,78,39,9,30,60,23
14126,47,81,5366,79,53,15,38,38,-8
14127,50,81,5366,82,63,20,43,62,-5
14128,53,81,5366,37,25,4,21,57,-29
14129,56,86,5366,77,57,16,41,52,6
14130,59,86,5366,76,58,15,43,70,6
14131,62,86,5366,76,50,9,41,67,2
14133,68,86,5366,46,20,7,13,27,3
14134,71,86,5366,75,36,12,24,32,-8
14135,74,74,5366,65,20,9,11,20,18
14136,77,74,5366,74,24,10,14,30,0
14137,32,66,39274,1,0,0,0,0,0
14138,80,89,21019,1,0,0,0,0,0
14139,77,63,31592,27,6,6,0,47,-2
14140,8,63,22168,73,72,30,42,16,9
14141,11,63,22168,39,19,12,7,10,-9
14142,74,66,17287,6,0,0,0,4,-5
14143,74,83,23151,20,4,2,2,6,-3
14144,71,85,36719,1,0,0,0,0,0
14145,80,85,36719,4,0,0,0,0,0
14146,2,79,8867,78,113,40,73,48,0
14147,5,79,8867,58,70,33,37,78,-16
14148,5,77,8867,22,27,10,17,18,-5
14150,11,77,8867,84,107,40,67,46,-2
14151,14,77,8867,10,5,2,3,12,-6
14152,14,75,8867,39,43,14,29,16,-3
14153,17,75,8867,82,78,28,50,69,20
14154,20,75,8867,82,80,34,46,58,-1
14155,23,75,8867,82,74,32,42,51,11
14156,26,75,8867,61,47,12,35,28,-4
14157,26,77,8867,10,6,4,2,6,-3
14158,29,77,8867,82,91,28,63,50,20
14159,32,77,8867,69,77,27,50,33,15
14160,35,77,8867,80,64,22,42,46,5
14161,38,77,8867,79,52,20,32,35,0
14162,41,77,8867,82,75,26,49,47,18
14163,47,79,8867,63,57,24,33,56,-28
14164,47,66,8867,20,7,4,3,12,-8
14165,50,79,8867,82,68,24,44,62,1
14168,56,81,8867,62,45,13,32,20,-15
14169,56,63,8867,18,16,10,6,2,-3
14170,59,63,8867,81,43,18,25,34,4
14171,62,63,8867,81,48,14,34,35,13
14172,62,68,18614,19,1,1,0,8,-8
14173,68,68,18614,5,0,0,0,4,-2
14176,17,1479,67319,8,0,0,0,4,-2
14177,71,83,31304,22,3,1,2,0,-1
14178,74,67,31304,9,0,0,0,2,-4
14179,74,70,19275,36,5,4,1,48,-8
14180,77,70,19275,3,0,0,0,0,-1
14181,80,70,19275,53,16,6,10,72,5
14182,83,70,19275,7,2,0,2,11,3
14183,11,81,43340,5,0,0,0,6,-3
14184,14,81,43340,43,6,1,5,41,-6
14185,17,81,43340,75,16,2,14,66,4
14187,23,81,43340,74,9,3,6,77,-24
14188,26,81,43340,67,18,2,16,92,-25
14189,29,83,43340,71,15,4,11,64,13
14190,32,83,43340,41,8,3,5,50,7
14191,35,83,43340,50,12,3,9,54,11
14192,38,74,43340,26,4,0,4,16,13
14193,38,71,43340,11,5,2,3,8,3
14194,41,71,43340,68,21,7,14,56,9
14195,47,71,43340,34,5,2,3,38,-5
14196,47,79,43340,6,1,0,1,6,-1
14197,47,85,43340,16,2,1,1,15,3
14198,68,76,19067,2,2,1,1,0,-3
14199,71,76,19067,22,14,9,5,14,3
14200,74,76,19067,76,41,25,16,33,9
14201,77,76,19067,80,36,15,21,51,-2
14202,80,76,19067,81,52,34,18,56,9
14204,86,76,19067,82,51,28,23,58,20
14205,2,76,69470,66,19,3,16,96,17
14206,5,76,69470,54,16,4,12,85,15
14207,8,81,69470,42,13,2,11,69,2
14208,11,81,69470,73,12,1,11,127,8
14209,11,89,69470,12,5,0,5,29,7
14210,14,89,69470,48,7,1,6,97,10
14211,17,89,69470,78,10,3,7,149,7
14212,20,89,69470,65,9,1,8,107,8
14213,23,89,69470,68,10,2,8,70,15
14214,26,89,69470,73,10,0,10,68,11
14215,29,89,69470,59,7,0,7,50,21
14216,32,89,69470,74,11,2,9,77,14
14217,35,89,69470,38,6,2,4,41,-7
14218,35,65,69470,17,2,0,2,28,2
14219,71,67,15482,9,2,1,1,4,-3
14221,77,67,15482,5,2,1,1,2,1
14222,77,80,15482,1,1,0,1,0,1
14223,80,80,15482,7,0,0,0,2,-3
14224,86,77,15482,47,7,3,4,8,-2
14225,8,81,8603,67,21,6,15,71,-21
14226,11,81,8603,64,21,3,18,135,-14
14227,14,81,8603,48,23,12,11,86,-18
14228,17,81,8603,82,65,16,49,103,-24
14229,20,81,8603,79,40,12,28,57,-29
14230,23,81,8603,37,15,3,12,22,-18
14231,23,71,8603,41,26,6,20,48,3
14232,26,71,8603,75,32,8,24,70,9
14233,29,71,8603,80,45,8,37,68,1
14234,32,76,8603,76,46,16,30,92,-20
14113,71,69,16032,46,15,6,9,29,14
14114,74,69,16032,72,14,7,7,32,-7
14239,50,62,8603,75,38,7,31,88,22
14240,53,75,8603,77,26,5,21,38,7
14241,56,75,8603,81,33,6,27,62,4
14242,59,75,8603,75,26,6,20,56,-2
14243,62,75,8603,79,34,5,29,81,6
14244,65,89,8603,68,13,2,11,34,11
14245,68,89,8603,4,1,0,1,2,-1
14246,68,74,8603,12,0,0,0,6,-3
14247,11,80,8692,83,79,30,49,22,-49
14248,14,80,8692,47,44,21,23,20,-20
14249,17,80,8692,46,39,15,24,28,-15
14250,20,80,8692,82,75,35,40,44,-7
14251,23,80,8692,82,72,33,39,24,6
14252,26,80,8692,82,94,44,50,54,16
14253,32,80,8692,82,88,40,48,30,10
14254,35,76,8692,78,75,32,43,25,-3
14256,41,76,8692,47,34,15,19,10,-1
14257,47,76,8692,82,66,28,38,68,-14
14258,50,76,8692,58,50,18,32,44,6
14259,11,86,8842,47,10,1,9,59,-9
14260,14,86,8842,42,9,2,7,29,-1
14261,17,86,8842,27,7,0,7,14,-16
14262,20,86,8842,31,8,0,8,21,-1
14263,23,86,8842,81,15,3,12,59,-4
14264,26,86,8842,82,14,5,9,36,15
14265,29,86,8842,66,16,2,14,31,-2
14266,32,86,8842,81,11,0,11,48,7
14267,35,86,8842,52,17,5,12,48,23
14268,38,86,8842,82,29,7,22,48,-19
14269,41,86,8842,80,19,2,17,46,18
14270,47,77,8842,79,24,3,21,46,22
14271,50,77,8842,18,1,0,1,6,-7
14273,17,83,3721,57,15,7,8,26,-11
14274,20,83,3721,75,33,12,21,41,-3
14275,23,83,3721,45,13,5,8,20,5
14276,26,83,3721,53,19,9,10,28,-6
14277,29,83,3721,18,4,3,1,2,6
14278,29,81,3721,55,24,11,13,34,-14
14279,32,81,3721,64,21,10,11,46,-13
14281,35,84,3721,14,6,2,4,12,4
14282,38,84,3721,30,10,4,6,22,0
14283,38,77,3721,13,5,2,3,6,2
14284,38,73,3721,6,1,0,1,4,-1
14285,8,76,8683,79,21,4,17,166,15
14286,11,76,8683,76,11,1,10,142,-6
14287,14,76,8683,13,1,0,1,22,-11
14288,17,76,8683,46,8,1,7,93,-12
14289,20,76,8683,18,5,0,5,16,-7
14291,23,79,8683,81,12,4,8,127,3
14292,26,79,8683,48,5,1,4,70,12
14293,29,79,8683,73,15,3,12,146,-12
14294,32,79,8683,77,19,3,16,111,11
14295,35,79,8683,69,14,2,12,123,-1
14296,35,64,8683,11,0,0,0,19,1
14297,38,74,8683,80,14,3,11,85,5
14298,41,74,8683,44,10,1,9,48,11
14299,47,74,8683,67,6,0,6,97,7
14300,50,74,8683,24,4,2,2,30,-1
14301,65,88,23801,26,4,2,2,28,2
14302,68,88,23801,44,6,2,4,46,-5
14303,71,88,23801,64,10,6,4,54,-1
14304,74,88,23801,60,9,6,3,54,-6
14305,77,88,23801,52,5,0,5,38,0
14306,80,88,23801,46,8,4,4,44,-3
14308,86,78,23801,14,2,0,2,14,2
14309,14,62,8890,10,2,0,2,2,1
14310,17,62,8890,74,35,16,19,41,-5
14311,20,62,8890,58,26,6,20,14,-6
14312,23,62,8890,72,49,27,22,40,-9
14313,26,62,8890,76,57,27,30,38,7
14314,29,62,8890,37,21,12,9,12,-9
14315,32,62,8890,66,45,21,24,45,-6
14316,32,78,8890,12,7,3,4,6,-2
14317,35,78,8890,80,45,23,22,36,8
14318,38,78,8890,79,67,24,43,56,12
14319,41,81,8890,81,80,25,55,36,18
14320,47,66,8890,72,76,21,55,32,-9
14321,50,66,8890,43,27,5,22,24,-8
14322,53,66,8890,55,46,21,25,14,-7
14323,53,80,8890,24,19,3,16,10,-8
14325,59,68,8890,58,37,15,22,22,-3
14326,62,68,8890,44,23,7,16,20,3
14327,62,66,8890,21,16,5,11,4,2
14328,83,80,33913,2,0,0,0,0,-1
14332,17,70,1915,5,2,1,1,0,1
14333,20,78,1915,44,19,7,12,10,2
14334,26,81,1915,28,7,3,4,6,-8
14335,29,81,1915,43,17,7,10,14,2
14336,32,76,1915,11,0,0,0,4,-1
14337,11,86,32130,1,0,0,0,0,0
14338,14,86,32130,26,8,3,5,94,-1
14339,17,86,32130,42,14,7,7,62,-15
14340,20,86,32130,60,27,12,15,222,-4
14341,23,86,32130,40,2,1,1,112,-4
14342,23,81,32130,14,2,1,1,58,-9
14343,26,81,32130,26,2,2,0,43,-5
14345,29,62,32130,76,32,10,22,78,3
14346,32,1479,32130,16,1,1,0,29,-9
14347,32,63,32130,63,5,1,4,200,-14
14348,35,63,32130,47,2,0,2,164,-2
14352,47,69,32130,2,0,0,0,6,-1
14353,17,83,264,11,7,5,2,4,-7
14354,20,83,264,39,10,2,8,20,-9
14355,23,84,264,7,2,0,2,0,0
14356,26,84,264,12,9,2,7,8,5
14357,26,88,264,3,0,0,0,4,-1
14358,20,83,18150,19,6,3,3,16,-3
14359,23,83,18150,9,4,0,4,8,2
14360,32,83,18150,2,0,0,0,0,-1
14361,20,71,39295,6,0,0,0,0,-1
14236,38,76,8603,73,41,9,32,87,21
14237,41,76,8603,81,29,7,22,68,2
14366,14,89,8673,31,7,2,5,22,4
14367,17,89,8673,78,41,15,26,60,25
14368,20,89,8673,57,30,13,17,36,-11
14369,23,89,8673,72,21,5,16,66,2
14370,26,89,8673,53,31,21,10,57,1
14371,29,89,8673,73,54,18,36,52,26
14372,32,89,8673,76,57,19,38,70,12
14373,35,89,8673,76,59,26,33,58,-1
14374,38,89,8673,82,67,18,49,52,13
14375,41,89,8673,56,49,7,42,44,-20
14376,41,63,8673,15,9,4,5,12,6
14377,47,79,8673,75,58,12,46,100,-13
14378,50,79,8673,82,67,13,54,72,-5
14379,53,79,8673,78,65,12,53,66,13
14380,56,79,8673,25,19,6,13,26,6
14381,59,79,8673,62,50,11,39,49,-4
14383,65,80,8673,74,37,5,32,55,-4
14384,68,80,8673,45,27,3,24,26,4
14385,71,70,8673,76,22,2,20,20,-12
14386,74,70,8673,3,1,0,1,2,-1
14387,74,75,8673,45,13,1,12,16,7
14388,8,77,54653,7,1,1,0,2,1
14389,11,77,54653,56,6,1,5,87,12
14390,14,77,54653,4,0,0,0,0,-2
14391,17,77,54653,2,0,0,0,2,0
14392,20,77,54653,4,1,0,1,8,1
14393,23,71,54653,4,0,0,0,10,0
14394,8,65,18721,4,0,0,0,2,-2
14395,11,65,18721,9,1,1,0,4,-2
14396,14,65,18721,41,19,12,7,33,9
14397,17,65,18721,46,16,6,10,32,10
14398,20,65,18721,67,24,13,11,42,-1
14400,26,73,18721,70,48,25,23,42,-5
14401,29,73,18721,63,26,9,17,40,-7
14402,29,62,18721,12,11,1,10,4,2
14403,32,69,18721,54,22,7,15,20,-1
14404,35,69,18721,9,2,1,1,17,-1
14405,35,1479,18721,17,3,1,2,19,-1
14406,11,72,8878,41,5,0,5,43,7
14407,14,72,8878,2,0,0,0,0,-3
14408,17,72,8878,64,3,2,1,86,5
14409,20,72,8878,57,3,1,2,38,-8
14410,20,83,8878,21,5,0,5,16,-4
14411,23,83,8878,81,16,3,13,100,-5
14412,26,83,8878,60,13,2,11,40,-9
14413,26,71,8878,12,2,1,1,11,0
14414,29,71,8878,80,14,3,11,60,16
14415,32,71,8878,82,20,5,15,120,14
14417,38,71,8878,68,12,4,8,64,5
14418,41,71,8878,68,19,7,12,98,13
14419,47,71,8878,76,17,4,13,84,1
14420,50,71,8878,82,11,2,9,103,-13
14421,53,77,8878,77,10,1,9,86,-4
14422,56,80,8878,63,1,1,0,47,-3
14423,8,79,8680,42,16,3,13,29,2
14424,11,79,8680,84,64,30,34,24,24
14425,14,79,8680,31,16,4,12,16,0
14426,14,80,8680,6,2,1,1,0,-1
14427,17,80,8680,43,25,9,16,29,-14
14428,17,76,8680,22,12,2,10,6,-6
14429,17,68,8680,12,6,2,4,6,1
14430,20,68,8680,55,29,7,22,12,9
14431,23,79,8680,75,42,19,23,28,-1
14432,26,79,8680,80,83,35,48,26,12
14434,32,79,8680,82,95,27,68,38,19
14435,35,79,8680,13,9,5,4,0,3
14436,38,79,8680,60,46,18,28,12,-18
14437,41,79,8680,22,12,4,8,16,-16
14438,41,88,8680,32,14,6,8,4,-9
14439,47,74,8680,82,76,22,54,42,17
14440,50,74,8680,77,70,29,41,24,16
14441,53,74,8680,65,41,14,27,22,5
14442,14,75,54820,1,0,0,0,0,0
14443,17,75,54820,24,6,1,5,10,-10
14444,20,75,54820,61,15,6,9,63,-9
14445,23,75,54820,5,1,1,0,4,-1
14446,23,81,54820,29,6,1,5,17,-21
14447,26,81,54820,46,8,1,7,69,-19
14448,32,74,54820,1,0,0,0,2,-2
14451,11,85,1860,1,0,0,0,0,1
14453,68,77,6658,15,3,2,1,34,0
14454,74,77,6658,1,0,0,0,10,-1
14455,14,70,8961,2,1,0,1,0,1
14456,17,70,8961,70,28,9,19,111,0
14457,20,70,8961,56,10,6,4,98,5
14458,23,70,8961,72,19,9,10,96,-2
14459,26,70,8961,82,31,13,18,85,1
14460,29,70,8961,45,8,2,6,38,-5
14461,32,70,8961,75,37,13,24,64,1
14462,35,82,8961,81,33,15,18,86,-20
14463,38,82,8961,66,28,8,20,71,-8
14464,38,72,8961,10,4,1,3,7,-3
14465,41,72,8961,65,15,8,7,67,-9
14466,47,72,8961,76,25,8,17,70,-18
14467,2,62,10850,66,41,19,22,22,17
14468,5,62,10850,77,54,20,34,32,1
14470,11,62,10850,84,93,40,53,58,20
14471,14,62,10850,48,35,18,17,28,-2
14472,20,62,10850,70,43,16,27,22,-2
14473,20,76,10850,12,19,5,14,4,7
14474,23,76,10850,82,65,25,40,32,-11
14475,26,76,10850,70,56,19,37,50,-15
14477,35,83,10850,78,51,20,31,26,7
14478,38,83,10850,81,42,12,30,26,7
14479,41,83,10850,69,30,11,19,30,2
14480,17,74,4392,5,1,0,1,0,-5
14481,20,74,4392,2,0,0,0,0,0
14482,23,79,4392,29,7,3,4,12,-2
14483,23,74,4392,1,0,0,0,2,-2
14484,26,63,4392,46,14,6,8,44,10
14363,26,71,39295,1,0,0,0,2,1
14364,29,63,39295,24,4,2,2,8,-8
14489,20,71,3726,1,1,0,1,0,-2
14490,23,71,3726,34,2,0,2,42,-7
14491,23,1479,3726,27,6,0,6,47,-2
14492,26,81,3726,21,3,1,2,24,-4
14493,32,74,3726,3,0,0,0,0,-1
14494,35,1479,3726,1,0,0,0,0,0
14496,11,71,21559,14,2,0,2,14,-4
14497,14,71,21559,29,8,1,7,40,-9
14498,17,71,21559,78,32,8,24,101,-23
14499,20,71,21559,55,32,6,26,85,2
14500,23,71,21559,81,46,16,30,100,-8
14501,26,71,21559,63,40,11,29,104,6
14502,26,65,21559,12,9,0,9,27,7
14503,29,65,21559,58,37,9,28,72,-3
14504,32,65,21559,66,22,5,17,42,-14
14505,35,65,21559,64,18,4,14,68,15
14507,38,74,21559,36,12,3,9,34,3
14508,41,74,21559,75,16,3,13,86,1
14509,11,80,74520,3,0,0,0,2,-2
14510,20,65,3312,16,1,0,1,13,-4
14511,23,79,3312,22,3,1,2,25,3
14512,2,83,20984,69,28,15,13,18,-10
14513,5,63,20984,43,14,7,7,27,5
14514,8,63,20984,65,36,20,16,10,12
14515,11,63,20984,83,23,6,17,25,10
14516,14,63,20984,38,10,5,5,10,8
14517,17,63,20984,63,44,23,21,4,14
14518,20,70,20984,82,39,19,20,10,12
14519,23,70,20984,65,18,6,12,14,-15
14520,26,70,20984,73,17,6,11,16,0
14521,29,64,20984,65,18,11,7,28,12
14522,32,64,20984,73,10,1,9,21,1
14524,20,81,729659,6,0,0,0,0,-4
14525,23,81,729659,11,2,0,2,27,0
14526,32,68,729659,1,0,0,0,0,0
14527,14,75,9674,24,4,3,1,6,-1
14528,17,75,9674,77,42,22,20,28,10
14529,20,75,9674,64,35,14,21,6,4
14530,23,75,9674,50,29,7,22,33,-5
14531,23,62,9674,16,9,5,4,2,0
14532,26,62,9674,80,53,26,27,22,0
14533,29,62,9674,82,75,35,40,50,-7
14534,32,62,9674,78,55,27,28,26,-21
14535,35,68,9674,31,18,8,10,12,-3
14536,38,68,9674,46,26,5,21,10,-11
14537,38,78,9674,5,2,0,2,0,-2
14538,41,68,9674,55,45,20,25,20,0
14539,41,70,9674,13,7,2,5,6,3
14541,23,62,27965,12,2,0,2,10,4
14542,26,62,27965,10,1,0,1,2,-1
14543,29,84,27965,11,5,0,5,2,2
14544,38,1479,27965,2,1,0,1,0,0
14545,11,71,25642,1,0,0,0,0,-1
14546,11,65,12797,52,16,3,13,30,-14
14547,14,65,12797,45,18,6,12,33,11
14548,17,65,12797,78,20,6,14,24,12
14549,20,65,12797,69,30,9,21,28,11
14550,23,65,12797,61,31,11,20,36,0
14551,26,65,12797,7,1,1,0,4,-1
14552,26,62,12797,69,29,12,17,40,15
14553,29,62,12797,74,31,13,18,30,-13
14554,32,62,12797,73,20,5,15,58,-7
14555,35,62,12797,40,6,3,3,23,-3
14556,38,64,12797,74,9,3,6,35,-12
14558,14,70,1559,5,2,1,1,0,1
14559,8,78,18261,74,27,4,23,20,-1
14560,11,78,18261,73,16,6,10,40,-12
14564,23,83,18261,78,39,17,22,22,-18
14565,26,83,18261,66,47,13,34,46,11
14566,29,83,18261,80,46,20,26,22,12
14567,32,83,18261,73,29,10,19,28,3
14568,35,65,18261,82,29,9,20,20,-5
14569,38,65,18261,48,9,4,5,30,-1
14570,41,65,18261,62,13,3,10,22,-15
14571,11,88,73316,1,0,0,0,0,0
14572,11,84,8909,4,0,0,0,2,-1
14573,14,84,8909,33,12,6,6,30,-6
14574,17,67,8909,68,31,11,20,67,-1
14575,20,67,8909,79,49,20,29,80,26
14576,23,67,8909,61,40,18,22,57,12
14578,29,67,8909,73,41,20,21,67,6
14579,35,76,8909,80,60,25,35,62,19
14580,38,76,8909,66,42,13,29,43,-4
14581,41,76,8909,76,40,11,29,71,17
14582,47,71,8909,71,23,9,14,56,-4
14583,50,83,8909,35,15,4,11,60,2
14584,53,82,8909,65,34,8,26,64,-1
14585,56,82,8909,71,22,4,18,58,-6
14586,14,72,8693,26,14,6,8,8,12
14587,17,72,8693,50,9,4,5,26,-2
14588,20,72,8693,29,4,2,2,20,-13
14589,23,72,8693,18,5,2,3,0,4
14590,26,72,8693,47,15,5,10,28,8
14591,29,72,8693,64,20,9,11,20,0
14592,32,72,8693,75,52,23,29,24,25
14593,35,72,8693,76,44,16,28,10,21
14595,41,72,8693,82,33,14,19,20,10
14596,47,72,8693,82,37,15,22,46,-4
14597,50,72,8693,82,40,16,24,35,-5
14598,53,72,8693,82,16,6,10,20,-5
14599,20,65,35389,1,0,0,0,2,0
14600,11,85,8969,67,26,9,17,181,12
14601,14,85,8969,31,13,5,8,88,5
14602,17,85,8969,63,29,15,14,158,14
14603,20,85,8969,68,49,19,30,126,14
14604,23,85,8969,71,37,15,22,157,0
14605,26,85,8969,69,40,14,26,108,10
14606,29,85,8969,24,12,6,6,48,1
14607,32,85,8969,72,22,12,10,123,-5
14608,35,85,8969,62,12,5,7,98,2
14486,35,89,4392,4,1,0,1,0,-1
14487,17,81,3726,13,1,0,1,4,-1
14613,53,85,8969,3,1,0,1,2,2
14614,56,85,8969,13,1,1,0,25,-2
14618,20,89,19682,59,21,7,14,30,5
14619,23,89,19682,38,16,6,10,14,1
14620,26,89,19682,73,35,8,27,28,0
14621,29,89,19682,76,25,11,14,28,6
14622,32,89,19682,81,38,13,25,34,9
14623,35,89,19682,80,36,13,23,40,-1
14624,38,65,19682,60,21,6,15,26,-3
14625,41,64,19682,49,12,5,7,24,3
14626,11,74,118228,9,2,0,2,6,0
14627,14,74,118228,9,3,0,3,2,2
14628,17,74,118228,25,3,2,1,22,5
14629,17,88,118228,11,1,0,1,18,-8
14630,20,88,118228,80,22,1,21,84,-4
14631,23,88,118228,73,13,1,12,90,14
14633,29,88,118228,82,14,1,13,66,22
14634,32,88,118228,82,18,0,18,60,10
14635,35,88,118228,79,11,2,9,38,-2
14636,38,88,118228,82,6,0,6,49,0
14637,41,88,118228,74,14,1,13,44,-3
14638,47,88,118228,77,27,4,23,58,-3
14639,50,88,118228,62,9,2,7,40,-20
14640,50,70,118228,14,2,0,2,8,2
14641,53,70,118228,66,13,2,11,40,3
14642,11,81,14415,10,3,1,2,2,0
14643,14,81,14415,3,1,0,1,0,-2
14644,17,80,10632,5,0,0,0,2,-1
14645,26,80,10632,46,10,1,9,22,12
14646,29,80,10632,66,23,6,17,21,17
14647,32,1479,10632,15,1,1,0,6,-6
14648,32,63,10632,37,8,2,6,14,4
14650,35,75,10632,25,5,2,3,14,-7
14651,38,75,10632,65,13,0,13,24,-9
14652,47,70,10632,1,0,0,0,0,0
14653,62,75,6624,3,0,0,0,0,0
14654,65,75,6624,12,0,0,0,4,-1
14655,38,62,214,46,9,4,5,12,-15
14656,38,79,214,12,6,1,5,4,1
14657,8,63,42956,1,1,0,1,0,1
14658,11,63,42956,24,3,2,1,2,-7
14659,20,80,42956,57,28,12,16,19,2
14660,23,80,42956,78,23,10,13,16,-7
14661,26,75,42956,70,22,7,15,6,-12
14662,29,75,42956,68,38,26,12,28,2
14663,32,75,42956,32,11,1,10,8,-15
14664,32,71,42956,37,20,4,16,22,8
14665,35,69,42956,73,39,19,20,28,-10
14667,41,69,42956,59,29,13,16,19,4
14668,41,73,42956,11,2,1,1,0,-2
14669,17,76,73798,14,1,0,1,11,-1
14670,20,76,73798,1,0,0,0,0,0
14671,17,89,18072,48,17,7,10,14,8
14672,20,89,18072,6,0,0,0,2,-3
14673,17,88,18074,11,5,1,4,4,3
14674,20,88,18074,33,9,4,5,22,3
14675,23,88,18074,21,6,1,5,10,8
14676,26,73,18074,55,11,5,6,28,0
14677,29,73,18074,6,0,0,0,6,1
14678,74,73,37773,7,0,0,0,7,-1
14679,77,73,37773,28,6,1,5,19,0
14680,80,73,37773,29,7,0,7,25,-1
14681,83,73,37773,32,3,1,2,27,-1
14682,86,73,37773,18,3,0,3,8,1
14684,17,1479,12901,3,1,0,1,12,1
14685,20,1479,12901,5,0,0,0,14,-1
14686,23,1479,12901,45,8,3,5,101,-4
14687,29,1479,12901,3,0,0,0,7,-1
14688,32,73,12901,8,1,1,0,39,-1
14689,35,73,12901,4,0,0,0,9,0
14690,38,69,12901,32,11,5,6,69,6
14691,41,69,12901,3,0,0,0,2,-1
14692,41,73,12901,53,9,5,4,103,-2
14693,47,73,12901,35,7,4,3,74,0
14694,47,70,12901,16,1,1,0,21,-3
14695,59,77,7524,36,4,2,2,10,-3
14696,8,78,11856,7,1,0,1,0,-2
14697,11,78,11856,59,21,9,12,51,-3
14698,14,78,11856,26,10,3,7,14,7
14699,8,78,1633,26,5,4,1,15,-4
14701,14,78,1633,2,0,0,0,0,1
14702,11,71,8949,68,19,11,8,74,-2
14703,14,71,8949,47,11,8,3,49,-11
14704,17,71,8949,49,8,2,6,61,-16
14705,17,85,8949,6,1,1,0,6,0
14706,20,85,8949,66,8,3,5,75,3
14707,23,85,8949,65,23,14,9,89,11
14708,26,85,8949,53,14,8,6,34,-6
14709,29,85,8949,41,14,6,8,24,1
14710,32,85,8949,79,19,12,7,22,16
14711,35,85,8949,82,24,9,15,40,15
14712,38,85,8949,82,37,14,23,91,17
14713,41,85,8949,79,33,14,19,80,24
14714,47,85,8949,82,11,5,6,80,-9
14715,50,85,8949,82,11,6,5,50,-9
14716,53,85,8949,61,10,6,4,32,-8
14718,59,85,8949,52,6,4,2,32,1
14719,17,72,9056,8,0,0,0,15,-2
14720,17,62,9056,3,0,0,0,5,3
14721,20,62,9056,63,7,1,6,91,-2
14722,23,62,9056,79,27,5,22,169,1
14723,26,62,9056,73,12,3,9,117,-8
14724,29,62,9056,47,7,1,6,47,-11
14725,32,73,9056,82,8,1,7,128,-5
14726,35,73,9056,63,2,0,2,121,-18
14727,38,73,9056,80,8,2,6,121,-11
14729,47,82,9056,27,3,0,3,43,-9
14730,47,62,9056,12,1,0,1,20,1
14731,2,74,54627,11,2,1,1,4,2
14732,5,71,54627,3,0,0,0,2,-2
14610,41,85,8969,43,11,6,5,50,2
14611,47,62,8969,67,13,7,6,117,-1
14740,17,75,8716,19,5,1,4,54,4
14741,20,75,8716,35,4,0,4,54,7
14742,23,75,8716,61,2,0,2,93,-3
14743,26,75,8716,66,10,2,8,66,-3
14744,29,75,8716,61,17,3,14,76,11
14745,32,75,8716,26,3,1,2,36,-8
14746,35,75,8716,82,25,8,17,76,1
14747,38,75,8716,82,22,7,15,71,1
14748,41,75,8716,80,12,4,8,98,-1
14749,47,75,8716,82,34,7,27,109,-5
14750,50,75,8716,54,16,6,10,57,-7
14751,50,86,8716,17,8,1,7,12,8
14752,53,86,8716,74,35,5,30,104,3
14753,56,67,8716,64,24,2,22,125,4
14754,59,67,8716,78,15,1,14,100,-6
14755,62,67,8716,23,3,1,2,12,-5
14757,26,65,15083,7,0,0,0,0,-1
14758,14,89,42312,8,3,2,1,2,3
14759,17,89,42312,20,3,2,1,8,-5
14760,23,65,42312,2,0,0,0,0,-1
14761,20,74,8746,40,1,0,1,147,-7
14762,23,74,8746,39,3,0,3,92,-3
14763,26,76,8746,9,3,0,3,23,1
14764,29,76,8746,67,9,2,7,196,-5
14765,32,76,8746,45,4,2,2,106,-18
14766,35,76,8746,74,7,2,5,176,-2
14767,38,76,8746,60,5,1,4,124,-7
14768,41,76,8746,72,8,2,6,189,-5
14769,47,68,8746,23,1,0,1,37,1
14770,47,79,8746,27,1,1,0,87,0
14771,50,79,8746,1,0,0,0,5,0
14772,2,77,8905,68,41,21,20,64,-8
14777,17,64,8905,62,27,6,21,52,1
14778,20,64,8905,63,32,13,19,59,-3
14779,23,64,8905,6,4,0,4,2,0
14780,23,86,8905,59,23,9,14,30,-4
14781,26,86,8905,82,39,13,26,68,1
14782,29,86,8905,82,44,20,24,60,14
14783,32,86,8905,81,44,22,22,60,3
14784,35,86,8905,79,53,19,34,44,9
14785,38,86,8905,75,34,11,23,53,-12
14786,41,86,8905,71,26,7,19,40,8
14789,8,80,585,4,0,0,0,0,-4
14790,11,80,585,7,0,0,0,0,-10
14791,68,77,32805,2,0,0,0,0,0
14792,17,81,9681,73,12,8,4,56,-6
14793,20,81,9681,16,3,1,2,12,-1
14794,20,62,9681,41,16,7,9,34,-11
14796,26,70,9681,7,0,0,0,10,-1
14797,29,70,9681,41,13,7,6,44,0
14798,32,69,9681,75,24,10,14,52,-8
14799,35,69,9681,71,17,6,11,38,-21
14800,38,83,9681,5,1,0,1,0,1
14801,47,1479,9681,5,0,0,0,2,0
14802,8,83,42304,78,74,34,40,28,33
14803,11,83,42304,45,34,14,20,10,6
14804,14,83,42304,19,5,0,5,0,3
14805,14,62,42304,8,5,0,5,0,7
14806,17,70,42304,12,4,1,3,6,-7
14807,14,68,1903,5,2,1,1,0,3
14808,17,68,1903,81,57,8,49,94,-3
14809,20,68,1903,82,45,13,32,86,2
14810,23,68,1903,79,43,9,34,113,-3
14811,26,68,1903,80,37,8,29,83,-13
14813,32,68,1903,82,28,6,22,76,-8
14814,35,68,1903,82,29,7,22,87,-19
14815,38,83,1903,82,45,7,38,46,13
14816,17,86,3570,11,11,8,3,0,4
14817,20,86,3570,2,0,0,0,0,-2
14818,32,82,3570,11,3,0,3,2,-8
14819,2,83,8926,78,10,1,9,238,-28
14820,5,71,8926,75,21,2,19,118,-9
14821,8,71,8926,82,13,3,10,142,-18
14822,11,71,8926,69,8,2,6,131,-13
14823,14,71,8926,46,13,3,10,40,-6
14824,17,71,8926,82,11,2,9,108,-27
14825,20,71,8926,82,12,1,11,91,9
14826,23,77,8926,81,5,2,3,139,7
14827,26,77,8926,78,6,0,6,106,-3
14828,29,77,8926,74,7,2,5,140,14
14830,35,77,8926,72,9,1,8,102,18
14831,38,82,8926,82,13,0,13,73,-16
14832,41,82,8926,64,6,1,5,48,-11
14833,47,82,8926,44,7,1,6,30,-18
14834,47,83,8926,21,3,0,3,41,-1
14835,50,81,8926,27,3,0,3,16,3
14836,53,80,8926,76,9,2,7,41,1
14837,56,80,8926,2,0,0,0,2,-3
14838,2,75,22794,75,61,31,30,53,0
14839,5,72,22794,74,64,29,35,25,-1
14840,8,72,22794,78,73,38,35,44,-1
14841,11,72,22794,80,72,36,36,16,31
14842,14,72,22794,45,39,23,16,10,8
14843,17,72,22794,73,32,20,12,30,-8
14844,20,75,22794,63,46,22,24,32,0
14845,23,75,22794,14,9,5,4,5,1
14847,26,81,22794,64,33,12,21,22,-10
14848,29,81,22794,20,12,7,5,4,2
14849,29,78,22794,36,25,8,17,14,7
14850,35,79,22794,58,25,13,12,14,-8
14851,35,72,22794,10,3,1,2,0,-1
14852,14,67,13359,5,0,0,0,4,-1
14853,35,89,13359,4,0,0,0,4,1
14854,8,67,9069,2,1,1,0,10,0
14855,11,67,9069,35,6,2,4,106,-7
14856,14,67,9069,23,2,1,1,116,-2
14857,17,67,9069,73,31,15,16,335,-2
14858,20,67,9069,68,43,19,24,249,16
14859,23,67,9069,72,25,5,20,289,8
14860,26,67,9069,44,18,4,14,143,-2
14734,11,71,54627,63,32,17,15,36,-10
14738,23,66,54627,47,6,2,4,38,-16
14865,35,81,9069,29,0,0,0,70,-7
14866,35,74,9069,48,21,8,13,144,-3
14867,38,74,9069,79,36,14,22,142,9
14868,41,74,9069,69,32,12,20,120,15
14869,41,64,9069,13,9,4,5,37,3
14870,47,65,9069,82,28,8,20,178,-11
14871,50,70,9069,39,7,1,6,127,5
14873,26,88,73041,28,4,1,3,107,-7
14874,17,74,4393,2,1,1,0,0,-3
14875,20,74,4393,12,2,1,1,6,1
14876,23,79,4393,46,7,3,4,43,-2
14877,26,71,4393,2,1,1,0,0,1
14878,29,76,4393,11,4,1,3,8,1
14879,35,89,4393,1,1,0,1,0,0
14880,14,88,69075,23,5,2,3,18,-7
14881,17,88,69075,7,1,1,0,4,-2
14884,26,71,69075,12,6,4,2,0,-2
14885,29,71,69075,7,0,0,0,0,0
14886,2,89,53926,79,71,23,48,26,9
14887,5,89,53926,80,69,29,40,38,3
14888,8,89,53926,84,82,26,56,44,5
14889,11,89,53926,81,70,26,44,24,15
14890,14,83,53926,48,37,10,27,14,1
14891,17,84,53926,37,21,6,15,29,-3
14892,20,84,53926,75,52,20,32,42,0
14893,17,70,2683,57,28,6,22,16,5
14894,20,70,2683,63,43,16,27,2,26
14895,23,70,2683,72,42,23,19,20,19
14896,26,70,2683,74,52,20,32,18,29
14897,29,70,2683,17,8,3,5,0,1
14898,32,70,2683,74,45,20,25,24,14
14899,35,70,2683,73,49,25,24,14,27
14901,41,70,2683,58,26,13,13,20,0
14902,47,70,2683,80,52,33,19,30,9
14903,50,70,2683,73,43,26,17,16,5
14904,53,70,2683,48,37,15,22,14,9
14905,56,70,2683,48,24,8,16,8,1
14906,59,70,2683,58,17,4,13,8,-8
14907,80,70,23315,9,2,0,2,2,0
14908,86,70,23315,11,1,0,1,0,-4
14909,71,63,18882,2,0,0,0,0,0
14910,74,63,18882,32,3,2,1,2,-4
14911,74,87,18882,19,4,1,3,2,-3
14912,77,87,18882,10,1,0,1,2,-1
14913,14,71,15650,1,1,0,1,0,1
14914,17,71,15650,13,3,1,2,4,-3
14915,20,83,15650,3,1,0,1,0,-1
14916,20,71,15650,5,1,1,0,0,0
14918,20,81,67416,47,4,3,1,136,1
14919,23,77,67416,23,0,0,0,169,-1
14920,26,86,67416,30,1,1,0,116,-2
14921,29,86,67416,13,1,0,1,97,0
14922,32,73,67416,20,0,0,0,28,-5
14923,32,89,67416,5,0,0,0,29,0
14924,38,63,67416,1,0,0,0,31,0
14925,14,80,74523,2,0,0,0,0,0
14926,17,86,729593,71,39,8,31,42,-24
14927,20,86,729593,69,17,3,14,63,-18
14928,23,86,729593,79,25,5,20,65,-11
14929,26,86,729593,74,13,0,13,66,7
14930,29,86,729593,63,16,3,13,38,13
14931,32,86,729593,68,15,3,12,44,2
14932,35,86,729593,70,20,5,15,44,4
14933,38,86,729593,25,8,1,7,30,2
14935,41,77,729593,70,16,7,9,58,12
14936,77,547,62350,1,0,0,0,0,0
14937,80,547,62350,82,20,6,14,38,6
14938,83,547,62350,81,26,7,19,47,15
14939,86,547,62350,59,31,6,25,14,9
14940,20,62,2659,3,1,0,1,0,1
14941,26,62,2659,4,0,0,0,8,-2
14942,26,81,2659,4,1,1,0,15,-3
14943,29,64,2659,33,0,0,0,46,-5
14944,32,70,2659,57,3,1,2,99,1
14945,35,70,2659,39,0,0,0,58,-4
14946,38,70,2659,5,0,0,0,6,1
14947,38,65,2659,10,1,0,1,28,3
14948,71,84,23102,16,3,1,2,0,1
14949,83,84,23102,27,9,4,5,14,-1
14950,86,84,23102,9,2,1,1,12,-1
14952,8,67,29837,68,39,20,19,28,6
14953,11,67,29837,72,58,27,31,49,13
14954,14,67,29837,48,25,8,17,14,8
14955,17,67,29837,66,28,8,20,40,-12
14956,17,78,29837,7,1,0,1,0,-5
14957,20,78,29837,2,1,1,0,2,-1
14958,65,77,23343,4,0,0,0,0,1
14959,68,77,23343,6,2,0,2,0,4
14960,74,77,23343,11,3,0,3,7,3
14961,77,77,23343,56,7,1,6,66,2
14962,80,77,23343,65,12,3,9,83,-12
14963,83,77,23343,65,19,7,12,56,0
14964,86,65,23343,27,3,1,2,21,-14
14965,86,71,23343,12,1,1,0,4,-1
14966,14,88,41351,1,1,1,0,0,1
14967,20,88,41351,26,13,4,9,6,-6
14969,17,84,53923,12,5,2,3,6,2
14970,80,73,33886,1,0,0,0,0,-1
14971,83,1479,33886,7,1,0,1,21,0
14972,14,84,5531,1,1,1,0,0,1
14973,17,84,5531,49,18,4,14,34,8
14974,20,84,5531,70,21,5,16,63,0
14975,23,84,5531,35,6,3,3,21,-4
14976,26,84,5531,82,34,23,11,77,-14
14977,29,84,5531,57,24,10,14,30,7
14978,32,84,5531,47,16,3,13,20,13
14979,32,81,5531,26,12,1,11,25,-8
14980,35,76,5531,81,34,12,22,62,23
14981,38,76,5531,73,35,8,27,70,-5
14982,41,76,5531,81,44,13,31,54,29
14862,29,79,9069,64,24,12,12,197,3
14863,32,79,9069,47,5,1,4,168,-7
14990,68,82,5531,36,4,0,4,16,-8
14991,11,86,290610,22,5,1,4,14,-4
14992,14,86,290610,16,4,0,4,10,6
14993,17,86,290610,79,20,4,16,54,-14
14994,20,86,290610,35,7,2,5,59,0
14995,20,65,290610,28,10,1,9,10,4
14996,23,65,290610,28,4,1,3,12,-10
14997,26,81,290610,10,3,1,2,0,-7
14998,32,77,290610,49,16,5,11,26,9
15000,20,62,68864,1,0,0,0,2,1
15001,11,76,8772,1,0,0,0,0,0
15002,17,76,8772,19,4,1,3,14,-6
15003,20,76,8772,50,13,6,7,33,-8
15004,23,80,8772,9,2,2,0,9,1
15005,26,74,8772,3,0,0,0,0,0
15006,29,74,8772,1,0,0,0,0,0
15008,38,88,8772,66,38,12,26,30,5
15009,41,88,8772,57,35,14,21,33,4
15010,47,88,8772,62,41,13,28,46,-2
15011,50,88,8772,67,44,11,33,62,13
15012,53,88,8772,77,35,8,27,63,4
15013,56,88,8772,56,9,5,4,63,-11
15014,59,78,8772,6,0,0,0,2,-2
15015,14,62,9083,2,0,0,0,0,0
15016,17,62,9083,4,0,0,0,4,0
15017,20,62,9083,76,9,4,5,49,-23
15018,23,62,9083,44,12,5,7,57,0
15019,26,73,9083,64,15,4,11,60,-10
15020,29,73,9083,52,5,1,4,23,-11
15021,29,70,9083,2,0,0,0,2,1
15023,35,72,9083,1,1,0,1,0,1
15024,38,74,9083,27,12,5,7,14,6
15026,41,74,9083,28,8,1,7,10,2
15027,47,76,9083,25,9,1,8,23,5
15028,20,83,57849,0,0,0,0,0,0
15029,35,77,10874,52,27,11,16,8,9
15030,38,71,10874,21,6,1,5,11,-4
15031,20,71,9663,82,31,11,20,16,9
15032,23,71,9663,61,18,9,9,39,-9
15033,26,71,9663,78,39,21,18,20,4
15034,29,71,9663,44,14,9,5,8,-2
15035,32,71,9663,82,36,15,21,24,5
15036,35,71,9663,69,24,7,17,14,5
15037,35,74,9663,11,3,1,2,4,-9
15038,38,74,9663,32,12,6,6,4,-3
15039,38,73,9663,53,19,6,13,18,1
15040,41,73,9663,39,17,8,9,12,-1
15041,47,71,9663,9,2,1,1,2,1
15043,11,63,1950,10,0,0,0,0,-2
15044,14,63,1950,1,0,0,0,0,0
15045,17,76,1950,4,0,0,0,0,-3
15046,65,70,23787,1,0,0,0,0,0
15047,68,70,23787,48,8,3,5,65,1
15048,71,70,23787,80,17,6,11,86,9
15049,74,70,23787,20,1,0,1,23,-2
15050,74,86,23787,60,9,2,7,54,-11
15051,77,86,23787,76,11,2,9,61,8
15052,80,86,23787,81,10,2,8,60,-2
15053,83,86,23787,81,22,5,17,60,-7
15054,86,86,23787,82,22,1,21,61,19
15055,20,1479,972,29,6,3,3,23,5
15056,23,1479,972,21,1,0,1,2,-8
15057,26,1479,972,6,0,0,0,0,-2
15058,29,79,972,3,1,1,0,0,2
15060,32,78,972,10,0,0,0,0,1
15061,74,64,23812,1,1,0,1,0,1
15062,77,64,23812,9,2,0,2,0,-1
15063,86,64,23812,11,2,1,1,0,2
15064,41,74,24430,4,0,0,0,19,-1
15065,68,81,18081,22,5,2,3,38,3
15066,71,81,18081,73,22,3,19,152,2
15067,74,81,18081,31,5,2,3,34,-5
15068,77,77,18081,76,14,5,9,116,-3
15069,80,77,18081,67,23,6,17,93,8
15070,83,77,18081,70,16,2,14,83,0
15071,86,77,18081,77,20,4,16,63,6
15072,2,75,73616,5,0,0,0,21,-2
15073,5,75,73616,20,3,2,1,62,3
15074,8,75,73616,50,8,4,4,142,2
15075,11,75,73616,28,3,1,2,55,-2
15077,11,83,70977,2,0,0,0,0,0
15078,26,89,70977,2,0,0,0,0,0
15079,14,83,67156,3,0,0,0,9,0
15080,17,76,67156,7,0,0,0,27,-2
15081,20,76,67156,18,2,0,2,102,-1
15082,23,76,67156,37,4,3,1,101,1
15083,26,76,67156,9,2,1,1,30,1
15084,26,63,67156,45,5,1,4,152,-2
15085,29,63,67156,37,4,2,2,44,-4
15086,32,63,67156,40,4,2,2,121,-6
15087,35,88,67156,43,2,2,0,85,-5
15088,38,88,67156,4,0,0,0,17,0
15089,47,88,67156,5,0,0,0,7,-1
15090,2,62,8931,80,53,22,31,252,15
15091,5,62,8931,76,90,53,37,207,32
15092,8,62,8931,58,79,38,41,172,32
15094,14,62,8931,8,4,2,2,43,1
15095,17,62,8931,35,42,22,20,78,15
15096,23,66,8931,61,49,20,29,103,3
15097,26,66,8931,77,42,14,28,178,2
15098,29,66,8931,69,53,23,30,62,-10
15099,32,83,8931,82,53,29,24,109,16
15100,35,83,8931,69,48,21,27,63,-4
15101,38,83,8931,14,8,5,3,10,-2
15102,41,83,8931,72,48,28,20,84,9
15103,47,68,8931,58,40,14,26,51,4
15104,50,68,8931,50,29,13,16,71,5
15105,50,79,8931,19,13,7,6,26,-5
15106,53,79,8931,38,15,3,12,40,-3
15107,56,81,8931,30,7,4,3,27,-11
14984,50,65,5531,59,16,4,12,50,-22
14985,53,62,5531,76,35,10,25,37,13
15112,17,88,597473,10,5,2,3,15,-2
15113,20,88,597473,62,23,8,15,102,-25
15114,23,88,597473,77,21,6,15,131,0
15115,26,88,597473,72,13,3,10,138,-5
15116,29,88,597473,79,22,9,13,185,-14
15117,32,88,597473,79,18,8,10,141,5
15118,35,88,597473,81,22,8,14,125,5
15119,38,88,597473,73,19,7,12,122,-9
15120,41,88,597473,62,22,10,12,58,-4
15121,47,64,597473,82,45,21,24,116,3
15122,50,64,597473,81,29,8,21,133,5
15123,53,64,597473,70,19,4,15,140,-5
15124,56,64,597473,74,19,7,12,163,0
15125,59,77,597473,82,20,3,17,162,-1
15126,2,78,31456,3,1,0,1,8,-1
15127,2,79,31456,61,15,3,12,70,18
15129,8,63,31456,65,17,5,12,105,23
15130,11,63,31456,59,7,1,6,40,-13
15131,17,65,70327,9,0,0,0,5,-4
15132,20,65,70327,6,0,0,0,6,-1
15133,11,75,73614,7,3,1,2,20,0
15134,20,74,8831,11,1,1,0,30,-2
15135,23,74,8831,16,1,1,0,38,-2
15136,23,65,8831,4,1,0,1,5,0
15137,26,65,8831,6,0,0,0,17,0
15138,29,65,8831,52,1,0,1,143,-3
15139,32,65,8831,64,7,2,5,146,-8
15140,35,65,8831,50,3,1,2,103,-10
15141,38,65,8831,22,0,0,0,58,0
15142,41,65,8831,65,5,4,1,120,-10
15143,47,79,8831,20,1,1,0,42,0
15144,23,89,78180,3,0,0,0,0,0
15146,17,76,42473,4,0,0,0,7,0
15147,20,86,42473,2,1,0,1,0,1
15148,26,86,8550,31,3,0,3,65,-4
15149,29,86,8550,40,2,1,1,80,-5
15150,32,69,8550,69,7,3,4,131,-11
15151,35,69,8550,19,6,2,4,35,-4
15157,53,76,8550,58,8,1,7,86,-6
15158,56,76,8550,23,10,2,8,40,3
15159,59,76,8550,54,12,4,8,73,-3
15160,59,80,8550,18,1,1,0,34,-7
15161,62,1479,8550,39,4,0,4,87,1
15162,65,71,8550,52,10,3,7,80,5
15163,23,70,372,39,5,2,3,6,4
15164,29,70,372,34,7,3,4,6,-1
15165,29,75,372,13,3,1,2,4,-2
15166,32,75,372,47,7,3,4,4,-4
15168,20,64,8791,79,26,9,17,38,1
15169,23,64,8791,81,22,7,15,48,-10
15170,26,64,8791,72,15,8,7,40,-8
15171,29,64,8791,79,22,8,14,28,9
15172,32,64,8791,50,14,4,10,20,-3
15173,35,64,8791,73,17,5,12,48,1
15174,38,62,8791,82,25,10,15,50,-10
15175,41,62,8791,53,17,4,13,24,1
15176,47,62,8791,74,18,4,14,48,10
15177,50,62,8791,56,24,10,14,32,5
15178,53,62,8791,74,12,3,9,20,-4
15179,56,63,8791,77,18,7,11,32,6
15180,59,66,8791,59,7,4,3,28,-6
15181,59,64,8791,11,1,0,1,4,0
15182,29,62,13400,6,0,0,0,2,1
15183,38,82,13400,2,0,0,0,4,0
15185,2,88,23531,62,23,1,22,16,22
15186,5,88,23531,56,13,3,10,37,1
15187,26,73,5528,30,6,0,6,4,-4
15188,29,73,5528,41,9,4,5,10,0
15189,35,73,5528,14,3,1,2,2,-2
15190,41,85,5528,52,11,3,8,4,3
15191,47,85,5528,46,15,4,11,16,13
15192,50,63,5528,78,17,5,12,26,-10
15193,53,1479,5528,17,1,1,0,8,0
15194,2,88,21331,76,91,45,46,68,28
15195,5,88,21331,80,107,44,63,95,-4
15196,8,88,21331,84,125,63,62,100,18
15197,11,88,21331,83,86,44,42,86,-20
15198,14,79,21331,46,42,23,19,37,10
15199,17,74,21331,77,69,23,46,80,13
15200,20,74,21331,69,48,24,24,48,16
15202,26,88,21331,82,74,39,35,54,-1
15203,29,88,21331,71,74,36,38,68,11
15204,32,88,21331,82,88,37,51,66,10
15205,35,85,21331,81,50,30,20,38,-2
15206,38,85,21331,81,31,11,20,50,4
15207,41,88,21331,80,51,22,29,56,4
15208,47,88,21331,65,24,15,9,52,-6
15209,26,63,6363,6,1,1,0,0,2
15210,29,63,6363,43,20,7,13,10,-8
15211,32,63,6363,1,0,0,0,0,0
15212,38,77,6363,16,3,2,1,4,2
15213,26,81,3662,82,28,13,15,23,-19
15214,29,81,3662,80,67,25,42,43,-25
15215,32,81,3662,68,51,23,28,66,-26
15216,35,81,3662,76,37,20,17,61,-18
15217,38,81,3662,80,78,33,45,39,0
15219,47,81,3662,80,75,35,40,90,0
15220,50,81,3662,82,108,52,56,44,2
15221,53,81,3662,81,92,40,52,89,-17
15222,56,81,3662,77,67,29,38,54,-9
15223,59,81,3662,82,70,24,46,63,-16
15224,62,81,3662,65,54,25,29,43,-5
15225,65,81,3662,64,49,22,27,50,-2
15226,68,81,3662,39,32,10,22,29,-5
15227,71,77,3662,69,37,20,17,44,-16
15228,74,77,3662,57,20,8,12,36,-7
15229,77,77,3662,7,1,0,1,2,-1
15230,77,88,3662,42,17,10,7,20,1
15231,26,73,3663,1,0,0,0,0,0
15232,29,73,3663,71,28,13,15,30,-6
15109,14,78,597473,37,27,13,14,85,12
15110,17,78,597473,33,9,3,6,87,-4
15237,47,73,3663,44,26,7,19,34,3
15238,50,73,3663,78,63,27,36,44,23
15239,53,73,3663,65,44,15,29,38,-4
15240,56,73,3663,73,42,20,22,32,-3
15241,59,73,3663,82,38,11,27,24,-5
15242,62,73,3663,64,41,17,24,24,13
15243,65,73,3663,78,53,19,34,26,3
15244,68,73,3663,48,25,12,13,20,-6
15245,71,73,3663,62,40,10,30,30,-8
15246,71,85,3663,21,11,4,7,31,-9
15247,74,80,3663,80,27,9,18,32,1
15248,77,67,3663,79,14,5,9,14,-4
15249,29,86,3665,82,36,10,26,32,3
15250,32,86,3665,77,23,5,18,56,10
15251,35,86,3665,82,29,6,23,39,13
15252,38,86,3665,36,14,4,10,46,-6
15254,47,86,3665,23,12,2,10,14,-2
15255,47,63,3665,55,31,10,21,38,-6
15256,50,63,3665,48,17,7,10,26,-22
15257,50,62,3665,27,5,0,5,18,12
15258,53,88,3665,63,21,5,16,67,-16
15259,53,85,3665,9,2,1,1,2,6
15260,56,85,3665,67,15,2,13,26,-3
15261,59,85,3665,82,20,4,16,22,-12
15262,62,85,3665,67,20,3,17,40,4
15263,65,85,3665,81,21,6,15,29,16
15264,68,86,3665,48,6,0,6,25,4
15265,71,86,3665,61,11,3,8,35,4
15266,74,64,3665,65,13,3,10,16,-4
15267,77,64,3665,6,0,0,0,0,-2
15268,11,67,42374,15,1,0,1,0,-3
15269,14,71,2710,4,0,0,0,0,0
15271,32,88,2710,11,1,0,1,4,1
15272,35,76,2710,1,0,0,0,0,-1
15273,26,74,5524,73,16,8,8,13,-2
15274,29,74,5524,27,0,0,0,4,-6
15275,32,74,5524,50,12,4,8,31,-10
15276,35,74,5524,56,13,7,6,42,-1
15277,35,70,5524,16,1,1,0,5,-3
15278,38,70,5524,59,10,3,7,42,-2
15279,41,70,5524,9,0,0,0,4,-2
15280,41,82,5524,56,25,12,13,24,-5
15281,47,82,5524,58,31,10,21,41,1
15282,50,82,5524,82,25,9,16,76,-8
15283,53,82,5524,71,29,11,18,34,-3
15284,56,82,5524,77,35,11,24,28,9
15285,59,86,5524,71,33,14,19,41,17
15286,62,84,5524,72,30,11,19,22,9
15288,68,84,5524,9,0,0,0,0,-3
15289,71,66,5524,69,13,7,6,18,0
15290,74,75,5524,58,4,1,3,12,-6
15291,26,62,8751,20,1,0,1,4,0
15292,29,62,8751,2,0,0,0,0,-1
15293,32,62,8751,5,0,0,0,6,-3
15294,35,74,8751,10,0,0,0,0,-2
15295,38,74,8751,36,6,2,4,6,-1
15296,38,79,8751,27,13,5,8,10,-6
15297,41,79,8751,73,34,16,18,54,-46
15298,47,79,8751,20,0,0,0,10,-5
15300,47,89,8751,21,6,3,3,8,3
15301,50,89,8751,10,2,1,1,2,3
15302,38,72,8921,26,8,5,3,21,0
15303,41,72,8921,51,11,6,5,41,-1
15306,47,82,8921,39,6,4,2,58,-3
15308,53,72,8921,64,9,3,6,58,-8
15309,56,72,8921,72,9,3,6,136,-2
15310,59,79,8921,81,19,13,6,120,5
15311,62,79,8921,81,17,9,8,124,-4
15312,65,74,8921,60,5,4,1,97,-1
15313,68,74,8921,8,0,0,0,12,-3
15314,68,69,8921,32,4,1,3,67,1
15315,71,69,8921,13,1,0,1,23,1
15316,20,63,729598,41,9,1,8,14,-9
15317,23,63,729598,23,2,1,1,6,-9
15318,26,63,729598,22,6,0,6,10,4
15319,29,63,729598,60,8,0,8,22,-11
15320,32,82,729598,76,11,2,9,24,-8
15321,35,82,729598,78,11,4,7,44,-33
15322,38,76,729598,80,16,3,13,24,-2
15323,41,76,729598,5,2,1,1,2,2
15325,17,81,10657,1,0,0,0,0,0
15326,20,81,10657,34,10,2,8,10,2
15327,23,81,10657,13,3,1,2,7,-6
15328,23,89,10657,33,7,3,4,8,-11
15329,26,89,10657,21,6,1,5,2,0
15330,29,89,10657,20,3,1,2,4,-1
15331,32,76,10657,39,6,2,4,10,-7
15332,32,74,10657,15,2,1,1,0,-3
15333,35,74,10657,38,11,7,4,10,-4
15334,35,79,10657,14,3,2,1,4,-5
15335,38,68,10657,8,4,2,2,4,2
15336,2,74,27570,44,10,3,7,35,10
15337,5,74,27570,26,2,0,2,31,-10
15338,11,81,27570,6,0,0,0,10,-1
15339,26,79,28865,5,0,0,0,0,-2
15340,32,69,28865,7,0,0,0,0,-3
15342,32,64,8773,82,77,27,50,37,35
15343,35,64,8773,70,48,13,35,36,8
15344,38,64,8773,82,67,26,41,36,34
15345,41,64,8773,69,79,25,54,42,30
15346,47,64,8773,71,78,29,49,46,8
15347,50,62,8773,81,81,22,59,44,12
15348,53,62,8773,78,58,18,40,48,11
15349,56,75,8773,50,41,16,25,34,13
15350,59,81,8773,80,37,10,27,32,-2
15351,62,62,8773,79,69,22,47,24,0
15352,65,62,8773,64,49,13,36,28,7
15353,68,62,8773,40,27,11,16,22,-13
15354,71,64,8773,16,11,4,7,4,7
15355,74,64,8773,80,55,22,33,40,-1
15234,35,73,3663,63,30,11,19,54,1
15235,38,73,3663,64,48,17,31,34,-2
15360,41,77,8704,17,3,3,0,0,-3
15361,41,69,8704,31,7,3,4,6,-7
15362,47,77,8704,1,0,0,0,2,0
15363,29,64,8596,80,16,3,13,20,5
15364,32,64,8596,82,25,8,17,38,8
15365,35,64,8596,82,31,10,21,42,-3
15366,38,64,8596,81,25,4,21,68,11
15367,41,64,8596,58,16,2,14,30,2
15368,41,1479,8596,21,9,2,7,2,3
15369,47,70,8596,61,15,4,11,36,6
15370,47,69,8596,17,6,1,5,10,0
15371,50,69,8596,81,15,0,15,36,9
15372,53,69,8596,80,11,3,8,26,-16
15373,56,69,8596,81,16,4,12,10,-12
15374,59,79,8596,33,8,3,5,6,-4
15375,59,72,8596,19,3,0,3,4,7
15377,32,62,8908,71,4,1,3,70,-7
15378,35,62,8908,77,8,2,6,93,-24
15379,38,62,8908,76,12,0,12,87,-9
15380,41,62,8908,82,18,4,14,74,14
15381,47,62,8908,68,26,6,20,67,6
15382,50,62,8908,78,21,2,19,75,27
15383,53,62,8908,82,20,5,15,79,11
15384,56,62,8908,75,8,0,8,73,10
15385,59,62,8908,81,17,2,15,80,2
15386,62,62,8908,79,17,2,15,58,2
15387,65,67,8908,76,5,1,4,56,-12
15388,68,67,8908,29,2,0,2,21,-4
15389,68,88,8908,12,2,0,2,2,0
15390,71,88,8908,79,14,3,11,46,6
15391,74,88,8908,67,13,3,10,45,10
15392,29,76,9080,60,8,4,4,38,-13
15394,35,81,9080,36,0,0,0,12,-16
15395,38,68,9080,34,9,1,8,14,-18
15396,41,68,9080,57,13,3,10,51,-13
15397,47,89,9080,52,13,4,9,50,-11
15398,29,77,8825,80,48,20,28,22,11
15399,32,77,8825,69,59,27,32,18,24
15400,35,77,8825,79,66,33,33,32,31
15401,38,77,8825,46,27,9,18,16,20
15402,41,77,8825,80,45,24,21,29,12
15403,47,77,8825,72,79,47,32,38,31
15404,50,77,8825,76,68,41,27,30,2
15405,53,77,8825,25,18,7,11,4,-8
15406,56,77,8825,79,74,34,40,42,21
15407,59,77,8825,58,40,17,23,47,-1
15408,62,81,8825,63,40,17,23,20,-12
15409,65,88,8825,34,17,7,10,18,-1
15411,68,77,8825,27,11,5,6,6,-3
15412,74,63,8825,23,4,3,1,4,0
15413,32,79,9627,42,14,7,7,8,-6
15414,35,79,9627,68,16,8,8,16,-9
15415,38,79,9627,31,12,7,5,10,-8
15416,41,79,9627,66,40,19,21,18,-22
15417,20,89,9108,19,5,3,2,7,0
15418,20,63,9108,19,13,8,5,2,-7
15419,23,63,9108,78,43,16,27,31,7
15420,26,63,9108,55,40,24,16,22,7
15421,29,63,9108,59,47,22,25,14,8
15422,32,71,9108,61,42,16,26,23,1
15423,35,71,9108,82,60,28,32,25,3
15424,38,71,9108,68,55,25,30,20,-11
15425,38,74,9108,11,5,1,4,6,0
15426,41,74,9108,43,17,10,7,14,-12
15428,41,88,9108,15,1,0,1,0,-5
15429,47,84,9108,81,55,33,22,41,-1
15430,50,82,9108,54,27,10,17,16,-1
15431,50,66,9108,10,1,1,0,2,-3
15432,38,78,676854,4,0,0,0,0,-3
15433,41,78,676854,66,18,5,13,16,3
15434,47,78,676854,52,18,6,12,48,-15
15435,50,78,676854,61,18,7,11,36,13
15436,53,78,676854,45,10,1,9,30,-4
15437,53,74,676854,18,8,2,6,20,2
15438,56,82,676854,56,7,2,5,32,5
15439,20,62,564,68,35,19,16,12,-4
15440,23,62,564,50,14,6,8,16,-9
15441,23,75,564,28,11,6,5,6,2
15442,26,75,564,74,18,8,10,16,-5
15443,29,83,564,82,56,29,27,10,-2
15445,35,83,564,82,47,13,34,26,11
15446,38,83,564,79,32,13,19,12,2
15447,29,72,9045,82,70,19,51,78,14
15448,32,72,9045,76,63,14,49,46,-1
15449,35,72,9045,76,48,10,38,36,-4
15450,38,72,9045,80,55,13,42,48,17
15451,41,72,9045,80,70,14,56,70,18
15452,47,72,9045,82,84,33,51,42,8
15453,50,72,9045,72,60,13,47,42,7
15454,53,74,9045,81,70,16,54,36,3
15455,56,74,9045,77,58,16,42,60,-2
15456,59,75,9045,78,59,12,47,60,1
15457,62,75,9045,80,38,7,31,48,-15
15458,65,75,9045,38,11,2,9,14,-9
15459,68,86,9045,39,15,2,13,22,-10
15460,71,68,9045,46,12,2,10,24,-11
15462,77,78,9045,21,8,1,7,4,-4
15463,77,80,9045,13,1,0,1,2,-3
15464,29,1479,8520,31,2,1,1,26,0
15465,32,1479,8520,76,11,1,10,99,-1
15466,35,1479,8520,74,3,0,3,60,-10
15467,38,1479,8520,80,8,2,6,76,-8
15468,41,1479,8520,73,16,6,10,51,0
15469,47,1479,8520,82,8,1,7,91,8
15471,50,73,8520,15,1,0,1,10,1
15472,53,72,8520,69,7,2,5,50,-12
15473,29,83,8655,66,30,12,18,41,14
15474,32,83,8655,52,17,6,11,30,5
15475,35,83,8655,11,2,1,1,4,-1
15476,38,83,8655,72,45,16,29,124,11
15357,77,87,8773,18,13,4,9,8,5
15358,32,75,8704,13,4,1,3,0,0
15481,56,83,8655,63,46,21,25,24,-13
15482,56,74,8655,18,13,7,6,6,-1
15485,65,547,8655,69,35,15,20,42,0
15486,68,547,8655,40,18,6,12,16,6
15487,29,67,8671,4,0,0,0,4,0
15488,32,67,8671,79,22,4,18,38,-2
15489,35,67,8671,58,13,2,11,26,-6
15490,38,67,8671,65,21,8,13,57,-7
15491,41,67,8671,77,34,10,24,42,0
15492,47,67,8671,55,18,2,16,54,14
15493,50,67,8671,82,29,7,22,36,19
15494,53,67,8671,46,8,1,7,32,-7
15495,56,74,8671,58,13,1,12,26,-7
15497,41,67,4339,42,2,2,0,151,-3
15498,47,67,4339,28,0,0,0,100,-2
15499,50,67,4339,58,2,1,1,125,-1
15501,56,67,4339,28,1,0,1,81,-2
15502,59,72,4339,29,0,0,0,93,-5
15504,38,79,9683,3,0,0,0,2,-5
15505,41,79,9683,16,5,3,2,27,-5
15507,50,73,9683,13,5,1,4,13,-3
15508,29,65,10826,9,0,0,0,5,-2
15509,32,65,10826,61,25,10,15,20,0
15510,35,80,10826,72,13,4,9,43,4
15512,38,86,5525,66,16,9,7,39,-5
15513,41,86,5525,81,47,28,19,33,5
15514,47,86,5525,82,93,56,37,58,23
15515,50,86,5525,76,69,37,32,69,11
15516,53,86,5525,69,37,23,14,46,11
15517,56,86,5525,66,29,12,17,59,-3
15518,59,80,5525,61,14,5,9,20,-13
15519,32,78,8829,1,0,0,0,0,-2
15521,38,78,8829,20,3,0,3,8,3
15522,41,68,8829,79,37,13,24,52,-16
15523,47,68,8829,80,37,8,29,90,15
15524,50,68,8829,78,29,4,25,64,-5
15525,53,68,8829,20,2,0,2,14,-2
15526,56,83,8829,27,11,3,8,14,2
15527,23,66,69046,18,2,0,2,10,-1
15528,26,66,69046,20,3,0,3,24,5
15529,29,66,69046,58,8,0,8,25,0
15530,32,66,69046,48,1,0,1,6,-10
15531,35,66,69046,5,1,0,1,6,3
15532,38,66,69046,6,0,0,0,0,1
15533,35,62,9081,6,1,1,0,2,-1
15534,38,62,9081,9,4,1,3,0,3
15535,41,62,9081,20,3,1,2,10,-1
15536,47,74,9081,66,10,8,2,24,-10
15538,53,74,9081,75,7,2,5,20,-4
15539,56,74,9081,81,10,6,4,16,-5
15540,59,77,9081,63,18,8,10,14,7
15541,62,77,9081,75,12,5,7,8,-3
15542,2,65,8920,79,94,41,53,80,38
15543,5,65,8920,80,103,53,50,98,23
15544,8,65,8920,84,107,50,57,86,15
15545,11,65,8920,84,107,46,61,125,21
15546,14,65,8920,33,34,10,24,14,5
15547,17,65,8920,66,67,32,35,109,9
15553,35,77,8920,75,67,21,46,74,32
15554,38,77,8920,79,59,27,32,75,20
15555,41,77,8920,62,47,19,28,62,1
15556,47,88,8920,58,22,9,13,36,-5
15558,53,86,8920,69,33,14,19,26,-8
15559,56,86,8920,42,13,4,9,24,-1
15561,38,72,48706,38,9,4,5,20,3
15562,41,72,48706,23,5,2,3,4,-4
15563,41,68,48706,10,4,3,1,10,-2
15564,35,70,9145,33,1,0,1,62,-8
15565,38,70,9145,16,2,2,0,29,1
15566,41,70,9145,32,1,0,1,84,-9
15567,47,70,9145,26,0,0,0,62,-3
15568,47,76,9145,34,1,1,0,99,-12
15569,50,89,9145,29,7,1,6,69,-13
15570,53,89,9145,51,9,2,7,96,1
15571,56,89,9145,52,4,0,4,63,1
15572,59,89,9145,50,6,1,5,66,16
15573,62,89,9145,73,11,4,7,94,1
15574,65,89,9145,28,2,0,2,51,3
15575,68,89,9145,30,6,3,3,34,10
15576,71,89,9145,37,4,1,3,56,-5
15578,23,71,9666,67,25,10,15,74,-17
15579,23,77,9666,13,6,1,5,35,-4
15580,26,77,9666,78,45,8,37,61,16
15581,29,77,9666,68,18,4,14,55,16
15582,32,77,9666,82,49,14,35,86,13
15583,35,77,9666,75,19,5,14,46,17
15584,38,77,9666,24,3,0,3,20,7
15585,38,86,9666,37,16,3,13,30,-6
15586,38,63,9666,10,1,0,1,10,2
15587,41,63,9666,80,28,5,23,65,-1
15588,47,72,9666,27,6,0,6,36,-5
15589,35,68,6557,2,0,0,0,2,-1
15590,38,68,6557,3,0,0,0,0,-2
15591,41,68,6557,4,0,0,0,7,-1
15593,20,74,18434,16,10,5,5,6,4
15594,23,74,18434,15,4,2,2,6,-10
15600,41,64,2681,12,0,0,0,2,-4
15601,47,64,2681,53,4,0,4,56,10
15602,50,64,2681,74,8,2,6,69,6
15603,56,77,2681,46,10,1,9,22,7
15604,56,84,2681,3,1,0,1,0,1
15605,8,80,38488,49,13,7,6,52,-21
15606,26,79,1834,11,1,0,1,6,-3
15607,35,78,10307,1,0,0,0,0,-2
15608,38,78,10307,11,3,2,1,0,-1
15609,38,76,10307,5,3,1,2,4,1
15610,41,76,10307,64,13,8,5,8,4
15611,20,83,8735,14,2,1,1,2,-2
15612,29,83,8735,6,2,0,2,2,2
15613,32,83,8735,25,10,1,9,4,13
15478,47,83,8655,57,31,12,19,56,13
15479,50,83,8655,54,33,18,15,44,8
15618,47,88,8735,53,13,2,11,48,0
15619,50,63,8735,17,1,0,1,6,-2
15620,26,63,67411,3,0,0,0,0,1
15621,29,63,67411,23,3,1,2,2,-1
15622,32,63,67411,31,16,3,13,14,2
15623,35,63,67411,20,3,0,3,9,0
15624,38,63,67411,73,22,6,16,21,4
15625,35,67,8977,5,1,0,1,0,0
15626,38,67,8977,8,2,0,2,6,-2
15627,41,67,8977,2,0,0,0,2,0
15628,47,81,8977,14,3,2,1,4,-2
15629,14,76,2018,2,0,0,0,2,0
15630,17,76,2018,10,7,2,5,2,4
15631,20,76,2018,3,0,0,0,2,-3
15633,38,71,10981,1,0,0,0,0,0
15634,50,63,10981,31,3,0,3,10,-1
15636,38,67,9631,6,0,0,0,4,-2
15637,29,75,8709,19,2,1,1,2,-6
15638,32,75,8709,2,0,0,0,2,0
15639,35,75,8709,43,18,8,10,12,-11
15640,38,75,8709,52,17,5,12,6,-3
15641,41,75,8709,81,65,20,45,34,15
15642,47,75,8709,79,51,16,35,36,-6
15643,50,70,8709,81,59,18,41,22,3
15644,53,70,8709,76,83,27,56,46,21
15645,56,70,8709,82,78,22,56,52,-4
15646,59,70,8709,66,53,19,34,38,-5
15647,62,70,8709,82,71,19,52,28,-4
15648,65,70,8709,74,63,18,45,66,5
15649,68,89,8709,48,49,13,36,53,-4
15651,74,73,8709,82,62,15,47,52,11
15652,77,73,8709,81,50,7,43,62,11
15654,71,89,12119,10,2,1,1,0,3
15655,74,547,12119,1,0,0,0,0,0
15656,41,85,69540,2,0,0,0,0,0
15657,35,64,42067,8,0,0,0,4,-4
15658,38,64,42067,4,0,0,0,0,0
15659,41,64,42067,57,12,5,7,37,-5
15660,8,63,3407,2,0,0,0,2,-1
15661,35,80,15316,6,1,0,1,0,1
15662,32,73,9590,40,13,6,7,4,0
15663,35,73,9590,82,42,20,22,16,-18
15664,38,73,9590,79,35,11,24,32,-18
15665,41,73,9590,72,21,9,12,22,-2
15666,50,65,9590,79,27,10,17,54,-13
15667,32,70,8713,48,7,2,5,29,-3
15669,41,84,8713,18,3,1,2,23,-4
15670,47,84,8713,12,2,1,1,21,0
15673,47,1479,8527,72,8,2,6,46,8
15674,50,1479,8527,76,8,2,6,48,1
15675,53,1479,8527,23,5,1,4,16,3
15676,2,78,31543,48,32,14,18,10,2
15677,2,84,31543,11,12,6,6,0,-2
15678,5,84,31543,80,71,24,47,42,18
15679,8,84,31543,79,85,29,56,30,19
15680,11,84,31543,76,68,25,43,42,7
15681,14,84,31543,41,25,6,19,27,-4
15682,17,84,31543,79,67,22,45,42,16
15686,26,73,31543,72,53,18,35,40,-6
15687,29,73,31543,82,62,26,36,34,-13
15688,32,73,31543,80,62,19,43,28,4
15689,35,73,31543,67,49,18,31,24,0
15690,35,88,31543,14,5,1,4,8,0
15691,38,69,31543,80,48,17,31,24,-6
15693,32,81,4719,82,62,21,41,14,-10
15694,35,81,4719,82,62,20,42,13,-18
15695,38,81,4719,80,74,17,57,24,3
15696,41,81,4719,82,79,26,53,12,14
15697,47,81,4719,82,91,23,68,32,0
15698,50,81,4719,82,70,25,45,23,-19
15699,53,81,4719,62,51,18,33,15,-25
15700,53,70,4719,12,11,2,9,0,-2
15701,56,70,4719,56,48,16,32,6,-4
15702,59,70,4719,80,91,24,67,14,-12
15703,62,70,4719,72,77,28,49,24,1
15704,65,74,4719,82,66,25,41,22,-1
15705,68,74,4719,46,34,11,23,14,8
15706,71,74,4719,82,51,20,31,18,-8
15707,74,65,4719,76,37,12,25,12,3
15708,77,85,4719,68,28,10,18,8,4
15710,38,89,8742,38,0,0,0,80,-4
15711,41,69,8742,71,6,2,4,106,4
15712,47,69,8742,63,5,0,5,73,-4
15713,56,75,8742,2,0,0,0,10,-2
15714,29,84,2671,8,1,0,1,6,-1
15715,32,84,2671,21,6,3,3,32,1
15716,35,84,2671,49,9,2,7,74,-1
15717,38,84,2671,36,4,2,2,66,-7
15718,41,84,2671,71,14,6,8,133,-13
15719,47,84,2671,82,17,10,7,142,1
15720,50,79,2671,81,16,7,9,125,0
15721,53,79,2671,71,16,6,10,138,3
15722,56,80,2671,78,21,7,14,144,0
15723,59,80,2671,82,26,12,14,121,-2
15724,62,80,2671,50,10,2,8,59,-2
15725,62,1479,2671,23,2,1,1,38,0
15727,38,66,8729,53,27,14,13,72,1
15728,41,66,8729,80,42,18,24,93,-4
15729,47,66,8729,60,59,30,29,54,19
15730,50,66,8729,71,61,29,32,76,2
15731,53,66,8729,73,51,22,29,76,5
15732,56,71,8729,63,27,16,11,63,-3
15733,56,66,8729,17,15,2,13,10,3
15734,59,66,8729,40,16,11,5,29,-9
15735,62,66,8729,82,52,26,26,49,-1
15736,65,75,8729,82,61,35,26,48,11
15737,68,75,8729,19,6,3,3,10,1
15738,68,70,8729,28,7,6,1,10,-7
15739,71,70,8729,75,29,16,13,20,-17
15740,74,70,8729,57,33,18,15,14,4
15615,38,65,8735,67,28,5,23,26,-7
15616,41,65,8735,58,25,8,17,30,-5
15745,47,81,8631,68,15,9,6,16,-7
15746,50,81,8631,33,6,3,3,8,-6
15747,50,77,8631,41,15,8,7,12,-19
15748,17,81,77621,5,0,0,0,2,0
15749,20,81,77621,4,0,0,0,5,-3
15750,23,81,77621,8,0,0,0,9,0
15751,41,80,12684,1,0,0,0,2,1
15752,38,75,8525,1,0,0,0,0,-1
15753,47,82,8525,11,2,0,2,11,-6
15754,47,1479,8525,61,34,8,26,41,8
15755,50,1479,8525,71,28,7,21,49,7
15756,53,1479,8525,82,21,2,19,59,-9
15757,56,1479,8525,20,5,4,1,12,-3
15758,59,83,8525,82,26,5,21,33,-13
15759,62,83,8525,54,12,2,10,16,-4
15760,62,1479,8525,27,5,3,2,16,-4
15762,68,1479,8525,48,24,6,18,22,19
15763,71,1479,8525,70,17,4,13,39,26
15764,74,1479,8525,64,23,11,12,48,17
15765,77,64,8525,82,34,8,26,38,-7
15766,80,64,8525,81,18,5,13,32,-14
15767,83,1479,8525,67,17,3,14,26,12
15768,41,82,14419,3,0,0,0,0,-2
15769,26,63,118923,2,0,0,0,0,-1
15770,80,68,25362,14,3,2,1,18,-1
15771,2,89,32724,47,20,5,15,65,-7
15772,2,83,32724,13,6,2,4,10,-11
15773,5,83,32724,79,22,3,19,97,-20
15774,8,83,32724,82,14,3,11,130,7
15775,11,83,32724,63,16,5,11,101,8
15776,14,85,32724,48,8,1,7,36,14
15777,17,85,32724,58,6,0,6,48,5
15779,23,85,32724,71,12,1,11,57,-9
15780,26,86,32724,70,11,0,11,44,0
15781,29,86,32724,26,1,0,1,19,-3
15782,35,72,9044,33,11,4,7,8,10
15783,38,72,9044,58,25,12,13,23,5
15784,41,72,9044,75,29,21,8,36,19
15785,47,72,9044,82,89,48,41,46,18
15786,50,72,9044,62,45,25,20,36,-3
15787,53,72,9044,82,53,22,31,46,1
15788,56,72,9044,81,60,20,40,32,12
15789,59,75,9044,61,46,28,18,26,3
15790,62,75,9044,82,46,29,17,24,3
15791,65,75,9044,31,15,8,7,16,-7
15792,68,75,9044,48,26,14,12,8,3
15793,71,75,9044,81,40,18,22,22,1
15794,74,67,9044,69,35,13,22,18,-13
15796,80,67,9044,82,35,15,20,22,-11
15797,83,63,9044,20,7,2,5,2,-1
15798,38,78,8793,16,1,0,1,38,0
15799,41,78,8793,14,1,0,1,25,0
15800,47,78,8793,54,2,0,2,79,-7
15801,50,78,8793,48,5,0,5,72,7
15802,53,78,8793,43,2,1,1,61,-3
15803,56,65,8793,65,14,1,13,79,7
15804,59,81,8793,66,5,2,3,90,-11
15805,62,77,8793,4,0,0,0,4,0
15806,65,77,8793,4,0,0,0,16,-2
15807,68,65,15396,1,0,0,0,2,1
15808,71,84,15396,64,16,1,15,32,5
15809,74,84,15396,54,11,3,8,35,9
15810,77,89,15396,1,0,0,0,2,-1
15811,59,69,17841,12,4,1,3,0,-2
15813,65,69,17841,14,7,2,5,0,-4
15814,71,89,17841,13,3,2,1,0,3
15815,62,77,38366,2,0,0,0,5,-1
15816,65,77,38366,5,0,0,0,2,0
15817,32,83,8653,22,4,1,3,14,-1
15818,35,83,8653,8,2,2,0,0,2
15819,38,83,8653,13,3,0,3,11,4
15820,41,83,8653,73,28,9,19,44,14
15821,47,83,8653,81,38,21,17,68,15
15822,50,83,8653,71,45,21,24,63,8
15823,53,83,8653,66,35,18,17,36,3
15824,56,83,8653,82,61,23,38,38,6
15825,59,83,8653,61,41,19,22,44,5
15826,59,79,8653,16,9,2,7,17,-6
15827,62,88,8653,61,15,5,10,36,1
15828,65,66,8653,49,15,7,8,26,-12
15830,68,547,8653,12,2,2,0,6,-2
15831,68,72,8653,30,7,2,5,8,1
15832,32,62,3728,19,11,4,7,14,1
15833,35,68,9676,8,2,0,2,2,0
15834,20,72,9739,2,1,1,0,0,1
15835,23,78,9739,48,15,6,9,35,4
15836,26,78,9739,60,27,9,18,24,10
15837,29,78,9739,7,2,1,1,6,-2
15838,32,78,9739,8,2,2,0,5,-1
15839,35,65,9739,19,2,0,2,4,-1
15842,38,72,9739,21,5,4,1,8,3
15843,41,74,9739,17,0,0,0,5,-3
15844,41,78,9739,25,4,1,3,4,-3
15845,47,72,9739,12,0,0,0,4,-6
15847,32,66,8609,76,21,8,13,53,-8
15848,35,66,8609,78,31,14,17,53,-7
15850,41,66,8609,82,45,19,26,60,-3
15851,47,66,8609,23,9,4,5,8,3
15852,50,73,8609,38,13,4,9,29,1
15853,50,66,8609,25,9,2,7,22,-6
15854,53,76,8609,81,35,16,19,53,1
15855,29,66,729605,81,12,4,8,19,-10
15856,32,66,729605,79,8,5,3,23,-9
15857,35,66,729605,40,2,0,2,6,-8
15858,38,66,729605,3,0,0,0,0,0
15859,35,68,7114,8,4,1,3,4,-2
15860,38,68,7114,15,1,0,1,25,-7
15861,41,68,7114,30,6,2,4,12,-6
15862,59,69,38210,3,1,0,1,8,2
15863,62,69,38210,2,0,0,0,0,0
15742,32,81,8631,9,2,1,1,4,1
15743,35,81,8631,5,0,0,0,0,-1
15868,77,69,38210,54,3,0,3,39,1
15869,80,69,38210,39,7,2,5,12,0
15870,83,78,38210,1,0,0,0,0,0
15871,83,69,38210,56,9,3,6,19,8
15872,86,69,38210,15,0,0,0,2,1
15873,38,86,8748,15,3,1,2,22,4
15874,41,86,8748,55,3,0,3,92,-3
15875,47,86,8748,69,6,1,5,76,6
15876,50,86,8748,22,2,0,2,27,-2
15877,53,86,8748,15,0,0,0,21,-3
15878,53,76,8748,19,2,1,1,32,-3
15879,56,84,8748,23,2,0,2,51,-4
15880,59,72,8748,1,0,0,0,0,0
15881,17,80,67486,75,14,4,10,68,-15
15882,20,63,67486,59,8,3,5,33,-16
15883,26,75,67486,46,0,0,0,29,-1
15885,32,71,4368,49,16,9,7,10,8
15886,35,71,4368,61,22,8,14,18,3
15887,38,71,4368,78,33,12,21,55,10
15888,41,71,4368,80,40,15,25,73,0
15889,47,71,4368,79,73,22,51,85,0
15890,50,71,4368,80,51,16,35,56,-22
15891,53,71,4368,53,50,21,29,30,1
15892,56,71,4368,80,53,17,36,39,7
15893,59,71,4368,77,36,13,23,51,-29
15894,62,71,4368,47,27,9,18,46,-1
15895,65,71,4368,81,34,13,21,24,-23
15896,68,71,4368,31,12,7,5,24,8
15897,71,70,4368,77,20,7,13,52,1
15898,74,70,4368,76,29,11,18,27,9
15899,77,1479,4368,59,15,6,9,34,1
15900,29,80,12236,13,7,2,5,2,4
15902,35,80,12236,1,1,0,1,0,1
15903,38,80,12236,33,19,9,10,4,3
15904,41,80,12236,43,6,2,4,14,-1
15905,41,1479,12236,22,2,2,0,4,-3
15906,38,84,2670,1,0,0,0,0,0
15907,35,88,9677,4,0,0,0,22,1
15908,38,88,9677,19,0,0,0,57,0
15909,41,88,9677,18,1,1,0,79,-1
15911,47,1479,9677,12,1,0,1,35,-2
15912,53,76,9677,3,0,0,0,12,0
15913,50,70,10997,26,5,3,2,107,2
15914,53,70,10997,48,3,1,2,105,-3
15915,56,70,10997,72,9,4,5,133,1
15916,59,70,10997,63,6,0,6,130,0
15917,62,70,10997,44,3,2,1,80,-7
15918,65,70,10997,10,0,0,0,23,-2
15920,68,72,10997,22,0,0,0,44,1
15921,71,68,10997,55,4,0,4,99,-10
15922,35,89,51396,8,1,0,1,6,-4
15923,68,86,18738,38,12,6,6,10,-1
15924,71,86,18738,62,19,2,17,35,5
15925,74,86,18738,53,19,8,11,18,3
15926,77,63,18738,2,0,0,0,0,-5
15927,80,73,18738,74,14,3,11,26,15
15928,83,73,18738,50,8,2,6,8,2
15929,86,73,18738,44,7,1,6,38,5
15930,62,84,39072,15,2,1,1,16,-1
15931,65,84,39072,23,1,1,0,37,-2
15932,68,84,39072,16,1,1,0,28,0
15933,68,89,39072,17,1,0,1,7,-2
15934,71,89,39072,41,2,2,0,49,-3
15935,74,89,39072,2,0,0,0,0,0
15937,53,81,11726,2,0,0,0,0,-1
15938,56,72,11726,24,1,0,1,21,0
15939,59,75,11726,7,0,0,0,5,0
15940,59,86,11726,28,2,1,1,20,3
15941,62,72,11726,7,0,0,0,7,0
15942,2,74,42038,14,1,0,1,27,-2
15943,11,75,9090,14,4,2,2,34,0
15944,14,75,9090,20,2,1,1,63,-5
15945,17,75,9090,67,4,0,4,223,-10
15946,20,75,9090,10,0,0,0,38,-2
15947,20,84,9090,59,13,8,5,207,-6
15948,23,84,9090,77,18,9,9,372,-9
15949,26,84,9090,82,18,8,10,209,-25
15950,29,84,9090,60,13,11,2,136,-9
15951,32,84,9090,79,28,9,19,145,0
15952,35,84,9090,31,13,5,8,90,-8
15954,38,77,9090,80,25,8,17,161,5
15955,41,77,9090,64,13,6,7,212,-1
15956,47,77,9090,76,9,4,5,166,-2
15957,50,89,9090,77,13,4,9,156,1
15958,53,89,9090,80,8,5,3,119,-7
15959,56,89,9090,63,4,1,3,121,-6
15960,59,74,9090,36,1,0,1,73,-9
15961,26,68,1627,63,15,3,12,28,15
15962,29,68,1627,82,36,10,26,53,7
15963,32,68,1627,12,3,2,1,8,-4
15964,32,65,1627,50,23,5,18,20,7
15965,35,65,1627,60,13,3,10,29,5
15966,35,82,1627,14,5,2,3,24,-9
15967,38,82,1627,81,45,9,36,70,-23
15968,41,82,1627,58,22,5,17,45,-13
15969,47,65,1627,45,24,7,17,72,8
15971,50,67,1627,65,21,5,16,62,20
15972,53,67,1627,60,32,9,23,42,7
15973,56,67,1627,80,45,8,37,38,2
15974,59,75,1627,74,21,3,18,50,9
15975,62,75,1627,59,16,1,15,45,9
15976,65,75,1627,12,3,0,3,2,2
15977,65,66,1627,34,12,5,7,6,4
15978,38,77,10239,1,0,0,0,0,0
15979,41,74,10239,1,0,0,0,0,0
15980,14,1479,22093,1,1,0,1,4,0
15981,17,1479,22093,16,3,1,2,14,8
15982,20,1479,22093,74,23,4,19,90,3
15983,23,1479,22093,19,4,1,3,4,-10
15984,23,63,22093,50,10,2,8,36,4
15865,68,69,38210,17,0,0,0,4,4
15866,71,69,38210,53,8,2,6,58,2
15989,35,68,22093,36,7,1,6,31,3
15990,35,76,22093,14,3,1,2,16,6
15991,38,82,22093,14,2,1,1,10,-6
15992,38,86,6660,10,3,1,2,0,-2
15993,41,86,6660,2,0,0,0,0,-1
15994,2,77,54479,3,1,1,0,0,1
15995,8,80,54479,69,16,3,13,61,-24
15996,11,80,54479,70,15,6,9,116,-50
15997,17,77,54479,5,0,0,0,4,0
15998,20,77,54479,10,0,0,0,0,-2
15999,32,78,54479,12,4,0,4,27,7
16000,38,81,54479,19,0,0,0,6,-2
16001,41,81,54479,5,0,0,0,2,-2
16002,41,63,8988,6,0,0,0,0,1
16003,47,63,8988,43,8,4,4,19,-2
16004,50,73,8988,1,0,0,0,0,0
16006,62,80,33243,36,21,10,11,10,-16
16007,65,80,33243,56,16,6,10,12,8
16008,68,72,33243,14,2,1,1,0,-6
16009,68,73,33243,20,9,3,6,4,-2
16010,71,68,33243,2,1,0,1,2,1
16011,32,75,592518,10,0,0,0,29,-3
16012,59,83,38297,2,0,0,0,2,0
16013,62,77,5541,3,0,0,0,4,-1
16014,65,77,5541,30,5,1,4,2,12
16015,68,77,5541,27,8,3,5,2,-1
16016,71,77,5541,31,10,2,8,6,7
16017,17,1479,67312,64,21,10,11,37,11
16018,20,1479,67312,18,8,2,6,14,1
16019,20,79,67312,55,20,5,15,76,-6
16020,23,79,67312,58,20,7,13,54,4
16021,26,86,67312,4,1,0,1,4,-1
16023,29,68,67312,8,3,1,2,4,3
16024,32,74,9682,43,5,1,4,74,-3
16025,35,74,9682,52,4,1,3,137,-2
16026,38,73,9682,3,0,0,0,2,1
16027,41,73,9682,5,1,0,1,10,3
16030,62,75,32186,2,0,0,0,0,-1
16031,41,79,8873,13,3,1,2,4,2
16032,47,79,8873,57,4,0,4,36,-18
16033,50,79,8873,78,11,1,10,28,3
16034,53,79,8873,71,5,0,5,26,3
16035,56,79,8873,81,16,1,15,18,23
16036,59,88,8873,73,11,0,11,21,16
16037,62,88,8873,82,15,2,13,16,1
16038,65,88,8873,82,9,1,8,16,-7
16039,68,88,8873,48,12,1,11,4,-6
16040,71,79,8873,53,4,0,4,2,-8
16042,77,79,8873,25,4,0,4,8,4
16043,77,65,8873,17,0,0,0,0,-6
16044,77,88,8873,21,6,0,6,2,9
16045,26,63,12772,5,0,0,0,0,2
16046,29,63,12772,22,6,2,4,10,-4
16047,32,63,12772,3,1,1,0,0,-1
16048,38,76,12772,3,0,0,0,0,-2
16049,32,71,9667,12,1,0,1,4,2
16050,71,62,31594,9,2,0,2,5,1
16051,2,65,50167,3,0,0,0,5,1
16052,5,65,50167,19,0,0,0,34,-8
16053,8,65,50167,67,6,2,4,151,5
16054,11,65,50167,67,8,1,7,200,10
16055,14,65,50167,33,4,1,3,88,4
16056,17,65,50167,61,4,2,2,129,8
16057,20,65,50167,44,2,1,1,65,-8
16059,26,65,50167,7,0,0,0,10,1
16060,26,64,50167,35,3,1,2,84,-5
16061,65,65,39211,18,0,0,0,58,-2
16062,68,65,39211,25,0,0,0,51,-1
16063,71,65,39211,82,14,7,7,92,-1
16064,74,62,39211,62,5,1,4,88,-9
16065,77,62,39211,54,4,2,2,103,-10
16066,26,64,71086,6,0,0,0,6,1
16067,35,88,11471,10,0,0,0,51,0
16068,38,88,11471,19,1,1,0,28,0
16069,47,88,11471,2,0,0,0,5,0
16070,32,86,366708,4,0,0,0,0,0
16071,35,74,366708,67,16,6,10,23,10
16072,38,74,366708,58,22,8,14,32,0
16073,38,79,366708,22,2,2,0,8,-21
16074,41,68,366708,37,9,3,6,35,0
16076,50,85,366708,53,34,14,20,28,1
16077,53,85,366708,73,40,11,29,26,21
16078,56,85,366708,81,40,19,21,50,0
16079,59,84,366708,74,53,30,23,64,10
16080,62,84,366708,75,50,18,32,36,8
16081,65,84,366708,6,3,1,2,6,-1
16082,65,68,366708,48,28,13,15,14,2
16083,68,85,366708,4,1,0,1,0,-3
16084,71,85,366708,26,3,1,2,6,-4
16085,2,67,1795,77,50,16,34,96,-6
16086,5,67,1795,70,25,4,21,76,-7
16087,8,65,1795,84,54,17,37,134,14
16088,11,65,1795,54,29,9,20,68,-4
16089,14,65,1795,20,7,2,5,6,3
16090,14,84,1795,25,11,5,6,23,11
16091,38,76,5211,8,4,0,4,4,5
16093,47,76,5211,82,35,16,19,34,-9
16094,50,76,5211,77,35,20,15,22,5
16095,53,76,5211,82,41,12,29,43,-17
16096,56,76,5211,55,31,14,17,41,-8
16097,59,76,5211,61,28,11,17,18,3
16098,62,76,5211,17,4,1,3,23,-3
16099,65,88,5211,38,7,2,5,8,-4
16100,2,63,9279,29,16,8,8,19,1
16101,5,63,9279,77,75,39,36,48,-10
16102,8,63,9279,60,41,19,22,38,-6
16103,11,80,9279,42,18,5,13,14,-21
16104,41,66,8923,25,3,1,2,22,4
16105,47,76,8923,6,1,0,1,0,1
16106,50,76,8923,11,1,0,1,4,0
15986,29,63,22093,79,28,5,23,73,-19
15987,32,63,22093,31,13,3,10,41,-9
16111,32,69,1563,20,4,1,3,4,-8
16112,8,88,51410,70,13,6,7,314,-15
16113,11,88,51410,80,19,10,9,322,-19
16114,14,88,51410,7,0,0,0,19,-5
16115,14,83,51410,26,7,1,6,101,1
16116,17,64,51410,52,8,6,2,147,6
16117,20,1479,51410,70,17,10,7,218,6
16118,23,1479,51410,63,11,5,6,198,-10
16119,23,64,51410,8,0,0,0,23,-1
16120,26,64,51410,28,2,0,2,63,3
16121,38,86,13956,16,0,0,0,2,-5
16122,14,1479,8551,43,17,6,11,23,7
16123,17,1479,8551,64,44,19,25,12,3
16124,20,1479,8551,79,67,19,48,24,26
16125,23,1479,8551,72,53,17,36,13,8
16126,26,1479,8551,69,62,23,39,22,11
16128,32,1479,8551,16,8,3,5,0,-5
16129,35,1479,8551,38,23,7,16,6,-3
16130,38,1479,8551,82,58,20,38,12,-14
16131,41,1479,8551,82,43,20,23,12,-14
16132,47,74,8551,72,36,13,23,10,6
16134,2,83,51742,20,5,0,5,2,-5
16135,5,83,51742,17,11,7,4,4,8
16136,8,83,51742,23,8,4,4,8,-4
16137,11,1479,51742,84,37,19,18,61,-11
16138,14,1479,51742,41,18,10,8,23,-8
16139,17,1479,51742,76,27,13,14,40,1
16140,20,1479,51742,77,29,12,17,35,1
16141,23,1479,51742,55,19,8,11,24,-1
16142,23,76,51742,25,6,3,3,10,1
16143,26,76,51742,73,3,3,0,45,-24
16144,29,89,51742,79,23,7,16,50,7
16146,35,89,51742,65,7,0,7,51,-13
16147,38,77,51742,34,6,1,5,20,0
16148,50,1479,10503,33,3,0,3,14,-3
16149,53,1479,10503,76,19,4,15,59,23
16150,56,1479,10503,33,6,2,4,27,6
16151,59,86,10503,82,22,3,19,47,6
16152,62,86,10503,50,10,2,8,12,8
16153,65,78,10503,25,7,2,5,10,9
16154,68,85,10503,11,0,0,0,4,-3
16155,68,77,10503,8,1,0,1,0,0
16156,65,70,37167,1,0,0,0,0,0
16157,68,70,37167,12,3,1,2,0,0
16158,71,63,37167,14,2,2,0,10,0
16159,74,63,37167,24,3,3,0,7,-5
16160,74,71,37167,36,9,5,4,10,-11
16161,2,62,29147,16,4,1,3,36,9
16163,5,89,29147,19,0,0,0,48,-5
16164,35,65,4749,21,4,3,1,4,-3
16165,38,65,4749,82,39,19,20,20,7
16166,41,65,4749,82,55,22,33,16,-13
16167,47,65,4749,60,41,13,28,40,5
16168,47,80,4749,19,4,0,4,4,-4
16169,50,64,4749,82,49,16,33,26,-8
16170,53,64,4749,70,31,10,21,16,-1
16171,56,64,4749,71,22,5,17,14,-16
16172,62,73,2293,4,0,0,0,0,-3
16173,26,86,9035,5,2,0,2,6,0
16174,29,86,9035,30,3,1,2,10,7
16175,32,86,9035,75,17,3,14,51,10
16176,35,86,9035,75,14,2,12,57,10
16177,38,86,9035,81,22,3,19,61,0
16178,41,86,9035,82,21,6,15,48,10
16180,50,86,9035,79,24,4,20,38,1
16181,53,64,9035,82,21,2,19,55,-5
16182,56,64,9035,81,10,1,9,26,-21
16183,59,64,9035,81,16,2,14,40,2
16184,62,64,9035,23,6,0,6,6,1
16185,62,89,9035,55,5,1,4,28,3
16186,65,62,9035,78,12,2,10,38,-10
16187,68,73,9035,29,1,0,1,20,-11
16188,68,86,9035,4,0,0,0,2,-3
16189,71,86,9035,56,12,3,9,55,1
16190,74,86,9035,58,7,2,5,26,0
16192,47,69,11035,10,1,0,1,2,-1
16193,50,83,11035,2,0,0,0,0,0
16194,2,77,1446,78,28,9,19,82,4
16195,5,77,1446,54,13,4,9,76,1
16196,5,79,1446,20,3,1,2,34,0
16198,11,79,1446,59,13,5,8,118,18
16199,14,79,1446,41,7,1,6,54,8
16200,17,77,1446,75,14,3,11,81,20
16201,20,77,1446,34,7,4,3,47,17
16202,23,77,1446,49,3,0,3,28,9
16203,26,81,1446,46,5,1,4,38,-6
16205,2,79,1444,14,5,1,4,37,4
16206,5,79,1444,62,15,1,14,206,2
16207,8,79,1444,77,29,3,26,249,36
16208,11,79,1444,80,29,5,24,199,23
16209,14,79,1444,44,16,1,15,113,11
16210,17,74,1444,74,19,1,18,122,9
16211,20,74,1444,73,17,6,11,138,3
16212,23,74,1444,73,12,3,9,122,1
16213,26,74,1444,67,12,4,8,93,6
16214,26,85,1444,4,0,0,0,6,-1
16216,35,80,8946,72,17,10,7,231,5
16217,38,80,8946,68,10,6,4,147,8
16218,41,80,8946,82,16,8,8,194,13
16219,47,80,8946,79,33,16,17,204,9
16220,50,80,8946,82,28,12,16,177,6
16221,53,80,8946,68,20,6,14,199,-3
16222,56,80,8946,60,10,3,7,146,-13
16223,59,80,8946,68,22,10,12,175,-1
16224,62,80,8946,80,16,6,10,210,-14
16225,65,80,8946,72,28,13,15,178,-10
16226,68,80,8946,48,12,4,8,144,0
16227,71,80,8946,76,14,8,6,211,-10
16228,74,80,8946,38,7,4,3,78,5
16229,77,80,8946,80,13,5,8,165,-3
16108,68,80,45889,12,2,2,0,13,-1
16109,77,80,45889,14,4,1,3,9,-4
16234,32,75,8575,63,23,6,17,18,-6
16235,35,75,8575,56,24,5,19,24,-1
16236,38,75,8575,79,37,13,24,34,13
16237,41,75,8575,69,28,6,22,20,-2
16238,47,75,8575,67,46,10,36,74,13
16239,50,75,8575,77,49,6,43,56,2
16240,53,75,8575,82,58,16,42,63,1
16241,56,75,8575,78,64,12,52,36,-2
16242,59,75,8575,45,34,6,28,32,11
16243,62,75,8575,7,3,1,2,4,2
16244,65,75,8575,13,3,0,3,4,-4
16245,68,75,8575,48,30,10,20,14,-9
16246,71,75,8575,81,43,7,36,34,12
16247,74,75,8575,81,50,10,40,38,22
16248,77,75,8575,82,44,5,39,38,-6
16249,80,75,8575,62,36,6,30,16,18
16251,20,1479,67186,64,21,7,14,53,-9
16252,23,1479,67186,9,4,1,3,8,1
16254,26,75,67186,6,0,0,0,0,0
16255,62,74,10876,42,23,6,17,4,3
16256,65,74,10876,10,3,2,1,6,0
16257,68,74,10876,15,8,3,5,8,10
16258,71,74,10876,77,59,19,40,32,11
16259,74,74,10876,78,49,15,34,45,17
16260,77,74,10876,81,61,26,35,34,2
16261,80,74,10876,80,59,15,44,26,15
16262,83,74,10876,80,53,16,37,36,-10
16263,86,74,10876,46,37,11,26,24,-11
16264,86,70,10876,2,3,1,2,0,3
16265,2,77,72083,15,3,0,3,0,-3
16267,35,67,8677,13,4,1,3,2,-1
16268,38,67,8677,68,35,21,14,30,-2
16270,47,67,8677,82,62,25,37,62,-3
16271,50,67,8677,66,38,16,22,46,-5
16272,53,67,8677,79,43,23,20,58,-5
16273,56,67,8677,56,32,13,19,28,-7
16274,56,71,8677,19,11,7,4,6,2
16275,59,74,8677,45,22,8,14,38,-18
16276,59,62,8677,26,5,3,2,29,1
16277,62,62,8677,26,6,4,2,8,-7
16278,32,77,9625,2,0,0,0,0,-1
16279,35,77,9625,3,1,1,0,0,1
16280,2,84,42238,59,13,7,6,125,-20
16281,5,84,42238,66,40,16,24,176,22
16282,8,84,42238,59,28,10,18,122,2
16285,17,84,42238,33,6,4,2,6,-3
16286,2,88,97460,68,89,45,44,106,27
16287,5,88,97460,49,39,17,22,70,-2
16289,11,88,97460,51,41,17,24,59,-12
16290,11,79,97460,27,17,6,11,24,5
16291,14,79,97460,47,44,21,23,42,1
16292,17,79,97460,58,70,35,35,69,4
16293,20,79,97460,40,24,9,15,33,4
16294,20,85,97460,34,18,9,9,36,2
16295,23,1479,97460,77,17,9,8,64,-25
16296,26,1479,97460,58,32,15,17,42,-5
16297,62,84,39615,29,1,0,1,0,0
16298,65,84,39615,25,2,0,2,2,10
16299,68,84,39615,38,7,2,5,10,4
16300,71,84,39615,64,17,6,11,8,12
16301,74,84,39615,70,20,2,18,12,8
16302,77,84,39615,69,18,4,14,8,-8
16303,80,84,39615,53,10,2,8,14,3
16304,83,84,39615,42,11,2,9,8,7
16306,11,80,1838,10,0,0,0,15,-6
16307,11,80,28638,3,0,0,0,2,-1
16308,26,62,28638,18,3,0,3,20,0
16309,32,83,43333,18,3,1,2,10,-5
16310,2,88,48196,4,0,0,0,4,3
16311,35,85,8611,70,35,11,24,4,4
16312,38,85,8611,64,51,12,39,16,20
16313,41,85,8611,75,68,30,38,35,-2
16314,47,85,8611,75,87,28,59,22,26
16315,50,85,8611,79,87,27,60,20,36
16316,53,85,8611,82,97,31,66,20,41
16317,56,85,8611,81,97,32,65,22,34
16318,59,85,8611,80,70,27,43,18,17
16319,62,85,8611,56,59,23,36,15,11
16320,65,85,8611,70,67,19,48,14,21
16321,68,85,8611,47,49,15,34,14,21
16323,74,85,8611,63,65,26,39,8,12
16324,77,85,8611,66,49,16,33,14,7
16325,35,70,2686,9,1,0,1,2,-1
16326,38,70,2686,82,34,5,29,44,25
16327,41,70,2686,67,6,1,5,16,-15
16328,47,70,2686,81,35,14,21,36,-10
16332,14,74,15119,3,1,1,0,2,-1
16333,17,80,15119,4,2,1,1,2,3
16334,20,63,15119,52,25,10,15,22,-8
16335,23,63,15119,2,0,0,0,0,0
16336,26,73,5527,2,1,0,1,0,0
16337,29,73,5527,59,11,5,6,20,-7
16338,32,73,5527,82,12,1,11,30,-12
16339,35,73,5527,82,17,4,13,36,-12
16340,38,73,5527,82,13,3,10,44,-18
16341,41,64,5527,82,13,5,8,26,18
16343,50,64,5527,68,11,0,11,30,0
16344,53,64,5527,43,4,1,3,20,-2
16345,53,68,5527,17,1,1,0,12,-9
16346,56,68,5527,80,18,4,14,30,9
16347,59,70,5527,79,13,2,11,24,-4
16348,62,70,5527,74,8,3,5,38,-1
16349,41,89,69118,2,0,0,0,2,0
16350,71,73,6016,12,9,2,7,4,7
16351,74,73,6016,74,18,7,11,18,2
16352,77,73,6016,81,30,16,14,14,1
16353,80,73,6016,81,31,15,16,25,-1
16354,83,73,6016,68,35,16,19,12,20
16355,86,73,6016,79,26,10,16,12,13
16356,74,74,10707,1,0,0,0,0,0
16231,38,69,223,4,1,1,0,0,1
16232,41,69,223,15,9,5,4,14,1
16361,86,80,10707,20,8,5,3,4,1
16362,2,67,28054,3,1,0,1,0,-2
16363,71,71,34760,44,6,0,6,16,-2
16364,74,71,34760,41,5,1,4,16,-4
16365,77,83,34760,65,7,1,6,34,-3
16366,80,83,34760,25,7,1,6,16,3
16367,83,83,34760,2,0,0,0,2,-2
16368,86,83,34760,24,5,1,4,12,-4
16369,26,74,597,23,2,0,2,8,-5
16370,83,83,46918,2,2,2,0,0,5
16371,86,83,46918,11,1,0,1,2,-5
16372,2,75,21483,70,59,28,31,52,-1
16373,5,75,21483,77,70,28,42,73,6
16374,8,75,21483,63,50,16,34,90,1
16375,11,81,21483,74,46,18,28,106,-1
16376,14,81,21483,31,17,6,11,10,-6
16378,17,65,21483,69,48,13,35,102,20
16379,20,65,21483,64,27,9,18,60,-10
16380,74,77,34818,3,2,0,2,0,1
16381,56,83,206,41,7,1,6,28,0
16382,11,1479,30925,1,0,0,0,0,0
16383,26,74,729607,4,0,0,0,0,0
16384,29,74,729607,9,2,1,1,2,0
16385,32,74,729607,15,3,0,3,8,-5
16386,32,75,729607,26,2,1,1,6,0
16387,68,63,23114,4,0,0,0,0,0
16388,71,63,23114,23,11,0,11,6,0
16389,74,63,23114,29,18,8,10,2,2
16390,77,63,23114,80,49,13,36,35,-9
16391,80,63,23114,78,39,11,28,14,-8
16392,83,63,23114,39,25,9,16,2,10
16393,83,74,23114,20,16,4,12,2,-4
16395,86,71,23114,25,3,2,1,2,-6
16396,86,84,23114,11,4,0,4,0,-1
16397,68,69,3494,1,0,0,0,0,0
16398,71,67,3494,28,4,0,4,19,0
16399,74,67,3494,39,16,6,10,12,0
16400,77,67,3494,74,17,10,7,27,-4
16401,80,67,3494,36,11,6,5,20,-7
16402,83,67,3494,80,17,4,13,49,-30
16403,86,67,3494,73,14,6,8,37,-8
16404,74,77,75049,1,0,0,0,0,-1
16405,83,77,75049,8,0,0,0,2,0
16406,83,64,75049,7,0,0,0,0,-1
16407,86,64,75049,2,0,0,0,0,0
16408,35,66,8591,10,4,2,2,2,0
16409,38,66,8591,48,14,3,11,32,-5
16410,41,66,8591,33,4,3,1,6,3
16412,2,89,53475,1,0,0,0,0,-1
16413,8,89,53475,16,5,2,3,12,-4
16415,38,86,9146,43,20,1,19,33,-3
16416,41,86,9146,15,2,0,2,18,-2
16417,47,86,9146,21,2,0,2,14,-11
16418,50,72,9146,13,1,0,1,2,0
16419,32,77,10867,6,1,1,0,2,-1
16420,8,80,33201,2,0,0,0,0,-2
16421,32,79,8917,12,8,2,6,4,3
16422,35,79,8917,79,18,8,10,4,-15
16423,50,71,8917,64,15,6,9,4,-18
16424,53,70,8917,8,3,0,3,4,0
16425,56,70,8917,57,11,4,7,14,1
16426,59,70,8917,78,15,9,6,6,3
16427,62,70,8917,60,6,2,4,8,-7
16428,65,70,8917,39,5,2,3,6,-7
16430,77,68,45701,23,5,1,4,14,1
16431,83,68,45701,44,12,4,8,19,-6
16432,86,74,45701,14,4,1,3,9,3
16433,41,75,4484,81,63,25,38,26,10
16434,47,75,4484,81,55,30,25,40,-5
16435,50,75,4484,82,58,30,28,60,-25
16436,53,75,4484,70,31,14,17,30,-4
16437,56,63,4484,74,53,27,26,26,28
16438,59,63,4484,82,33,18,15,35,3
16439,62,63,4484,79,41,18,23,26,-1
16440,65,70,4484,82,62,35,27,46,17
16441,68,70,4484,19,14,6,8,8,4
16442,68,75,4484,27,21,10,11,8,-2
16443,71,72,4484,82,34,18,16,18,-6
16444,74,72,4484,47,19,6,13,30,-1
16445,77,88,23320,10,0,0,0,2,0
16447,80,77,23320,23,12,8,4,10,5
16448,83,77,23320,69,21,8,13,12,-10
16449,86,77,23320,28,9,3,6,16,-5
16450,86,87,23320,19,2,1,1,0,-3
16451,86,75,23320,16,10,4,6,2,0
16452,71,83,31293,1,0,0,0,0,0
16453,74,83,31293,3,0,0,0,0,0
16454,77,68,31293,15,2,2,0,2,1
16455,80,68,31293,31,6,3,3,11,-5
16456,80,81,31293,15,1,0,1,11,2
16457,83,79,31293,26,4,2,2,8,-4
16458,86,66,31293,41,11,6,5,8,-2
16459,71,75,36732,60,14,7,7,18,-6
16460,74,75,36732,29,5,3,2,4,3
16461,80,81,36732,19,3,2,1,2,-3
16462,83,81,36732,5,0,0,0,0,0
16464,68,69,60301,37,14,8,6,28,3
16465,71,69,60301,70,30,12,18,33,-7
16466,74,69,60301,82,35,11,24,39,13
16467,77,69,60301,82,42,21,21,16,1
16468,80,69,60301,82,56,18,38,36,13
16469,83,69,60301,66,37,11,26,18,8
16470,86,69,60301,60,28,10,18,16,1
16471,86,63,60301,21,6,2,4,4,-2
16472,11,83,70978,3,0,0,0,12,0
16473,35,89,37600,8,0,0,0,0,-1
16474,38,89,37600,4,0,0,0,2,1
16475,41,73,37600,1,0,0,0,0,0
16476,71,89,34789,17,9,3,6,6,-2
16477,74,89,34789,80,37,11,26,24,10
16358,80,74,10707,65,20,8,12,32,2
16359,83,20120,10707,63,11,9,2,14,-11
16482,68,74,30699,1,0,0,0,0,0
16483,71,75,30699,2,0,0,0,0,-1
16484,74,75,30699,18,1,1,0,7,-2
16485,77,75,30699,5,2,0,2,2,1
16486,77,87,30699,1,0,0,0,0,0
16487,71,72,20715,52,11,2,9,12,-3
16488,74,72,20715,66,14,2,12,24,-14
16489,77,72,20715,47,5,1,4,28,-15
16490,80,72,20715,51,6,1,5,24,-9
16491,83,20120,20715,34,3,1,2,22,7
16492,86,20120,20715,57,15,3,12,53,16
16493,35,77,9381,7,0,0,0,2,4
16494,38,77,9381,6,0,0,0,2,-1
16495,38,66,9381,18,7,2,5,12,-3
16496,41,66,9381,35,2,0,2,31,-7
16497,47,1479,9381,1,1,1,0,0,1
16499,65,66,20710,66,22,8,14,29,-16
16500,68,66,20710,38,15,5,10,15,1
16501,71,66,20710,76,32,5,27,37,-9
16502,74,66,20710,82,49,15,34,30,-19
16503,77,66,20710,64,37,16,21,27,-22
16504,80,66,20710,75,37,17,20,32,-18
16505,83,66,20710,76,31,8,23,48,-26
16506,86,66,20710,82,35,11,24,47,9
16507,71,76,75050,72,26,14,12,12,-10
16508,74,76,75050,82,42,20,22,24,6
16509,77,76,75050,81,40,26,14,30,-3
16510,80,76,75050,81,45,20,25,36,-6
16511,83,76,75050,82,35,19,16,43,-4
16512,86,76,75050,82,53,25,28,28,20
16513,41,79,10999,3,3,2,1,0,-1
16514,47,79,10999,13,1,0,1,0,-5
16516,41,78,10214,1,0,0,0,0,-2
16517,47,83,10214,7,4,3,1,4,2
16518,50,83,10214,74,29,13,16,10,-4
16519,53,83,10214,33,5,1,4,10,-4
16520,65,1479,32739,49,13,7,6,16,-7
16521,68,1479,32739,7,0,0,0,0,-4
16522,71,1479,32739,19,10,2,8,2,5
16523,74,1479,32739,54,17,5,12,12,1
16524,74,75,32739,20,3,1,2,12,-2
16525,77,75,32739,46,12,6,6,22,-2
16526,77,72,32739,18,13,8,5,8,-1
16527,80,72,32739,53,9,4,5,12,-19
16528,83,89,32739,75,16,7,9,38,-6
16529,86,89,32739,54,8,4,4,15,-6
16530,68,68,32790,6,0,0,0,25,-8
16531,71,68,32790,7,1,0,1,8,3
16533,77,68,32790,66,17,2,15,90,17
16534,80,68,32790,49,14,1,13,79,-1
16535,83,68,32790,67,13,2,11,98,-2
16536,86,68,32790,26,1,0,1,24,-8
16537,86,71,32790,9,1,0,1,2,-7
16538,68,68,40276,11,1,1,0,2,-8
16539,71,68,40276,76,38,16,22,16,-14
16540,74,68,40276,72,43,24,19,38,-7
16541,77,68,40276,67,34,15,19,41,-8
16542,80,68,40276,54,14,7,7,22,-19
16543,83,68,40276,82,49,19,30,41,5
16544,86,68,40276,32,12,5,7,16,2
16545,86,79,40276,32,14,9,5,14,4
16546,68,79,46992,26,14,3,11,6,7
16547,71,79,46992,21,7,3,4,0,-2
16548,74,79,46992,49,12,4,8,16,-1
16550,80,72,46992,65,19,8,11,20,-3
16551,83,78,46992,6,0,0,0,0,-2
16552,77,68,22096,3,0,0,0,0,-1
16553,74,74,40256,79,45,17,28,22,15
16554,77,74,40256,79,36,14,22,30,4
16555,80,74,40256,76,49,17,32,18,10
16556,83,74,40256,76,44,25,19,18,1
16557,86,74,40256,51,42,14,28,10,1
16558,86,547,40256,20,13,5,8,2,-3
16560,74,87,19437,27,4,2,2,10,-7
16561,77,64,19437,26,1,0,1,8,-3
16562,68,78,24783,38,19,8,11,10,1
16563,71,78,24783,64,43,21,22,16,20
16564,74,78,24783,77,73,37,36,31,27
16565,77,78,24783,80,74,40,34,37,7
16566,80,78,24783,82,75,39,36,12,-1
16568,86,78,24783,76,68,33,35,22,8
16569,68,73,33764,6,1,1,0,0,-2
16570,77,73,33764,57,10,3,7,32,-4
16571,80,73,33764,77,17,5,12,99,14
16572,83,73,33764,76,19,14,5,123,2
16573,86,73,33764,37,16,7,9,39,11
16574,74,64,15385,13,2,1,1,0,-1
16575,65,78,33926,7,3,2,1,0,1
16576,68,78,33926,45,13,7,6,4,-4
16577,71,78,33926,80,56,25,31,27,28
16578,74,78,33926,75,63,28,35,16,13
16579,77,78,33926,33,22,8,14,8,8
16580,80,78,33926,78,55,19,36,18,14
16581,83,78,33926,62,59,24,35,26,15
16582,86,78,33926,69,36,11,25,16,-6
16583,68,68,31285,18,0,0,0,2,-11
16585,77,68,31285,58,11,6,5,18,-1
16586,80,547,31285,5,0,0,0,0,1
16587,68,1479,20712,38,10,3,7,9,7
16588,71,1479,20712,29,11,7,4,4,3
16589,74,1479,20712,45,10,5,5,4,-6
16590,77,74,20712,19,3,0,3,2,-4
16591,77,84,20712,39,12,7,5,9,-8
16592,80,1479,20712,3,0,0,0,2,1
16593,47,1479,13776,1,0,0,0,21,0
16594,59,76,13776,14,1,0,1,75,-2
16595,62,76,13776,39,2,2,0,165,-3
16596,65,76,13776,3,0,0,0,0,-1
16597,29,77,9137,27,2,1,1,8,1
16598,32,73,9137,34,11,3,8,14,7
16479,80,89,34789,82,59,19,40,46,18
16480,83,89,34789,79,83,27,56,48,3
16603,50,79,9137,35,3,0,3,16,-6
16604,53,79,9137,36,3,0,3,4,6
16605,56,79,9137,68,9,4,5,36,3
16606,59,79,9137,79,16,3,13,26,5
16607,62,76,9137,34,3,0,3,8,-2
16608,65,76,9137,62,4,1,3,10,-17
16609,68,79,9137,23,0,0,0,4,9
16610,65,85,33939,1,0,0,0,4,0
16611,68,85,33939,1,0,0,0,0,0
16612,71,85,33939,42,24,9,15,6,8
16613,74,85,33939,79,36,13,23,16,-3
16614,77,85,33939,81,25,14,11,12,-8
16615,80,85,33939,80,13,2,11,14,-29
16616,83,85,33939,8,0,0,0,4,0
16617,83,79,33939,73,32,11,21,4,4
16618,86,79,33939,49,9,7,2,13,-7
16620,71,83,4316,1,0,0,0,0,0
16621,74,83,4316,7,0,0,0,6,1
16622,77,73,4316,27,2,0,2,13,1
16623,80,73,4316,10,0,0,0,10,0
16624,14,74,67044,18,2,1,1,62,0
16625,17,74,67044,64,11,7,4,175,2
16626,20,74,67044,60,9,3,6,195,-1
16627,23,74,67044,70,6,3,3,197,0
16628,26,74,67044,44,0,0,0,80,-3
16629,29,74,67044,21,1,0,1,26,-2
16630,32,66,67044,54,2,0,2,94,-4
16631,35,66,67044,58,3,2,1,106,2
16632,38,66,67044,9,0,0,0,16,0
16633,38,84,67044,45,1,0,1,143,-2
16634,41,75,67044,64,3,0,3,135,-2
16635,47,72,67044,14,1,0,1,22,-3
16637,71,77,37584,18,5,4,1,4,-1
16638,74,86,37584,33,5,1,4,11,1
16639,74,87,37584,18,2,1,1,10,-1
16640,77,81,37584,2,0,0,0,0,0
16641,26,73,43824,2,0,0,0,2,-1
16642,35,65,43824,4,1,0,1,0,-1
16643,59,71,11550,13,0,0,0,41,-3
16644,74,1479,39440,9,0,0,0,2,-2
16645,77,1479,39440,11,0,0,0,17,-2
16646,77,64,39440,26,4,4,0,9,-2
16647,77,1479,39440,6,2,0,2,2,2
16648,80,1479,39440,43,7,6,1,6,2
16649,83,1479,39440,64,15,6,9,35,-7
16650,83,76,39440,15,1,1,0,2,-3
16651,86,63,39440,76,19,12,7,51,3
16652,77,75,37293,3,0,0,0,2,0
16654,65,66,23669,64,44,20,24,56,-8
16655,68,66,23669,42,24,13,11,26,-21
16656,71,66,23669,71,54,33,21,22,-14
16657,74,66,23669,77,31,18,13,18,-24
16658,77,66,23669,82,51,28,23,38,-2
16659,80,66,23669,79,63,37,26,28,-3
16660,83,66,23669,82,49,24,25,34,-27
16661,86,67,23669,82,63,40,23,36,0
16662,77,83,75103,16,6,4,2,18,0
16663,80,83,75103,82,28,10,18,30,2
16664,83,83,75103,82,40,15,25,37,22
16665,86,83,75103,71,41,21,20,65,16
16666,41,70,12757,4,0,0,0,0,-2
16668,65,547,22925,76,28,13,15,42,4
16669,68,547,22925,44,10,4,6,14,0
16670,77,547,22925,81,21,7,14,32,-11
16672,80,87,22925,26,14,5,9,6,-1
16673,83,84,22925,24,6,2,4,12,-5
16674,65,68,31291,72,8,2,6,78,-19
16675,68,68,31291,32,4,0,4,47,-22
16676,71,68,31291,65,9,3,6,114,-7
16677,74,68,31291,76,13,4,9,58,-4
16678,77,68,31291,64,9,2,7,49,3
16679,80,84,31291,30,6,1,5,18,-14
16680,83,84,31291,52,5,2,3,35,-7
16681,86,84,31291,57,8,2,6,83,-27
16682,86,79,31291,19,2,0,2,4,7
16683,62,71,14355,65,42,22,20,27,-9
16684,65,71,14355,61,53,27,26,36,-3
16685,68,71,14355,45,50,16,34,33,5
16686,71,71,14355,75,80,27,53,44,-15
16687,74,71,14355,53,38,14,24,40,-1
16689,80,72,14355,72,53,20,33,32,-9
16690,83,72,14355,76,93,39,54,34,14
16691,86,72,14355,33,37,11,26,16,-6
16692,65,81,24254,68,15,4,11,30,-9
16693,68,81,24254,5,1,1,0,0,-3
16694,71,81,24254,11,1,1,0,4,-5
16695,74,81,24254,50,15,12,3,38,4
16696,74,63,24254,5,2,0,2,10,-1
16697,77,63,24254,71,25,9,16,20,-1
16698,80,89,24254,66,23,15,8,40,20
16699,83,89,24254,70,27,15,12,30,-6
16700,86,89,24254,81,46,22,24,24,13
16702,26,78,11482,29,4,0,4,19,3
16703,29,78,11482,15,2,1,1,10,-3
16704,32,84,11482,20,6,2,4,18,0
16705,35,84,11482,40,10,5,5,53,10
16708,56,89,11482,12,3,0,3,2,-1
16709,62,63,23813,74,22,11,11,18,-4
16710,65,63,23813,81,67,29,38,30,34
16711,68,63,23813,48,32,16,16,16,23
16712,71,70,23813,80,84,37,47,18,16
16713,74,70,23813,71,77,37,40,20,-1
16714,77,70,23813,72,73,33,40,16,2
16715,80,70,23813,82,72,26,46,22,-15
16716,83,70,23813,82,78,40,38,43,12
16717,86,70,23813,82,80,33,47,18,17
16718,71,74,37188,2,0,0,0,7,-1
16719,74,74,37188,1,0,0,0,9,0
16720,77,74,37188,34,4,2,2,64,7
16721,80,74,37188,1,0,0,0,4,0
16600,38,73,9137,50,9,2,7,22,1
16601,41,73,9137,75,13,4,9,26,16
16726,14,77,39298,8,2,1,1,6,-2
16727,17,77,39298,5,3,1,2,9,1
16728,32,86,39298,28,7,1,6,19,-1
16729,35,70,39298,8,2,0,2,0,-1
16730,38,70,39298,1,0,0,0,0,0
16731,68,67,23150,19,5,1,4,0,-7
16732,71,67,23150,44,7,1,6,16,-11
16733,74,67,23150,7,3,2,1,2,4
16734,77,67,23150,55,11,1,10,32,-1
16735,80,68,23150,82,17,4,13,10,0
16736,83,68,23150,82,16,3,13,20,-8
16737,86,68,23150,70,11,1,10,26,-1
16738,26,67,45511,1,0,0,0,0,-1
16741,62,76,17676,9,2,1,1,8,-1
16742,65,76,17676,55,1,1,0,12,-29
16743,71,69,17676,81,36,14,22,44,12
16745,77,69,17676,82,43,20,23,36,9
16746,80,69,17676,82,57,25,32,53,17
16747,83,69,17676,63,32,18,14,36,14
16748,86,69,17676,46,23,9,14,10,-11
16749,86,66,17676,36,30,14,16,20,7
16750,2,75,8872,69,30,10,20,63,7
16751,5,75,8872,78,32,8,24,72,10
16752,8,75,8872,60,44,13,31,91,8
16753,11,75,8872,75,52,20,32,62,15
16754,14,75,8872,30,20,5,15,49,-3
16755,14,76,8872,13,9,3,6,30,-5
16756,17,76,8872,65,47,11,36,93,-18
16757,17,83,8872,13,7,2,5,10,-2
16758,20,83,8872,26,12,5,7,20,3
16759,23,83,8872,76,37,11,26,44,-12
16760,26,74,8872,75,34,10,24,71,-19
16762,32,88,8872,73,51,16,35,56,0
16763,35,88,8872,55,30,7,23,68,3
16764,38,88,8872,65,43,14,29,57,0
16765,38,85,8872,13,7,2,5,16,2
16766,41,85,8872,78,46,14,32,56,22
16767,47,85,8872,72,59,21,38,86,33
16768,50,85,8872,68,52,11,41,66,12
16769,53,1479,8872,65,39,12,27,50,22
16771,56,75,8872,23,17,5,12,14,-2
16772,59,84,8872,17,5,2,3,12,0
16774,68,75,20703,8,2,0,2,2,5
16775,71,75,20703,22,2,0,2,40,-2
16776,74,75,20703,13,2,0,2,19,-5
16777,77,75,20703,3,0,0,0,5,-3
16778,77,87,20703,7,0,0,0,12,-2
16779,20,81,39226,17,2,2,0,4,-4
16781,26,81,39226,20,3,2,1,0,-2
16782,71,85,16034,3,0,0,0,2,0
16783,74,85,16034,31,8,5,3,10,5
16784,77,85,16034,36,12,6,6,14,2
16785,80,69,16034,9,1,1,0,2,-1
16786,80,87,16034,4,1,1,0,4,-1
16787,68,69,16035,27,8,2,6,6,-4
16788,71,69,16035,63,41,8,33,22,-3
16789,74,69,16035,68,39,8,31,20,17
16790,77,69,16035,82,44,13,31,20,-12
16791,80,69,16035,81,69,26,43,12,23
16792,83,69,16035,77,67,21,46,18,13
16793,86,69,16035,63,49,15,34,20,-2
16794,86,73,16035,16,5,1,4,4,-6
16795,11,80,10644,84,51,20,31,40,-45
16796,14,80,10644,47,37,16,21,14,-22
16798,20,80,10644,82,51,26,25,33,-33
16799,23,80,10644,38,16,7,9,8,-7
16800,23,77,10644,37,26,9,17,6,-1
16801,26,77,10644,31,5,3,2,2,-1
16802,26,81,10644,32,12,6,6,2,-12
16803,29,74,10644,58,26,8,18,23,-5
16804,38,79,10644,33,7,4,3,8,-10
16805,41,69,10644,78,51,20,31,14,-4
16806,47,69,10644,46,28,5,23,12,-6
16809,17,78,8534,78,25,7,18,110,-18
16810,20,78,8534,79,35,11,24,143,15
16811,23,78,8534,81,36,9,27,180,47
16812,26,78,8534,67,46,13,33,113,3
16813,29,78,8534,79,62,14,48,92,52
16814,32,78,8534,51,47,8,39,75,21
16815,35,78,8534,78,47,7,40,120,23
16817,41,78,8534,80,54,14,40,88,-1
16818,47,71,8534,80,56,12,44,74,2
16819,50,1479,8534,66,59,13,46,69,27
16820,53,1479,8534,72,43,12,31,128,-1
16821,56,1479,8534,82,48,11,37,88,0
16822,59,77,8534,82,55,10,45,79,22
16823,62,77,8534,50,25,4,21,44,7
16824,65,77,8534,13,12,1,11,10,1
16825,11,81,9165,84,42,13,29,123,-25
16826,14,81,9165,46,27,7,20,89,-2
16827,17,81,9165,82,38,17,21,105,-13
16828,20,81,9165,82,62,30,32,201,-28
16829,23,77,9165,82,62,22,40,159,11
16830,26,77,9165,26,8,1,7,41,-8
16831,26,81,9165,52,26,7,19,102,-20
16832,29,81,9165,58,41,14,27,121,-24
16834,32,67,9165,82,40,19,21,102,0
16835,35,67,9165,82,39,15,24,75,0
16836,38,67,9165,66,44,15,29,86,-5
16839,41,64,9165,13,3,2,1,18,1
16840,47,68,9165,76,39,17,22,104,6
16841,50,68,9165,81,35,13,22,94,1
16842,53,81,9165,60,21,10,11,77,-7
16843,56,81,9165,18,2,0,2,10,-3
16844,56,82,9165,6,1,0,1,2,2
16845,11,68,8532,65,26,9,17,51,-11
16846,14,68,8532,48,10,4,6,36,-13
16847,17,68,8532,82,61,26,35,107,1
16848,20,68,8532,60,38,14,24,54,4
16849,23,68,8532,33,15,8,7,41,-9
16723,86,85,37188,7,0,0,0,4,2
16724,11,78,39298,67,20,6,14,44,-1
16854,38,62,8532,54,18,8,10,42,-13
16855,38,1479,8532,12,4,2,2,15,3
16856,41,1479,8532,55,28,12,16,34,-6
16857,47,1479,8532,76,39,15,24,89,-5
16858,50,1479,8532,82,16,5,11,77,-8
16859,53,1479,8532,78,16,8,8,54,1
16860,56,1479,8532,79,21,14,7,42,-17
16861,59,72,8532,71,22,10,12,45,3
16862,62,67,8532,71,19,5,14,22,-8
16863,14,86,8695,16,2,2,0,2,-5
16864,17,86,8695,62,19,6,13,6,-15
16865,20,86,8695,78,41,16,25,40,-16
16866,23,86,8695,18,7,5,2,2,-2
16867,23,68,8695,46,23,12,11,14,-1
16868,26,68,8695,65,51,16,35,24,13
16869,29,68,8695,80,70,17,53,16,24
16871,35,68,8695,50,27,9,18,20,-16
16872,38,68,8695,74,56,22,34,18,-8
16873,41,68,8695,48,27,11,16,16,-4
16874,41,72,8695,11,6,2,4,2,0
16875,47,72,8695,69,25,12,13,16,0
16876,50,76,8695,81,51,25,26,28,12
16877,53,89,8695,81,54,16,38,18,28
16878,56,89,8695,67,41,13,28,16,-9
16879,11,71,9062,78,68,33,35,104,1
16880,14,71,9062,42,37,15,22,128,-14
16881,17,71,9062,64,59,28,31,87,-6
16882,20,71,9062,67,57,19,38,92,-21
16883,23,71,9062,35,18,5,13,78,-16
16884,23,72,9062,35,15,5,10,21,-8
16885,26,72,9062,74,54,27,27,79,10
16886,29,72,9062,76,56,22,34,51,22
16888,35,72,9062,63,41,22,19,59,3
16889,35,70,9062,10,4,3,1,6,-1
16890,38,70,9062,72,47,23,24,51,9
16891,41,70,9062,73,57,21,36,66,23
16892,47,70,9062,81,76,32,44,102,13
16893,50,73,9062,68,54,27,27,48,15
16894,53,73,9062,79,72,28,44,54,19
16895,56,73,9062,65,57,33,24,49,2
16896,59,73,9062,63,46,19,27,26,0
16897,62,72,9062,62,24,13,11,32,-9
16898,62,89,9062,11,7,4,3,8,3
16899,65,78,9062,72,34,17,17,26,13
16900,17,74,119799,82,21,9,12,14,2
16901,20,74,119799,82,52,24,28,20,23
16902,23,74,119799,70,47,19,28,24,0
16903,26,74,119799,81,43,13,30,20,-2
16905,32,86,119799,82,49,10,39,28,10
16906,35,86,119799,73,39,9,30,50,7
16907,38,86,119799,47,12,2,10,22,-4
16908,38,75,119799,33,14,5,9,8,3
16909,41,75,119799,66,20,8,12,18,3
16910,47,75,119799,55,15,6,9,30,-6
16911,14,70,9042,40,20,11,9,67,-3
16912,17,70,9042,69,29,9,20,136,-13
16913,20,70,9042,71,31,9,22,142,19
16914,23,70,9042,59,19,9,10,104,5
16915,26,74,9042,37,28,11,17,72,-1
16916,29,74,9042,31,6,3,3,62,-9
16917,29,86,9042,40,12,8,4,78,-2
16918,32,86,9042,69,21,10,11,72,6
16919,35,86,9042,69,22,9,13,73,16
16920,38,86,9042,76,19,3,16,74,5
16922,47,71,9042,63,7,5,2,32,-7
16923,17,89,8827,48,5,2,3,85,-4
16924,20,89,8827,44,5,3,2,88,-20
16925,23,89,8827,64,8,1,7,112,-11
16926,26,89,8827,54,7,2,5,87,-6
16927,29,89,8827,77,8,1,7,114,5
16928,32,89,8827,72,6,3,3,101,2
16929,35,89,8827,68,10,3,7,78,-1
16930,38,89,8827,69,11,2,9,106,12
16931,41,89,8827,72,12,2,10,123,-22
16932,47,89,8827,58,11,1,10,141,-5
16933,47,73,8827,17,3,0,3,68,5
16934,50,76,8827,81,14,1,13,131,14
16935,53,76,8827,59,7,2,5,51,-8
16936,56,76,8827,65,9,0,9,94,-34
16937,59,76,8827,42,5,2,3,45,-18
16939,17,83,629178,50,26,4,22,22,12
16940,17,76,629178,16,4,0,4,10,-5
16941,20,76,629178,81,21,3,18,24,10
16942,23,76,629178,81,40,14,26,58,-2
16943,26,76,629178,63,26,8,18,34,-18
16944,29,76,629178,65,25,1,24,32,-15
16945,32,76,629178,65,29,8,21,30,-22
16946,35,76,629178,76,32,10,22,26,15
16947,38,76,629178,71,26,8,18,24,-8
16948,41,76,629178,79,29,5,24,22,25
16949,17,72,10192,10,4,3,1,0,-1
16950,20,72,10192,70,32,12,20,62,7
16951,23,72,10192,80,28,15,13,97,-6
16952,26,72,10192,76,23,11,12,66,-10
16953,29,72,10192,35,6,3,3,16,-7
16954,29,84,10192,12,5,3,2,2,1
16956,35,84,10192,29,6,1,5,31,-2
16958,38,73,10192,43,10,4,6,39,2
16959,74,89,24625,2,1,1,0,0,1
16960,77,89,24625,24,3,0,3,4,2
16961,20,71,635544,69,25,11,14,12,-7
16962,23,71,635544,82,26,13,13,42,0
16963,26,71,635544,48,17,5,12,22,4
16964,26,76,635544,12,8,5,3,2,2
16965,29,76,635544,43,16,9,7,24,0
16966,32,76,635544,20,7,3,4,10,4
16967,35,76,635544,59,15,3,12,16,0
16968,38,84,635544,54,14,5,9,18,-2
16970,17,64,21310,78,48,21,27,142,20
16971,20,64,21310,78,60,33,27,136,8
16851,29,68,8532,81,33,10,23,46,-5
16852,32,68,8532,67,32,12,20,50,-12
16976,32,88,21310,18,6,4,2,4,3
16977,35,88,21310,76,62,29,33,71,8
16978,38,88,21310,20,17,13,4,21,2
16979,11,89,9060,2,1,0,1,0,1
16980,14,89,9060,12,3,2,1,6,-3
16981,17,89,9060,19,3,0,3,2,-3
16982,20,89,9060,53,22,5,17,25,-3
16983,20,63,9060,19,12,3,9,9,-3
16984,23,63,9060,81,83,33,50,60,33
16985,26,63,9060,82,76,23,53,68,5
16986,29,63,9060,37,28,10,18,20,5
16987,32,63,9060,82,95,36,59,85,-8
16988,35,88,9060,73,74,19,55,68,2
16989,38,88,9060,26,28,6,22,22,9
16990,47,83,9060,66,60,17,43,76,-18
16991,17,64,10831,7,1,1,0,6,3
16993,20,63,10831,40,17,7,10,49,-6
16994,23,63,10831,28,6,1,5,7,3
16995,26,63,10831,22,6,3,3,17,0
16996,29,63,10831,40,4,1,3,18,-6
17001,41,79,10831,19,6,5,1,31,0
17002,56,70,10831,27,8,2,6,21,5
17003,17,75,2668,82,45,20,25,40,-7
17004,20,75,2668,50,56,17,39,38,7
17005,23,75,2668,69,57,14,43,48,8
17006,26,75,2668,65,44,14,30,38,-7
17007,29,75,2668,24,21,3,18,14,7
17008,32,75,2668,54,47,17,30,40,2
17009,35,75,2668,3,2,0,2,0,0
17010,38,75,2668,82,71,21,50,72,5
17011,41,75,2668,68,55,14,41,52,-5
17012,47,75,2668,72,62,17,45,70,1
17014,53,75,2668,77,56,16,40,93,-4
17015,56,75,2668,65,50,16,34,44,4
17016,59,1479,2668,71,52,19,33,36,14
17017,62,1479,2668,75,45,15,30,36,-8
17018,65,1479,2668,74,38,11,27,50,7
17019,68,1479,2668,47,27,8,19,18,4
17020,71,1479,2668,65,29,11,18,46,3
17021,17,85,567,1,0,0,0,2,1
17022,20,85,567,23,6,0,6,10,5
17023,23,85,567,66,21,7,14,32,21
17024,26,85,567,61,12,2,10,34,5
17025,26,65,567,11,8,0,8,0,6
17026,29,65,567,73,28,3,25,20,4
17027,32,65,567,13,5,2,3,2,-4
17028,32,68,567,60,21,0,21,28,2
17029,35,83,567,34,2,0,2,12,-1
17031,41,82,567,66,27,7,20,18,-6
17032,50,82,567,79,23,0,23,46,12
17033,53,62,567,61,18,1,17,36,-5
17035,59,74,567,8,2,0,2,0,2
17036,17,76,9077,76,39,18,21,83,-14
17037,20,76,9077,64,23,10,13,68,-3
17038,23,76,9077,52,18,7,11,58,-19
17039,23,84,9077,22,15,6,9,63,2
17040,26,84,9077,32,16,8,8,44,-6
17041,29,84,9077,80,50,25,25,126,-2
17042,32,84,9077,79,55,25,30,93,-18
17043,35,84,9077,72,85,36,49,110,21
17044,38,84,9077,82,97,46,51,144,2
17045,41,84,9077,69,60,17,43,122,21
17046,47,84,9077,82,71,25,46,120,-17
17047,50,68,9077,7,7,1,6,13,-4
17049,53,1479,9077,68,40,14,26,97,8
17050,56,62,9077,66,44,15,29,74,-13
17051,59,85,9077,82,44,18,26,80,-7
17052,62,85,9077,81,45,16,29,71,-7
17053,65,85,9077,71,38,14,24,64,23
17054,68,85,9077,7,3,2,1,2,3
17055,71,85,9077,59,16,9,7,40,-17
17056,74,66,13663,3,0,0,0,2,0
17057,23,83,8740,5,0,0,0,7,0
17058,26,83,8740,1,0,0,0,0,0
17059,29,83,8740,52,13,5,8,39,-7
17060,32,82,8740,66,20,8,12,52,-4
17061,32,68,8740,12,9,3,6,2,7
17062,35,68,8740,44,12,4,8,28,-3
17063,35,66,8740,33,5,2,3,15,-2
17064,38,66,8740,77,18,9,9,57,-8
17066,47,66,8740,82,23,15,8,36,0
17067,50,66,8740,35,4,2,2,17,-10
17069,53,65,8740,27,2,0,2,13,-7
17070,17,79,25553,2,0,0,0,2,0
17071,20,79,25553,5,0,0,0,7,-1
17072,77,79,17637,42,15,5,10,24,3
17073,80,79,17637,57,16,4,12,18,8
17074,83,79,17637,69,8,2,6,6,-6
17075,86,76,17637,36,9,4,5,10,1
17076,17,67,8472,58,12,4,8,41,13
17077,20,67,8472,77,11,2,9,51,13
17078,23,67,8472,66,8,4,4,48,13
17079,26,67,8472,30,3,1,2,47,10
17080,26,68,8472,4,0,0,0,0,2
17081,29,68,8472,60,20,4,16,35,10
17082,32,68,8472,19,1,0,1,25,-7
17084,38,74,8472,1,0,0,0,0,1
17085,14,86,8566,14,0,0,0,6,-6
17086,17,86,8566,74,21,13,8,39,-17
17087,20,86,8566,73,15,9,6,42,-18
17088,23,86,8566,20,6,3,3,22,3
17089,23,64,8566,47,12,5,7,48,3
17090,26,64,8566,68,19,7,12,37,4
17091,29,64,8566,18,1,1,0,8,-4
17095,35,79,8566,13,3,2,1,4,-5
17096,38,79,8566,52,9,4,5,30,-6
17097,38,62,8566,13,3,1,2,7,-2
17098,41,62,8566,82,42,18,24,72,14
17099,47,62,8566,80,20,9,11,82,9
17100,50,63,8566,76,17,6,11,56,-13
16973,26,64,21310,66,49,22,27,99,-2
16974,29,64,21310,71,45,18,27,106,-10
17105,20,80,23862,21,1,0,1,8,-4
17106,23,80,23862,1,0,0,0,0,0
17107,26,80,23862,7,0,0,0,4,-1
17108,26,65,23862,7,0,0,0,6,-3
17109,29,65,23862,11,3,0,3,4,7
17110,32,82,23862,9,2,0,2,6,1
17111,35,82,23862,60,6,1,5,34,-15
17112,2,89,78383,4,0,0,0,2,-2
17113,20,72,8701,46,14,6,8,6,-1
17114,23,72,8701,23,4,1,3,4,-4
17115,26,72,8701,70,27,14,13,10,3
17116,29,72,8701,71,15,7,8,4,0
17117,32,72,8701,63,16,4,12,16,3
17118,35,72,8701,65,14,4,10,15,12
17119,38,72,8701,68,17,6,11,23,12
17120,41,72,8701,82,26,13,13,14,5
17122,50,72,8701,82,27,13,14,8,-5
17123,53,72,8701,54,24,12,12,22,10
17124,56,72,8701,61,10,5,5,10,-12
17125,59,72,8701,52,9,4,5,6,-10
17126,65,76,8701,62,3,1,2,8,-14
17127,68,63,8701,18,0,0,0,2,-2
17128,14,70,8739,2,0,0,0,2,0
17129,17,70,8739,12,4,2,2,6,-2
17130,20,70,8739,76,39,13,26,51,-2
17131,23,70,8739,81,52,23,29,61,9
17132,26,70,8739,75,45,12,33,62,10
17133,29,70,8739,65,39,18,21,68,16
17134,32,70,8739,53,30,12,18,57,4
17135,35,70,8739,68,26,10,16,54,-11
17136,35,72,8739,14,6,3,3,23,2
17137,38,72,8739,78,55,22,33,65,17
17139,47,72,8739,80,53,19,34,74,-1
17140,50,72,8739,82,60,23,37,64,-9
17141,53,72,8739,64,41,13,28,30,-1
17142,56,72,8739,81,69,29,40,56,25
17143,59,72,8739,81,61,19,42,44,6
17144,62,72,8739,31,14,4,10,16,-15
17145,62,70,8739,39,18,5,13,29,-3
17146,65,78,8739,70,24,6,18,32,7
17147,68,78,8739,4,1,0,1,0,1
17148,20,77,2654,77,44,4,40,58,12
17149,23,77,2654,66,34,3,31,56,6
17150,23,71,2654,11,9,1,8,6,7
17151,26,71,2654,81,28,4,24,88,7
17152,29,71,2654,81,33,8,25,89,14
17153,32,71,2654,82,46,12,34,90,6
17154,35,71,2654,81,44,5,39,80,13
17156,38,76,2654,13,6,1,5,14,-2
17157,41,76,2654,82,28,9,19,64,12
17158,47,76,2654,41,10,1,9,62,-7
17159,47,70,2654,22,6,2,4,24,-5
17160,50,75,2654,41,3,0,3,36,-13
17161,74,83,32729,16,2,1,1,9,1
17162,77,83,32729,3,0,0,0,4,-2
17163,86,1479,32729,6,1,0,1,2,-1
17164,71,62,75068,8,2,1,1,0,-2
17165,77,62,75068,2,0,0,0,0,-2
17166,80,78,75068,7,3,1,2,2,0
17167,83,63,75068,5,1,0,1,4,-1
17173,29,84,4317,12,9,2,7,10,4
17174,32,84,4317,82,54,16,38,42,2
17175,35,84,4317,82,67,23,44,26,18
17176,38,84,4317,82,71,25,46,36,18
17177,41,84,4317,82,60,22,38,50,16
17178,47,84,4317,82,56,19,37,84,-1
17179,50,84,4317,82,51,20,31,60,-9
17180,53,84,4317,39,25,9,16,18,-3
17181,56,1479,4317,62,22,10,12,16,0
17182,56,70,4317,19,9,6,3,16,3
17183,59,89,4317,74,42,12,30,40,23
17184,62,62,4317,66,43,9,34,16,13
17185,65,62,4317,28,11,4,7,6,-1
17186,65,65,4317,11,0,0,0,6,-4
17187,17,76,4723,82,23,7,16,156,-24
17188,20,76,4723,82,28,8,20,165,-2
17189,23,76,4723,56,12,3,9,145,9
17190,23,84,4723,26,12,1,11,64,10
17191,26,84,4723,69,21,7,14,120,-11
17192,29,65,4723,79,25,6,19,139,-8
17193,32,83,4723,82,29,5,24,123,16
17194,35,83,4723,82,43,17,26,129,16
17195,38,83,4723,75,24,6,18,135,9
17196,41,83,4723,75,53,16,37,86,22
17197,47,83,4723,73,68,19,49,116,-1
17198,50,83,4723,82,57,15,42,115,3
17199,53,83,4723,54,23,5,18,81,-2
17200,56,68,4723,69,39,15,24,41,-1
17201,59,68,4723,82,43,8,35,83,-4
17202,62,68,4723,48,22,5,17,28,3
17203,62,74,4723,19,6,2,4,6,-1
17204,71,63,17493,4,2,1,1,0,1
17205,11,67,68103,8,0,0,0,8,-1
17206,14,67,68103,4,0,0,0,4,-1
17207,14,88,68103,21,0,0,0,11,-2
17208,17,88,68103,18,6,1,5,22,0
17209,68,75,25715,44,28,15,13,33,10
17210,71,75,25715,81,41,19,22,73,4
17211,74,75,25715,82,47,24,23,31,18
17212,77,75,25715,53,40,19,21,24,13
17213,80,75,25715,64,29,10,19,39,7
17214,83,75,25715,82,54,31,23,34,-13
17215,86,75,25715,82,52,33,19,49,10
17216,11,86,22678,27,4,1,3,20,-6
17217,14,86,22678,14,2,0,2,16,-7
17218,17,86,22678,27,8,1,7,18,-17
17219,20,86,22678,35,8,2,6,12,-17
17220,23,72,22678,2,1,0,1,0,1
17102,56,80,8566,65,10,5,5,34,-2
17103,59,80,8566,30,5,2,3,40,-4
17225,32,73,9151,2,0,0,0,2,-2
17226,35,67,9151,5,0,0,0,4,-2
17227,38,67,9151,36,4,1,3,16,-7
17228,41,67,9151,60,11,4,7,44,-5
17229,47,67,9151,56,9,4,5,50,-18
17230,50,84,9151,58,7,1,6,46,12
17231,53,77,9151,19,1,0,1,11,-12
17232,20,83,1949,3,0,0,0,7,0
17233,71,74,10963,11,0,0,0,2,-5
17234,74,74,10963,58,14,6,8,8,-1
17235,77,74,10963,79,30,10,20,18,9
17236,80,74,10963,68,21,6,15,16,6
17237,83,74,10963,71,33,13,20,26,-10
17238,86,74,10963,66,20,8,12,26,-3
17239,32,63,12482,8,1,0,1,2,0
17240,35,63,12482,3,0,0,0,0,0
17242,41,76,12482,18,2,0,2,2,-2
17243,14,62,9059,1,0,0,0,0,0
17244,20,62,9059,20,0,0,0,35,-4
17245,23,62,9059,43,11,3,8,104,3
17246,26,65,9059,39,4,2,2,62,0
17247,29,65,9059,59,4,1,3,102,-5
17248,32,65,9059,44,4,1,3,53,7
17249,35,62,9059,37,2,0,2,24,-3
17250,35,82,9059,7,0,0,0,28,-4
17251,38,82,9059,48,1,0,1,99,-15
17252,41,73,9059,47,3,0,3,76,-7
17253,47,73,9059,20,1,0,1,45,-6
17254,47,68,9059,7,0,0,0,11,0
17255,20,79,10651,1,0,0,0,0,-1
17256,26,67,10651,3,0,0,0,2,0
17257,29,67,10651,7,1,1,0,6,1
17259,35,71,10651,22,6,0,6,8,-2
17260,38,73,10651,2,0,0,0,2,0
17261,41,67,10651,4,0,0,0,4,-1
17262,77,88,35694,5,0,0,0,0,0
17263,80,88,35694,49,7,1,6,6,3
17264,83,88,35694,16,3,0,3,2,-3
17265,86,71,35694,36,3,0,3,4,-2
17266,14,1479,35012,30,11,4,7,6,-4
17267,17,1479,35012,37,17,9,8,10,-1
17268,20,1479,35012,9,1,1,0,16,-2
17269,32,69,13516,3,0,0,0,0,-3
17270,41,1479,13516,4,1,0,1,0,-1
17271,17,86,1654,31,13,2,11,14,-7
17272,20,86,1654,28,5,2,3,0,-8
17273,26,73,1654,14,10,5,5,2,1
17274,29,73,1654,79,28,6,22,22,-1
17276,50,68,1654,72,37,17,20,28,7
17277,53,68,1654,56,20,5,15,20,-2
17278,56,68,1654,79,31,12,19,31,6
17279,11,71,4076,5,0,0,0,2,-8
17280,23,74,19099,6,1,0,1,2,1
17281,26,79,19099,51,7,4,3,14,-8
17283,32,81,19099,25,5,0,5,8,-5
17284,17,79,68733,71,14,7,7,130,-5
17285,20,79,68733,61,10,5,5,155,-13
17286,26,62,68733,36,6,3,3,44,-1
17287,29,62,68733,2,0,0,0,5,-1
17288,35,76,68733,1,0,0,0,0,0
17289,17,78,8929,3,0,0,0,2,-1
17290,20,78,8929,15,7,2,5,6,-4
17291,23,78,8929,59,6,2,4,36,5
17292,26,78,8929,76,7,2,5,47,-3
17294,32,80,8929,45,6,2,4,44,6
17295,35,80,8929,2,0,0,0,4,-3
17296,35,63,8929,64,6,4,2,45,6
17297,38,68,8929,1,0,0,0,2,-2
17298,41,85,8929,50,7,3,4,41,9
17299,47,85,8929,15,1,0,1,12,0
17301,50,78,8929,31,4,1,3,36,-7
17302,11,68,67300,67,11,4,7,156,-1
17303,14,68,67300,9,2,1,1,37,-3
17304,14,76,67300,19,4,1,3,34,1
17305,17,76,67300,65,9,1,8,180,3
17306,20,64,67300,66,5,1,4,193,-6
17307,23,1479,67300,37,4,1,3,133,-3
17308,26,70,67300,30,3,1,2,50,-2
17309,20,72,2656,1,0,0,0,5,-1
17310,23,72,2656,73,5,2,3,295,3
17312,29,72,2656,69,16,6,10,184,-2
17313,32,82,2656,10,2,0,2,34,1
17314,32,79,2656,26,3,1,2,131,-4
17315,35,79,2656,57,2,0,2,150,-5
17316,38,74,2656,9,0,0,0,51,1
17317,38,63,2656,33,0,0,0,110,-4
17318,41,62,2656,65,5,3,2,247,-8
17319,47,72,2656,3,0,0,0,0,-2
17320,23,76,19680,2,2,0,2,0,-1
17321,26,76,19680,8,0,0,0,12,6
17322,29,76,19680,17,2,1,1,8,-3
17323,32,78,19680,22,3,1,2,26,5
17324,35,65,19680,13,2,0,2,6,0
17325,74,71,45541,12,1,1,0,0,-5
17326,77,71,45541,51,11,4,7,20,7
17327,80,71,45541,28,1,0,1,16,1
17329,83,75,45541,13,1,0,1,9,-3
17330,83,71,45541,23,4,3,1,10,-2
17331,83,76,45541,15,2,1,1,4,-8
17332,86,65,45541,10,1,0,1,15,-4
17333,2,71,42297,57,31,15,16,26,17
17334,5,71,42297,59,42,20,22,16,12
17335,8,81,42297,13,5,2,3,4,-5
17336,8,84,42297,62,44,10,34,28,21
17337,11,1479,42297,49,30,11,19,12,-4
17338,14,1479,42297,15,7,3,4,4,-10
17339,14,77,42297,26,3,1,2,6,-2
17340,17,77,42297,44,16,3,13,14,3
17341,17,1479,42297,12,10,1,9,10,-4
17342,20,67,42297,25,6,2,4,2,-3
17222,20,75,9151,6,1,0,1,6,-2
17223,20,78,9151,2,0,0,0,2,-2
17347,26,89,17838,4,1,0,1,2,-4
17348,35,89,17838,2,0,0,0,2,-1
17349,38,85,17838,25,8,2,6,14,8
17350,41,79,17838,16,7,3,4,8,-16
17351,20,77,8636,18,15,5,10,4,3
17352,23,77,8636,41,18,5,13,17,-10
17353,23,80,8636,15,7,1,6,4,-1
17354,26,80,8636,79,36,10,26,58,8
17355,29,80,8636,79,55,22,33,40,-2
17356,32,80,8636,40,13,1,12,12,1
17357,32,68,8636,34,16,4,12,10,-2
17358,35,81,8636,81,55,18,37,38,-11
17359,38,81,8636,80,79,22,57,53,9
17360,41,1479,8636,82,54,19,35,54,-9
17361,47,81,8636,81,80,25,55,50,-3
17362,50,81,8636,82,55,14,41,36,-24
17364,53,77,8636,18,14,4,10,6,7
17365,56,81,8636,82,45,19,26,52,-20
17366,59,74,8636,75,58,20,38,32,8
17367,62,74,8636,29,23,9,14,8,4
17368,65,82,8636,82,55,16,39,36,-11
17369,68,82,8636,48,30,12,18,32,3
17373,26,66,1904,52,11,2,9,36,-6
17374,29,66,1904,57,14,4,10,63,13
17375,32,66,1904,61,20,6,14,34,-4
17376,35,66,1904,82,23,4,19,88,8
17377,38,66,1904,10,2,0,2,16,-3
17378,38,84,1904,69,18,7,11,52,23
17379,41,84,1904,78,19,3,16,45,35
17380,47,74,1904,74,18,2,16,78,28
17381,50,74,1904,69,21,2,19,70,32
17382,53,74,1904,42,10,2,8,48,7
17384,2,72,8688,75,66,29,37,141,4
17385,5,78,8688,80,69,33,36,171,-3
17386,8,78,8688,71,94,51,43,174,10
17387,11,78,8688,81,102,52,50,211,-9
17388,14,78,8688,45,41,20,21,136,7
17391,20,85,8688,79,87,46,41,131,31
17392,23,85,8688,75,57,28,29,154,6
17393,26,85,8688,81,58,31,27,123,2
17394,29,85,8688,78,78,41,37,105,24
17395,32,85,8688,81,76,31,45,81,9
17396,35,85,8688,80,75,37,38,118,23
17397,38,85,8688,78,68,30,38,103,5
17398,41,85,8688,82,53,25,28,117,15
17399,47,85,8688,82,81,40,41,105,29
17400,50,74,8688,67,62,29,33,47,2
17401,53,74,8688,73,46,23,23,35,-2
17403,17,75,10818,4,0,0,0,0,-1
17404,20,75,10818,28,11,2,9,2,-3
17405,23,75,10818,53,14,6,8,36,5
17406,26,73,10818,72,40,16,24,26,-14
17407,29,73,10818,60,23,10,13,30,-12
17408,32,73,10818,14,5,2,3,14,-4
17409,35,69,10818,14,5,1,4,8,-1
17413,8,80,70240,81,41,7,34,34,-47
17414,11,80,70240,66,23,4,19,59,-41
17415,14,80,70240,2,0,0,0,0,3
17416,26,89,70240,4,0,0,0,4,0
17417,26,78,70240,12,0,0,0,4,0
17418,11,77,32143,8,2,1,1,4,-4
17419,14,1479,32143,25,10,2,8,14,4
17420,17,1479,32143,16,4,2,2,24,-12
17421,17,68,13519,1,1,0,1,0,1
17423,23,68,13519,58,19,11,8,32,-6
17424,26,68,13519,4,0,0,0,4,-1
17425,26,84,13519,8,0,0,0,2,0
17426,29,77,13519,1,0,0,0,0,0
17427,32,77,13519,3,0,0,0,0,0
17428,23,65,70328,1,0,0,0,0,0
17429,17,78,76938,1,0,0,0,0,-1
17430,20,78,76938,3,0,0,0,2,-1
17431,71,86,31582,11,0,0,0,2,-5
17432,74,86,31582,1,0,0,0,0,-1
17433,74,64,31582,17,1,1,0,0,-1
17434,77,62,31582,4,2,1,1,0,1
17435,80,62,31582,26,2,2,0,8,-3
17436,83,62,31582,8,1,0,1,2,-1
17437,83,87,31582,8,0,0,0,0,1
17438,17,88,9297,2,0,0,0,6,0
17440,2,74,67704,77,12,2,10,89,8
17441,5,74,67704,10,1,0,1,15,1
17442,5,71,67704,12,2,1,1,8,-8
17444,8,63,67704,77,24,10,14,108,10
17445,11,63,67704,55,10,1,9,85,-11
17446,14,63,67704,44,7,3,4,36,-9
17447,17,81,67704,66,12,1,11,64,5
17448,20,81,67704,57,11,1,10,72,1
17449,23,81,67704,14,2,0,2,12,-2
17450,47,63,11568,2,0,0,0,2,0
17451,68,73,16054,2,1,0,1,0,-1
17452,5,62,31270,35,3,1,2,119,-7
17453,74,70,24076,1,0,0,0,0,0
17454,20,78,5370,6,1,0,1,2,-3
17455,26,78,5370,34,9,4,5,40,-3
17456,29,78,5370,79,17,7,10,90,0
17458,35,78,5370,77,17,9,8,99,9
17459,38,78,5370,15,7,2,5,8,1
17460,41,78,5370,80,11,6,5,91,-19
17461,47,78,5370,67,26,15,11,129,-22
17462,50,78,5370,80,22,8,14,89,-19
17463,53,78,5370,80,27,12,15,91,-19
17464,56,83,5370,71,16,7,9,82,-7
17465,59,83,5370,44,8,2,6,78,-5
17466,59,62,5370,27,6,1,5,53,2
17467,62,86,5370,78,14,3,11,124,3
17468,65,65,5370,81,15,6,9,91,-4
17469,68,65,5370,19,2,0,2,16,2
17470,14,65,9126,4,2,1,1,2,2
17471,17,65,9126,80,53,30,23,18,16
17344,14,63,67696,1,0,0,0,0,1
17345,26,79,67696,26,6,0,6,16,-4
17489,2,83,34936,23,18,8,10,10,2
17490,23,1479,11572,3,0,0,0,0,0
17491,32,1479,11572,1,0,0,0,0,-1
17493,17,62,8838,15,6,3,3,0,-4
17494,20,62,8838,2,0,0,0,4,0
17495,23,62,8838,2,0,0,0,2,1
17496,32,62,8838,7,0,0,0,0,-2
17497,35,77,8838,74,27,12,15,10,10
17498,38,77,8838,76,26,11,15,13,-1
17499,41,66,8838,66,12,5,7,8,6
17500,50,88,8838,19,2,0,2,4,-5
17501,23,68,41659,2,0,0,0,4,-3
17502,26,68,41659,3,0,0,0,0,-1
17503,29,68,41659,17,0,0,0,26,-2
17504,32,68,41659,60,3,1,2,62,-4
17505,35,79,41659,19,4,0,4,42,2
17506,38,86,41659,12,0,0,0,11,0
17507,74,62,45485,26,5,2,3,16,1
17508,77,62,45485,71,18,4,14,45,-15
17510,83,62,45485,77,41,21,20,24,5
17511,86,66,45485,71,40,17,23,58,13
17512,2,83,67478,10,1,0,1,0,1
17513,5,83,67478,48,10,2,8,23,-17
17514,8,83,67478,16,0,0,0,11,-5
17518,17,67,67478,26,8,2,6,20,10
17519,20,67,67478,82,23,4,19,112,23
17520,23,67,67478,76,22,3,19,56,26
17521,26,67,67478,71,15,3,12,52,28
17523,29,62,67478,27,9,1,8,22,-13
17524,32,75,67478,7,1,0,1,6,-4
17525,2,67,52982,34,14,8,6,12,-11
17526,5,67,52982,1,1,0,1,0,1
17534,23,63,9073,13,2,2,0,2,-3
17535,26,63,9073,33,9,5,4,2,3
17536,29,63,9073,44,12,5,7,14,-17
17538,35,76,9073,71,52,17,35,30,18
17539,38,76,9073,74,42,13,29,52,-9
17540,41,76,9073,69,32,9,23,46,-8
17541,47,76,9073,66,34,15,19,60,-11
17542,50,76,9073,48,10,4,6,34,13
17543,53,76,9073,2,0,0,0,0,-2
17544,2,85,70245,7,1,0,1,14,0
17546,68,80,32817,4,0,0,0,2,-1
17547,71,80,32817,19,8,4,4,4,5
17548,74,80,32817,80,64,26,38,14,21
17549,77,80,32817,75,61,23,38,38,-4
17550,80,80,32817,71,54,22,32,25,12
17551,83,80,32817,58,62,20,42,10,9
17552,86,80,32817,59,62,28,34,22,13
17553,86,20120,32817,18,11,5,6,5,4
17554,74,70,21707,65,40,11,29,32,5
17556,80,70,21707,80,49,13,36,34,2
17557,83,70,21707,82,67,8,59,26,10
17558,86,70,21707,64,45,10,35,12,6
17559,68,77,18621,1,1,1,0,0,2
17560,71,77,18621,1,1,0,1,0,1
17561,74,77,18621,13,0,0,0,8,-1
17562,17,71,794,62,35,18,17,22,0
17563,20,71,794,64,28,17,11,22,-4
17564,20,67,794,12,10,8,2,4,1
17565,23,67,794,79,46,22,24,34,2
17566,26,67,794,81,66,40,26,44,24
17567,29,67,794,81,67,33,34,32,16
17568,32,67,794,82,62,29,33,36,5
17569,35,67,794,82,73,37,36,33,14
17578,5,85,27646,74,62,36,26,27,7
17579,8,85,27646,70,66,32,34,29,7
17580,11,85,27646,82,93,52,41,26,13
17581,14,85,27646,43,40,30,10,17,11
17582,17,85,27646,5,4,2,2,2,0
17583,17,86,27646,51,46,27,19,10,-19
17584,17,68,27646,14,10,8,2,4,0
17473,23,65,9126,80,42,31,11,22,4
17474,26,65,9126,72,42,22,20,22,-13
17476,32,65,9126,79,57,33,24,16,1
17477,35,65,9126,82,70,38,32,36,17
17478,38,65,9126,54,44,22,22,14,10
17479,41,65,9126,19,11,4,7,0,-7
17480,47,65,9126,1,0,0,0,2,-2
17481,23,76,69535,8,0,0,0,0,-4
17482,26,76,69535,11,0,0,0,8,-4
17483,29,70,69535,10,1,0,1,13,-2
17484,71,63,49315,2,0,0,0,0,0
17485,74,63,49315,27,5,1,4,0,-2
17486,77,63,49315,38,7,2,5,22,3
17487,83,79,49315,3,0,0,0,0,-3
17488,86,79,49315,13,1,0,1,4,4
17692,29,67,10808,61,34,11,23,35,12
17693,29,65,10808,14,6,2,4,12,-1
17694,32,74,10808,65,20,9,11,61,-10
17695,35,74,10808,15,5,3,2,12,-3
17696,38,63,10808,63,20,2,18,71,2
17698,2,71,57083,75,57,30,27,66,-8
17699,5,71,57083,79,61,24,37,80,8
17700,8,71,57083,60,46,24,22,36,-14
17701,11,67,57083,22,16,8,8,8,-3
17702,14,67,57083,24,11,4,7,26,-5
17679,32,1479,39759,39,11,1,10,20,-16
17680,77,74,17720,5,1,0,1,0,3
17681,80,74,17720,16,2,0,2,2,-3
17682,83,62,17720,3,0,0,0,0,1
17683,38,64,15131,2,0,0,0,0,0
17684,62,83,9271,3,0,0,0,2,0
17688,17,67,10808,22,10,6,4,31,0
17689,20,67,10808,82,36,15,21,71,25
17690,23,67,10808,67,30,10,20,60,9
17691,26,67,10808,76,50,20,30,102,21
17703,29,88,3314,48,16,6,10,18,3
17704,32,88,3314,56,9,2,7,38,8
17705,35,88,3314,30,1,0,1,29,-5
17706,35,73,3314,15,1,0,1,12,-1
17710,50,81,4094,53,9,3,6,12,-4
17711,53,81,4094,58,4,2,2,10,-7
17712,20,1479,67189,23,1,1,0,121,0
17713,23,1479,67189,12,2,1,1,55,-1
17714,2,62,68905,16,2,0,2,53,0
17715,5,62,68905,21,4,1,3,119,-4
17716,8,81,68905,7,0,0,0,11,-1
17718,20,75,8855,73,20,7,13,110,-5
17719,23,75,8855,39,6,1,5,57,-6
17720,23,81,8855,35,14,6,8,89,-8
17721,26,81,8855,82,43,21,22,176,-34
17722,29,81,8855,50,34,14,20,108,-15
17723,29,83,8855,27,17,7,10,55,3
17724,32,83,8855,82,37,16,21,141,6
17725,35,83,8855,77,59,24,35,92,24
17726,38,83,8855,77,36,10,26,119,-7
17727,41,83,8855,64,32,21,11,68,4
17728,47,83,8855,74,61,28,33,100,-12
17729,50,83,8855,56,43,24,19,81,-11
17730,53,83,8855,74,34,18,16,100,-8
17731,56,64,8855,63,16,8,8,67,-13
17606,41,77,10837,6,1,0,1,2,0
17736,80,1479,23658,9,2,0,2,0,-2
17737,80,68,23658,29,7,2,5,9,-3
17738,20,64,28744,5,2,1,1,0,1
17739,23,64,28744,5,0,0,0,6,0
17740,26,64,28744,7,2,1,1,0,-2
17741,29,64,28744,5,1,0,1,4,-2
17742,32,69,28744,3,0,0,0,2,0
17743,20,1479,8487,3,0,0,0,0,-2
17744,23,1479,8487,21,11,9,2,12,-6
17745,29,1479,8487,3,0,0,0,2,0
17748,2,88,10730,7,0,0,0,2,4
17749,5,88,10730,3,1,0,1,2,0
17750,5,78,77120,1,0,0,0,0,0
17751,2,72,6810,1,1,0,1,0,0
17752,5,72,6810,15,6,2,4,4,-1
17753,8,72,6810,11,2,0,2,4,-3
17755,17,62,6810,1,0,0,0,0,0
17756,23,86,6810,22,10,4,6,14,-2
17757,23,65,6810,4,1,0,1,2,0
17758,23,70,6810,1,0,0,0,0,0
17759,23,65,6810,3,0,0,0,2,0
17760,26,86,6810,17,2,1,1,4,-6
17762,35,77,6810,1,0,0,0,2,0
17763,11,74,8526,1,0,0,0,0,-1
17764,11,71,8526,3,1,0,1,2,-1
17765,14,71,8526,45,27,13,14,32,-3
17766,17,71,8526,81,38,19,19,66,-19
17767,20,71,8526,79,33,14,19,44,11
17768,23,71,8526,76,35,14,21,71,9
17769,26,71,8526,82,36,14,22,65,3
17770,29,71,8526,82,40,17,23,70,7
17771,32,71,8526,71,39,13,26,51,1
17773,38,71,8526,77,60,20,40,48,13
17774,41,82,8526,77,34,9,25,34,-17
17775,47,82,8526,18,9,3,6,20,-1
17776,47,1479,8526,61,25,6,19,46,3
17777,50,1479,8526,56,23,8,15,44,7
17778,53,1479,8526,75,16,9,7,48,-3
17779,56,1479,8526,72,18,5,13,34,-2
17780,59,1479,8526,78,22,9,13,32,-16
17781,62,1479,8526,79,8,1,7,26,-18
17782,11,67,29276,14,4,0,4,0,-3
17783,74,66,29028,4,0,0,0,0,-2
17784,77,66,29028,8,0,0,0,0,-4
17785,17,89,9095,11,6,3,3,0,5
17786,20,89,9095,23,11,4,7,12,-3
17787,23,89,9095,28,23,11,12,12,2
17788,26,73,9095,77,31,11,20,26,-10
17792,38,69,9095,82,46,18,28,30,-10
17793,41,69,9095,82,49,15,34,12,3
17794,47,64,9095,82,63,24,39,48,9
17795,50,64,9095,82,83,27,56,36,-8
17796,53,64,9095,82,59,19,40,14,5
17797,56,69,9095,80,50,22,28,18,-5
17798,59,69,9095,82,61,25,36,12,-5
17799,62,69,9095,82,46,18,28,16,-7
17800,65,65,9095,78,27,12,15,4,-13
17801,80,67,32559,2,0,0,0,0,-1
17802,83,80,32559,2,1,0,1,0,2
17803,86,80,32559,4,0,0,0,2,-1
17804,20,75,13404,2,0,0,0,0,0
17805,23,75,13404,1,0,0,0,0,-1
17806,35,82,13404,5,0,0,0,7,-1
17807,38,82,13404,35,5,3,2,86,-6
17809,32,82,15578,1,0,0,0,5,0
17810,62,76,30058,1,0,0,0,0,-1
17811,74,87,37267,12,1,0,1,8,-1
17812,20,77,9888,2,0,0,0,0,0
17813,23,77,9888,4,0,0,0,12,0
17814,35,83,9888,21,10,3,7,2,7
17815,38,83,9888,44,10,3,7,16,8
17816,41,74,9888,4,0,0,0,0,0
17817,47,64,9888,2,0,0,0,14,0
17818,29,68,8784,4,0,0,0,2,-1
17819,32,78,8784,1,0,0,0,0,-1
17820,35,78,8784,8,1,0,1,4,-2
17821,38,78,8784,80,49,22,27,38,22
17822,41,78,8784,27,10,6,4,20,-1
17823,47,78,8784,9,5,1,4,4,-1
17824,47,79,8784,38,11,5,6,29,-2
17826,2,75,31510,57,34,15,19,85,12
17827,5,75,31510,42,6,3,3,36,-4
17828,8,75,31510,23,8,5,3,55,1
17829,8,62,31510,16,6,2,4,10,3
17830,11,68,31510,79,40,15,25,136,13
17831,14,68,31510,47,14,5,9,88,0
17832,17,68,31510,79,27,7,20,129,6
17833,20,68,31510,51,18,5,13,48,4
17834,23,74,31510,59,11,5,6,39,-4
17835,23,70,31510,13,2,2,0,10,-2
17836,26,70,31510,40,5,4,1,33,2
17837,29,70,31510,22,3,1,2,22,0
17838,2,84,3357,20,8,4,4,8,-9
17839,2,63,3357,28,19,5,14,9,4
17840,5,63,3357,9,1,1,0,6,-3
17842,8,86,3357,17,7,4,3,6,-8
17844,35,62,19444,2,0,0,0,0,-2
17845,38,76,19444,4,0,0,0,0,-1
17846,23,63,8719,68,6,2,4,47,4
17847,26,63,8719,80,10,3,7,63,-10
17848,29,63,8719,81,12,3,9,51,0
17849,32,63,8719,80,11,1,10,71,-2
17850,35,63,8719,79,22,4,18,77,16
17851,38,63,8719,76,17,4,13,56,21
17852,41,63,8719,82,9,2,7,99,16
17853,47,63,8719,80,10,1,9,124,-4
17854,50,83,8719,82,20,6,14,91,11
17855,53,83,8719,63,20,2,18,52,0
17856,53,79,8719,18,4,1,3,16,6
17857,56,79,8719,62,10,2,8,53,11
17733,68,64,23658,6,0,0,0,4,-3
17734,74,64,23658,3,1,0,1,10,0
17862,68,73,8719,32,0,0,0,12,-3
17863,71,77,8719,6,0,0,0,2,0
17864,35,68,8476,22,2,0,2,45,-2
17865,38,88,8476,53,6,3,3,97,1
17866,41,88,8476,20,1,0,1,77,-1
17867,41,89,8476,16,1,0,1,17,-4
17868,47,80,8476,7,0,0,0,31,1
17869,50,85,8476,6,1,0,1,20,2
17870,83,88,44677,2,0,0,0,2,0
17871,29,89,8771,79,29,18,11,39,21
17872,32,89,8771,80,42,21,21,60,13
17873,35,89,8771,48,19,5,14,29,-9
17874,38,89,8771,82,34,13,21,88,6
17875,41,89,8771,79,46,19,27,56,-21
17876,47,89,8771,70,44,11,33,79,-8
17877,50,70,8771,76,25,8,17,78,-7
17879,53,81,8771,19,18,10,8,14,2
17880,56,81,8771,52,16,7,9,32,-13
17881,59,81,8771,55,17,9,8,27,-13
17882,59,88,8771,16,2,0,2,12,-1
17883,62,75,8771,72,26,11,15,29,6
17884,65,89,8771,69,16,4,12,24,-1
17885,68,74,8771,30,1,0,1,8,-5
17886,68,75,8771,16,2,1,1,2,-3
17888,20,71,9167,79,32,15,17,45,7
17889,23,71,9167,66,15,9,6,73,-3
17890,26,71,9167,82,44,20,24,54,5
17891,29,71,9167,65,31,9,22,68,9
17892,32,71,9167,74,36,20,16,20,11
17893,35,71,9167,82,25,8,17,32,1
17894,38,89,9167,82,32,15,17,36,-14
17895,41,89,9167,68,20,8,12,32,-19
17897,47,67,9167,81,23,7,16,28,-7
17898,50,86,9167,81,33,16,17,43,-5
17899,53,86,9167,78,22,9,13,24,-8
17900,56,86,9167,62,23,10,13,25,8
17901,59,67,9167,73,22,10,12,14,-4
17902,62,67,9167,73,16,5,11,12,0
17903,17,67,13364,3,0,0,0,0,0
17904,20,67,13364,31,8,2,6,18,1
17905,20,71,13364,4,0,0,0,0,0
17906,29,89,13364,1,0,0,0,0,0
17907,41,88,9175,5,2,2,0,8,1
17908,41,79,9175,44,14,3,11,38,-11
17909,11,80,8592,12,2,1,1,4,-7
17910,14,80,8592,16,7,4,3,0,-4
17911,17,80,8592,31,17,7,10,6,-3
17912,20,78,8592,8,3,3,0,2,0
17914,26,78,8592,82,89,37,52,16,13
17915,29,78,8592,71,75,28,47,8,34
17916,32,78,8592,44,45,20,25,16,27
17917,35,78,8592,82,78,35,43,46,13
17918,38,78,8592,78,93,36,57,32,0
17919,41,78,8592,68,58,23,35,18,1
17920,47,88,8592,58,62,25,37,42,21
17921,50,69,8592,71,64,25,39,28,0
17922,53,69,8592,68,54,15,39,24,9
17923,56,84,8592,69,53,20,33,20,6
17924,59,84,8592,28,16,3,13,0,3
17927,35,69,12767,3,0,0,0,0,-3
17928,26,88,8776,1,1,1,0,0,1
17929,29,88,8776,64,23,5,18,26,4
17930,32,88,8776,17,4,1,3,10,-8
17931,32,76,8776,30,12,4,8,24,-12
17933,38,76,8776,81,55,25,30,58,16
17934,41,76,8776,75,47,22,25,56,11
17935,47,76,8776,76,57,28,29,60,0
17936,50,76,8776,82,69,40,29,34,1
17937,53,83,8776,82,52,15,37,28,-4
17938,56,83,8776,78,63,25,38,40,-2
17939,59,83,8776,56,26,10,16,26,-4
17940,59,1479,8776,26,15,6,9,10,-6
17941,62,1479,8776,76,32,16,16,41,-5
17942,65,1479,8776,45,12,7,5,6,-4
17943,23,63,44618,1,0,0,0,2,0
17944,29,63,44618,14,3,0,3,0,-6
17945,32,64,44618,3,0,0,0,2,0
17946,68,62,12377,6,1,0,1,0,-1
17947,71,62,12377,13,1,0,1,4,-2
17948,74,64,12377,3,0,0,0,0,0
17950,80,85,12377,6,1,0,1,0,1
17951,86,1479,12377,21,5,3,2,2,-4
17952,29,84,5970,45,19,8,11,22,9
17953,32,84,5970,17,7,1,6,8,-1
17954,35,84,5970,3,1,0,1,2,-2
17955,29,72,1594,75,32,5,27,28,21
17956,32,72,1594,78,52,9,43,26,36
17957,35,72,1594,76,47,7,40,18,15
17958,38,72,1594,79,40,3,37,14,18
17959,41,72,1594,69,36,6,30,24,6
17960,47,72,1594,82,49,6,43,36,0
17961,50,72,1594,82,55,8,47,34,4
17962,53,85,1594,73,55,13,42,34,27
17963,56,85,1594,78,59,10,49,20,17
17964,59,85,1594,78,42,8,34,26,23
17965,62,85,1594,63,48,4,44,22,11
17967,32,76,7298,9,3,0,3,0,4
17968,35,76,7298,2,0,0,0,0,0
17969,38,1479,7298,67,25,10,15,12,1
17970,41,1479,7298,80,18,6,12,16,-4
17972,50,74,7298,9,2,2,0,4,2
17973,56,84,7298,4,1,1,0,2,0
17974,26,73,2660,50,12,4,8,30,-4
17975,29,73,2660,51,33,8,25,26,-5
17976,32,73,2660,82,25,12,13,50,-6
17977,35,73,2660,82,42,13,29,28,2
17978,38,73,2660,72,40,6,34,46,-3
17979,41,73,2660,77,44,12,32,52,-7
17980,47,73,2660,79,50,11,39,74,-3
17981,50,73,2660,80,55,13,42,42,20
17859,62,75,8719,75,9,2,7,43,-9
17860,65,75,8719,53,8,1,7,29,-7
17986,65,77,2660,76,43,4,39,46,8
17987,68,77,2660,45,29,5,24,36,3
17988,71,77,2660,77,35,6,29,32,5
17989,74,65,2660,16,0,0,0,2,-3
17990,11,62,32603,76,45,27,18,28,20
17991,14,62,32603,40,24,12,12,16,6
17992,17,62,32603,82,67,28,39,24,9
17993,20,62,32603,79,52,22,30,36,-12
17994,23,62,32603,68,40,18,22,38,-1
17995,26,79,32603,72,56,11,45,34,18
17996,29,79,32603,63,42,17,25,34,-3
17997,29,71,32603,7,4,0,4,4,2
17998,32,1479,32603,71,20,9,11,61,-21
17999,35,1479,32603,66,27,13,14,36,4
18000,23,84,729592,30,6,2,4,24,2
18001,26,84,729592,39,4,2,2,13,-7
18003,32,74,729592,2,0,0,0,4,-1
18004,68,71,33252,1,0,0,0,0,0
18005,71,71,33252,41,18,4,14,8,-7
18006,74,71,33252,36,12,7,5,12,-7
18007,74,73,33252,4,1,1,0,0,0
18008,74,79,33252,10,2,0,2,2,1
18009,74,87,33252,27,16,9,7,6,-4
18010,77,83,33252,20,4,3,1,0,0
18011,11,71,1905,44,28,8,20,30,-3
18012,14,86,1905,13,5,0,5,14,-9
18013,32,84,362141,75,34,20,14,24,-3
18014,35,84,362141,79,32,9,23,32,1
18015,38,84,362141,79,31,14,17,34,8
18016,41,84,362141,82,54,18,36,18,18
18017,47,84,362141,82,71,22,49,34,7
18018,50,84,362141,81,84,36,48,36,19
18020,56,84,362141,82,82,31,51,36,24
18021,59,84,362141,63,85,29,56,28,36
18022,62,84,362141,82,104,41,63,32,30
18023,65,84,362141,72,67,30,37,40,14
18024,68,84,362141,47,40,12,28,18,12
18025,71,84,362141,73,47,16,31,38,0
18026,74,84,362141,82,76,20,56,18,5
18027,77,84,362141,82,61,28,33,36,7
18028,80,84,362141,82,44,15,29,32,-16
18029,83,84,362141,81,55,23,32,40,-21
18030,35,77,5212,8,1,1,0,2,-1
18031,38,77,5212,42,12,5,7,4,8
18032,38,66,5212,8,1,0,1,2,-3
18033,41,66,5212,18,8,5,3,8,0
18035,29,76,8770,81,34,14,20,44,-25
18036,32,76,8770,82,41,10,31,42,-14
18038,38,67,8770,80,25,12,13,32,-28
18039,47,67,8770,63,55,16,39,28,5
18040,50,67,8770,2,1,1,0,2,1
18041,53,67,8770,48,40,7,33,8,4
18042,56,67,8770,48,47,18,29,22,12
18043,59,67,8770,73,65,17,48,28,10
18044,62,67,8770,68,42,13,29,20,-10
18045,65,83,8770,70,36,13,23,40,-14
18046,32,89,8426,4,0,0,0,2,-2
18047,35,79,8426,79,25,10,15,45,-25
18048,38,79,8426,12,1,0,1,6,-3
18049,41,79,8426,4,1,0,1,6,0
18050,47,73,8426,5,3,1,2,0,1
18051,47,89,8426,5,0,0,0,4,0
18052,50,89,8426,64,26,8,18,46,-11
18053,53,82,8426,16,9,5,4,2,3
18055,53,79,8426,5,0,0,0,2,-1
18056,32,76,5368,78,18,4,14,39,-17
18057,35,67,5368,48,20,10,10,35,4
18058,38,67,5368,78,28,14,14,38,-8
18059,41,67,5368,63,20,8,12,25,-7
18060,47,67,5368,41,12,6,6,33,-1
18061,50,84,5368,76,37,23,14,42,5
18062,53,84,5368,79,37,16,21,60,9
18063,56,84,5368,69,19,10,9,43,0
18067,68,74,5368,48,11,6,5,6,5
18068,71,74,5368,22,1,0,1,10,-9
18069,71,79,5368,34,4,4,0,10,-15
18070,38,74,8754,55,19,8,11,16,-3
18071,41,74,8754,56,10,2,8,33,-8
18072,47,74,8754,3,1,1,0,6,-2
18074,47,62,8754,12,10,4,6,20,2
18076,50,88,8754,29,9,7,2,25,-8
18077,56,62,8754,27,16,8,8,17,2
18078,59,62,8754,21,9,4,5,4,-6
18079,59,83,8754,15,3,1,2,16,-1
18080,32,76,8650,42,5,1,4,53,-5
18081,35,76,8650,24,2,0,2,12,2
18082,38,68,8650,11,2,2,0,10,-2
18083,41,68,8650,45,7,0,7,80,-4
18084,47,68,8650,16,1,0,1,37,3
18085,50,68,8650,45,3,0,3,55,5
18086,53,68,8650,57,4,2,2,64,-13
18087,17,67,8745,2,0,0,0,10,0
18088,23,67,8745,3,0,0,0,4,0
18089,35,62,8745,60,17,8,9,107,-9
18090,38,62,8745,68,10,5,5,149,-7
18091,41,65,8745,75,18,7,11,145,-16
18093,50,73,8745,59,13,7,6,79,7
18094,53,73,8745,73,18,10,8,72,12
18095,56,73,8745,43,10,4,6,41,0
18096,59,86,8745,79,19,4,15,72,0
18097,62,86,8745,56,7,4,3,50,-3
18098,65,78,8745,80,8,3,5,83,-5
18099,68,78,8745,30,1,1,0,25,-2
18100,17,78,155,26,10,2,8,14,-6
18101,20,78,155,5,1,0,1,0,1
18102,20,80,155,25,5,2,3,10,-5
18103,35,71,2672,1,0,0,0,0,0
18104,38,71,2672,12,4,3,1,0,2
18105,41,71,2672,2,0,0,0,0,0
18106,47,71,2672,21,3,3,0,6,0
17983,56,77,2660,77,43,3,40,54,19
17984,59,77,2660,82,39,6,33,50,-2
18111,41,67,9027,14,3,0,3,19,-3
18112,47,67,9027,2,0,0,0,4,0
18113,29,62,8583,4,1,0,1,2,-4
18114,32,62,8583,59,23,9,14,43,4
18115,35,62,8583,3,0,0,0,0,-2
18116,38,62,8583,52,23,8,15,46,5
18117,41,62,8583,69,29,12,17,41,1
18120,50,80,8583,12,2,1,1,4,-3
18121,29,66,8769,31,4,4,0,14,-4
18122,32,66,8769,74,29,7,22,42,-9
18123,35,66,8769,78,16,1,15,35,-13
18124,38,66,8769,68,13,3,10,24,-27
18127,47,63,8769,54,16,4,12,48,0
18128,50,66,8769,60,17,5,12,44,5
18129,53,66,8769,18,3,1,2,8,2
18130,32,68,9594,43,16,6,10,16,6
18132,38,68,9594,23,6,4,2,12,-7
18133,41,68,9594,2,0,0,0,0,0
18134,38,79,8674,2,0,0,0,0,-2
18135,41,79,8674,82,29,9,20,30,-30
18136,47,79,8674,60,9,3,6,20,-10
18137,29,79,47031,68,14,3,11,12,-5
18138,32,79,47031,58,22,4,18,22,11
18139,35,79,47031,53,7,2,5,22,-12
18140,38,79,47031,63,5,1,4,36,-23
18141,35,74,9450,10,0,0,0,2,-4
18142,71,76,24331,2,0,0,0,7,-1
18143,29,65,8563,5,2,1,1,4,0
18144,32,65,8563,44,5,0,5,8,-7
18145,35,65,8563,3,0,0,0,2,-1
18146,38,65,8563,57,5,1,4,23,-1
18147,41,65,8563,25,4,1,3,8,-9
18152,35,78,9021,1,0,0,0,0,0
18153,38,78,9021,82,19,3,16,190,23
18154,41,78,9021,15,3,1,2,41,-1
18155,47,78,9021,63,10,4,6,156,-6
18156,50,78,9021,70,27,3,24,82,20
18157,53,78,9021,78,16,2,14,93,-12
18158,56,78,9021,82,21,4,17,86,-17
18159,59,78,9021,66,17,2,15,81,3
18160,62,78,9021,60,13,0,13,57,3
18161,65,78,9021,81,13,1,12,57,20
18162,68,78,9021,46,12,3,9,39,6
18163,71,78,9021,79,15,3,12,97,11
18164,74,78,9021,80,15,2,13,47,3
18165,77,73,9021,73,5,1,4,76,1
18166,41,64,39465,3,0,0,0,0,-1
18167,32,80,8620,73,42,19,23,20,8
18169,38,80,8620,67,59,24,35,30,20
18170,41,80,8620,68,68,31,37,46,12
18171,47,80,8620,18,16,9,7,4,6
18172,50,65,8620,56,57,25,32,28,15
18173,53,65,8620,35,27,10,17,22,4
18174,56,65,8620,81,77,29,48,30,29
18175,59,69,8620,73,54,18,36,34,-19
18176,62,69,8620,78,62,22,40,52,-10
18177,65,86,8620,39,27,7,20,22,10
18178,68,86,8620,40,18,8,10,30,7
18179,71,86,8620,48,22,12,10,10,14
18180,74,72,8620,40,14,5,9,10,-11
18181,77,78,8620,2,1,1,0,0,0
18182,2,77,72031,72,21,11,10,37,0
18185,11,70,72031,1,0,0,0,0,-1
18186,38,79,9603,38,6,3,3,14,-5
18188,35,81,5523,2,0,0,0,0,0
18189,41,68,5523,2,0,0,0,2,0
18190,38,64,13508,2,0,0,0,0,0
18191,41,64,13508,6,2,0,2,4,-1
18192,50,67,10347,19,5,3,2,2,-8
18193,53,67,10347,46,8,4,4,30,-4
18194,56,66,10347,18,2,0,2,2,-3
18195,35,73,599,5,0,0,0,2,-2
18196,62,84,599,4,0,0,0,0,1
18197,38,79,5975,3,0,0,0,4,-3
18198,38,67,9632,3,1,1,0,0,0
18199,41,67,9632,23,9,1,8,18,1
18200,47,65,9632,24,7,1,6,8,0
18201,38,71,8645,46,7,1,6,58,-7
18202,41,71,8645,46,5,2,3,32,8
18203,47,71,8645,11,2,1,1,17,-3
18205,50,68,8645,23,5,0,5,28,9
18206,53,86,8645,22,4,1,3,36,-8
18207,56,86,8645,47,8,1,7,57,3
18208,35,89,8788,11,1,1,0,4,3
18209,41,89,8788,1,0,0,0,0,0
18210,47,89,8788,38,7,0,7,86,1
18212,65,68,8788,1,0,0,0,0,0
18213,68,68,8788,7,0,0,0,11,-1
18214,71,1479,8788,2,1,0,1,0,-1
18215,2,71,72872,59,13,1,12,55,13
18216,5,71,72872,74,18,2,16,43,-5
18217,8,71,72872,78,18,4,14,30,-11
18218,11,71,72872,21,3,0,3,12,-10
18219,11,68,72872,56,6,1,5,38,-3
18220,14,68,72872,47,6,2,4,22,-5
18221,17,68,72872,31,10,3,7,20,-4
18223,23,74,72872,15,2,1,1,6,-4
18224,26,74,72872,4,0,0,0,2,-5
18225,11,63,67701,11,5,3,2,14,3
18226,14,63,67701,16,4,3,1,2,1
18227,17,78,67701,1,0,0,0,2,0
18228,32,72,9111,20,5,1,4,14,5
18229,35,72,9111,37,1,0,1,30,-12
18230,38,62,9111,6,1,0,1,19,2
18231,41,62,9111,12,0,0,0,25,-4
18232,47,66,9111,72,13,3,10,138,12
18233,50,66,9111,82,29,7,22,113,0
18234,53,66,9111,41,12,3,9,74,2
18235,53,80,9111,26,2,0,2,26,-9
18236,56,82,9111,81,24,5,19,100,11
18108,35,86,9027,48,18,5,13,29,2
18109,38,86,9027,26,6,0,6,9,-7
18241,41,71,2684,13,1,0,1,4,-1
18242,50,65,2684,57,17,6,11,26,-3
18243,38,62,8993,58,14,4,10,12,-15
18244,41,62,8993,82,33,9,24,24,8
18245,47,62,8993,74,20,2,18,68,6
18246,50,64,8993,15,5,2,3,14,-4
18247,53,64,8993,43,13,5,8,20,5
18248,56,64,8993,64,20,6,14,18,-10
18249,56,62,8993,19,4,1,3,6,-5
18250,59,68,8993,61,18,7,11,22,-7
18251,59,79,8993,20,8,4,4,6,5
18252,62,67,8993,71,35,13,22,36,-11
18253,65,67,8993,79,24,10,14,28,4
18254,68,67,8993,24,8,2,6,14,-6
18255,68,78,8993,15,2,0,2,0,-2
18256,71,78,8993,27,6,1,5,6,1
18258,74,82,8993,18,3,1,2,9,-7
18259,74,69,8993,18,1,0,1,8,1
18262,41,84,10325,7,1,1,0,9,3
18263,50,77,10325,3,0,0,0,0,-3
18264,32,81,22839,49,4,4,0,38,-13
18265,35,81,22839,39,13,6,7,16,-11
18266,38,81,22839,37,7,2,5,24,-1
18267,41,66,12812,2,0,0,0,2,0
18268,41,79,8951,18,2,1,1,14,-6
18269,47,79,8951,41,6,1,5,24,-9
18271,35,73,8718,1,1,0,1,0,0
18272,38,73,8718,79,28,16,12,31,-8
18273,41,73,8718,79,27,13,14,37,-8
18274,47,73,8718,75,29,14,15,40,0
18275,50,74,8718,49,12,4,8,18,-13
18276,50,69,8718,23,5,2,3,8,2
18278,56,81,8718,74,10,5,5,29,-9
18279,62,81,8718,82,18,7,11,32,-12
18280,65,81,8718,57,7,2,5,17,-11
18281,68,81,8718,20,4,0,4,23,3
18282,68,66,8718,6,0,0,0,0,-2
18283,68,77,8718,11,0,0,0,0,-1
18284,71,77,8718,80,9,4,5,23,-15
18285,65,70,39071,20,3,2,1,22,-1
18286,68,70,39071,36,10,3,7,32,1
18287,71,70,39071,75,32,17,15,106,10
18288,74,70,39071,67,25,8,17,55,-9
18289,77,65,39071,43,6,2,4,27,-7
18290,77,1479,39071,37,8,5,3,21,-4
18291,80,1479,39071,27,3,2,1,20,-3
18292,41,73,9057,18,8,4,4,4,1
18293,47,66,9057,36,11,3,8,18,-2
18295,56,81,9057,2,0,0,0,0,-5
18296,56,70,9057,38,5,2,3,12,-4
18297,62,79,9057,5,1,0,1,6,-3
18298,38,67,9028,6,0,0,0,2,1
18299,41,67,9028,4,0,0,0,19,0
18300,50,81,9028,75,11,2,9,53,-11
18301,53,81,9028,61,4,1,3,45,-3
18302,56,70,9028,13,1,0,1,2,-2
18303,56,75,9028,2,0,0,0,2,-1
18304,59,85,9028,13,2,0,2,18,-3
18305,62,85,9028,7,0,0,0,7,-2
18306,65,85,9028,9,1,0,1,6,2
18307,47,86,9105,1,1,0,1,2,0
18308,56,80,9105,1,0,0,0,0,0
18309,59,80,9105,81,11,2,9,190,0
18310,62,80,9105,50,7,1,6,136,0
18312,68,76,9105,22,2,0,2,46,-2
18313,71,76,9105,53,3,0,3,149,-10
18314,38,66,9522,19,3,2,1,0,-4
18315,41,66,9522,17,3,0,3,2,-1
18316,47,66,9522,21,1,1,0,4,1
18324,53,70,11724,2,0,0,0,0,0
18325,56,70,11724,3,0,0,0,0,0
18326,17,83,71010,21,4,2,2,14,0
18327,20,83,71010,7,0,0,0,0,-3
18330,47,63,8632,5,0,0,0,2,-2
18331,35,68,2678,78,28,10,18,8,-6
18332,38,68,2678,80,23,8,15,20,-8
18333,41,68,2678,75,23,10,13,22,-5
18334,47,68,2678,30,6,2,4,2,-8
18335,47,70,2678,54,15,6,9,16,-2
18336,50,70,2678,82,29,17,12,34,3
18337,53,70,2678,82,41,27,14,51,4
18338,56,83,2678,65,42,22,20,4,-5
18339,59,83,2678,55,33,20,13,23,-3
18340,59,62,2678,27,11,5,6,2,-1
18341,62,62,2678,71,27,11,16,24,-2
18342,65,62,2678,8,4,1,3,2,3
18343,65,1479,2678,63,19,8,11,12,-10
18344,2,71,21550,77,54,13,41,193,14
18345,5,65,21550,76,30,9,21,304,23
18346,8,65,21550,78,57,10,47,214,12
18347,11,65,21550,57,27,5,22,174,-5
18348,14,65,21550,48,13,1,12,128,6
18349,17,65,21550,37,9,0,9,71,12
18350,20,65,21550,21,0,0,0,29,4
18351,26,62,21550,69,15,1,14,80,3
18352,29,62,21550,20,4,0,4,42,-13
18353,32,62,21550,13,2,0,2,17,-2
18354,2,71,47069,0,0,0,0,0,0
18355,32,84,729603,82,29,9,20,38,-2
18356,35,84,729603,82,36,16,20,36,9
18357,38,84,729603,78,39,8,31,38,9
18358,41,84,729603,76,42,11,31,32,23
18359,47,84,729603,82,75,18,57,56,11
18360,50,84,729603,82,81,10,71,66,19
18361,53,84,729603,82,76,15,61,56,6
18362,56,84,729603,82,82,22,60,48,22
18363,59,84,729603,82,112,29,83,48,35
18238,62,82,9111,20,6,2,4,44,-8
18239,65,85,9111,17,2,0,2,21,3
18368,74,84,729603,82,73,18,55,22,11
18369,77,84,729603,74,55,11,44,24,0
18371,83,84,729603,82,50,3,47,30,-22
18372,29,88,1914,37,9,0,9,4,3
18378,47,66,1914,77,44,6,38,46,8
18379,50,66,1914,27,8,2,6,20,8
18380,53,66,1914,80,22,0,22,30,-4
18381,56,66,1914,30,8,1,7,8,-4
18382,38,76,347,47,23,6,17,10,-2
18383,41,76,347,55,20,8,12,26,9
18384,47,76,347,53,6,2,4,14,-4
18385,47,69,347,15,5,2,3,10,0
18386,50,69,347,12,2,1,1,10,-2
18390,8,80,60156,51,14,4,10,51,-34
18391,2,84,73677,45,14,2,12,87,-5
18394,5,62,68896,7,2,1,1,15,7
18395,8,62,68896,35,3,1,2,95,2
18396,11,68,68896,12,1,1,0,37,0
18397,11,83,68896,11,1,0,1,38,-2
18398,11,65,68896,38,0,0,0,108,-2
18399,14,65,68896,22,3,0,3,33,2
18400,20,83,68896,2,0,0,0,0,0
18401,74,76,38330,6,2,1,1,8,-3
18402,77,79,38330,1,0,0,0,2,0
18403,29,1479,729571,50,9,2,7,20,0
18404,32,1479,729571,47,14,4,10,34,-6
18405,35,1479,729571,52,3,1,2,40,-13
18406,38,1479,729571,82,33,11,22,30,5
18407,41,1479,729571,79,26,6,20,28,-28
18412,56,72,729571,15,4,0,4,6,-2
18413,41,66,10834,1,1,1,0,0,1
18414,32,78,5867,6,2,2,0,2,1
18416,35,74,5867,8,1,0,1,4,-7
18417,35,81,122326,74,14,3,11,24,3
18418,38,81,122326,37,3,0,3,16,-2
18419,38,69,8802,7,1,1,0,13,0
18420,41,69,8802,6,1,0,1,10,-2
18421,47,69,8802,51,12,4,8,64,-8
18422,50,81,8802,4,0,0,0,0,0
18423,53,81,8802,7,1,1,0,7,-1
18424,32,71,4697,41,22,8,14,14,6
18425,35,71,4697,82,60,33,27,45,16
18426,38,71,4697,69,51,20,31,90,-18
18427,41,77,4697,21,9,4,5,12,2
18431,50,80,4697,41,25,13,12,24,-1
18432,53,76,4697,76,49,21,28,87,-21
18433,56,76,4697,41,20,7,13,26,-8
18434,56,80,4697,22,7,3,4,6,-7
18436,62,79,4697,21,6,1,5,18,-4
18437,65,77,39080,37,6,3,3,35,-11
18438,68,77,39080,7,1,0,1,36,0
18439,71,79,39080,13,2,2,0,12,0
18440,74,76,39080,2,0,0,0,0,-1
18441,77,1479,39080,1,0,0,0,0,-1
18442,80,73,39080,24,4,2,2,10,-2
18446,41,77,5673,24,9,1,8,36,0
18447,47,77,5673,64,14,8,6,44,-6
18448,50,69,5673,82,24,11,13,21,-9
18449,53,69,5673,73,17,7,10,48,-14
18450,41,80,9009,4,0,0,0,0,-2
18451,47,80,9009,82,30,10,20,76,21
18452,50,80,9009,82,38,15,23,40,28
18453,53,80,9009,75,30,11,19,30,3
18454,56,80,9009,82,23,12,11,38,-10
18456,62,80,9009,57,23,12,11,27,-12
18457,62,63,9009,24,5,2,3,6,-1
18458,65,63,9009,82,39,20,19,41,33
18459,68,63,9009,34,9,3,6,16,-8
18460,71,63,9009,57,18,9,9,32,2
18461,74,63,9009,80,28,7,21,48,6
18462,77,63,9009,11,2,2,0,0,3
18463,80,80,9009,82,12,5,7,23,-17
18464,83,1479,9009,12,2,0,2,2,1
18465,41,70,198,18,2,1,1,2,-6
18466,47,70,198,33,6,2,4,18,4
18467,50,70,198,18,4,1,3,4,-3
18470,68,89,33862,28,9,1,8,33,9
18471,71,89,33862,33,10,2,8,53,7
18472,74,89,33862,1,0,0,0,0,-1
18473,80,79,33862,11,1,0,1,24,2
18475,32,76,8649,29,7,4,3,12,-8
18476,35,76,8649,7,2,2,0,0,-2
18477,38,68,8649,10,1,0,1,0,1
18478,41,68,8649,53,25,14,11,14,-7
18479,47,68,8649,77,35,15,20,40,1
18480,50,68,8649,64,25,11,14,18,2
18481,71,71,34076,4,2,2,0,0,-1
18482,74,86,34076,7,4,0,4,4,0
18483,77,84,34076,1,1,0,1,0,1
18484,80,67,34076,27,7,0,7,16,3
18485,83,67,34076,7,1,0,1,2,-1
18486,86,70,34076,54,11,4,7,14,2
18487,47,80,8972,60,5,2,3,141,0
18488,50,80,8972,45,2,0,2,100,-1
18489,53,80,8972,38,3,0,3,46,0
18491,59,62,8972,34,4,1,3,86,3
18493,68,73,8972,2,0,0,0,0,0
18494,68,62,8972,19,3,3,0,49,-4
18495,71,62,8972,76,8,4,4,100,-4
18496,74,62,8972,8,0,0,0,4,-2
18497,2,67,53890,80,24,9,15,32,-13
18498,5,67,53890,55,18,3,15,36,-3
18499,5,86,53890,11,1,0,1,4,-12
18500,8,86,53890,25,9,4,5,14,-3
18501,8,77,53890,14,2,0,2,0,0
18502,65,77,33248,79,47,24,23,12,13
18503,68,77,33248,42,24,11,13,2,1
18504,71,77,33248,75,40,22,18,16,-4
18505,74,77,33248,80,30,8,22,14,-4
18506,77,77,33248,79,26,11,15,27,-5
18365,65,84,729603,82,81,14,67,52,23
18366,68,84,729603,48,45,11,34,24,19
18511,74,71,32190,3,0,0,0,5,-2
18512,41,79,8717,81,43,22,21,64,-23
18513,47,79,8717,77,44,22,22,63,-22
18514,50,79,8717,64,31,16,15,71,4
18515,53,79,8717,77,51,27,24,103,14
18516,56,81,8717,70,45,26,19,98,4
18517,59,81,8717,69,47,21,26,68,-8
18518,62,81,8717,54,38,14,24,51,-3
18519,65,81,8717,68,48,20,28,82,-11
18520,68,81,8717,24,8,6,2,22,-3
18521,71,81,8717,57,15,5,10,67,-7
18522,74,74,8717,6,0,0,0,4,-4
18523,71,63,38292,47,6,1,5,38,20
18524,74,63,38292,41,7,2,5,15,20
18525,77,63,38292,71,18,5,13,53,15
18526,80,63,38292,58,13,3,10,50,1
18528,86,63,38292,39,7,0,7,35,8
18529,29,81,8470,8,1,0,1,4,-2
18530,32,81,8470,15,2,1,1,4,-4
18535,53,82,8562,17,2,2,0,8,-2
18536,56,82,8562,1,0,0,0,2,-1
18537,59,82,8562,18,4,1,3,0,3
18538,62,82,8562,63,23,9,14,22,14
18539,65,82,8562,66,14,7,7,40,4
18540,68,82,8562,43,8,3,5,36,1
18541,71,82,8562,71,18,9,9,47,0
18542,74,68,8562,82,11,5,6,45,-17
18543,77,68,8562,64,13,6,7,36,7
18544,80,68,8562,82,16,6,10,50,-7
18545,83,68,8562,75,14,3,11,31,-9
18546,86,68,8562,1,0,0,0,0,0
18547,38,76,7106,11,4,2,2,2,-1
18549,68,81,33283,35,24,9,15,16,-3
18550,68,80,33283,12,5,2,3,4,6
18551,71,80,33283,60,20,4,16,34,8
18552,71,67,33283,19,6,3,3,16,-7
18553,74,76,33283,15,3,1,2,14,-3
18554,80,81,33283,11,4,1,3,4,0
18555,83,81,33283,36,12,8,4,24,0
18556,86,81,33283,1,0,0,0,2,0
18557,41,89,4626,9,1,0,1,2,-3
18558,77,72,12075,3,0,0,0,2,0
18559,80,68,12075,21,3,0,3,22,-4
18560,2,71,1908,2,0,0,0,0,0
18561,62,80,14391,4,0,0,0,0,-1
18562,65,80,14391,22,5,3,2,8,-9
18563,68,80,14391,9,2,1,1,0,-3
18564,71,80,14391,12,4,3,1,2,2
18566,74,82,24395,25,5,0,5,8,2
18567,83,72,24395,59,26,12,14,20,10
18568,86,1479,24395,44,5,2,3,16,-8
18569,86,80,24395,20,14,6,8,4,3
18570,62,76,32384,1,0,0,0,2,0
18571,71,72,33232,14,0,0,0,0,-1
18572,74,72,33232,10,1,0,1,2,-2
18573,77,72,33232,18,4,3,1,4,-2
18574,65,63,15063,3,1,1,0,0,1
18575,20,1479,67313,3,0,0,0,0,-2
18576,74,84,39110,2,0,0,0,0,0
18577,35,64,6604,8,2,0,2,0,1
18578,41,64,6604,14,0,0,0,6,0
18579,80,69,15085,3,0,0,0,0,0
18580,38,86,8779,21,13,6,7,8,-7
18581,41,86,8779,68,24,9,15,49,6
18583,47,77,8779,19,9,5,4,6,4
18584,50,77,8779,5,0,0,0,6,-4
18585,65,69,24398,1,1,0,1,0,0
18586,65,64,18754,2,0,0,0,2,0
18587,71,72,14678,1,0,0,0,0,0
18588,74,72,14678,4,1,1,0,0,-1
18589,47,81,9547,9,1,0,1,6,-3
18590,50,89,9547,2,0,0,0,2,-1
18591,50,1479,244,3,1,1,0,0,-1
18592,2,79,5679,75,23,5,18,40,11
18593,5,79,5679,54,10,2,8,62,-8
18594,8,79,5679,77,16,4,12,97,7
18595,11,63,5679,71,10,3,7,54,-7
18596,14,76,5679,18,4,0,4,9,-6
18597,71,69,24916,66,21,13,8,26,6
18598,74,69,24916,71,31,9,22,12,13
18600,38,66,14993,1,1,1,0,0,0
18601,41,66,14993,1,1,0,1,0,1
18602,65,75,17889,59,16,3,13,30,-7
18603,68,75,17889,23,14,1,13,6,4
18604,71,75,17889,46,11,0,11,12,-4
18605,71,84,17889,6,2,1,1,0,-3
18606,71,74,17889,11,2,1,1,4,5
18607,74,62,17889,56,4,2,2,10,-3
18608,38,84,9557,7,1,0,1,4,0
18609,41,84,9557,8,1,0,1,4,0
18610,47,74,9557,3,0,0,0,6,0
18611,35,64,2665,22,5,2,3,14,1
18612,38,64,2665,42,7,3,4,12,3
18613,41,64,2665,28,1,0,1,12,-7
18614,2,65,1671,7,1,0,1,2,0
18615,5,65,1671,19,8,4,4,8,0
18617,11,79,1671,58,11,7,4,18,-4
18618,11,71,1671,23,14,5,9,28,-1
18619,14,71,1671,46,17,6,11,21,-12
18625,32,76,1671,34,5,1,4,2,-5
18626,32,84,1671,18,3,1,2,8,-6
18627,35,73,8606,80,33,9,24,32,-11
18628,38,73,8606,27,8,1,7,14,-9
18629,41,73,8606,76,49,16,33,38,10
18630,47,73,8606,80,49,20,29,76,0
18631,50,73,8606,68,57,16,41,50,13
18632,53,73,8606,76,57,23,34,40,-3
18633,56,73,8606,71,50,17,33,48,-7
18634,59,73,8606,74,49,21,28,50,-7
18635,62,73,8606,64,50,17,33,22,14
18508,83,77,33248,19,1,1,0,2,-2
18509,86,69,33248,12,1,1,0,2,-2
18641,74,87,8606,79,32,9,23,48,-16
18642,2,72,21335,77,60,18,42,53,0
18643,5,72,21335,66,62,24,38,42,6
18644,8,72,21335,62,40,17,23,22,-5
18645,11,78,21335,17,16,5,11,4,-2
18646,14,78,21335,6,2,1,1,0,1
18647,26,77,10642,13,8,2,6,8,4
18648,26,65,10642,28,7,4,3,8,2
18649,26,74,10642,4,0,0,0,4,-1
18650,29,77,10642,1,0,0,0,4,0
18651,32,82,10642,39,6,5,1,33,-11
18652,41,74,9903,1,0,0,0,0,-1
18653,35,77,10854,1,0,0,0,0,0
18654,38,85,396,79,44,22,22,8,6
18655,41,85,396,61,43,15,28,14,15
18656,47,85,396,77,85,39,46,30,29
18658,53,85,396,75,92,43,49,34,30
18659,56,85,396,77,73,31,42,36,13
18660,59,85,396,74,70,23,47,26,12
18661,62,85,396,80,80,24,56,40,-1
18662,65,85,396,82,69,22,47,47,14
18663,68,85,396,46,48,11,37,18,2
18664,71,85,396,45,48,16,32,20,19
18665,74,85,396,77,66,17,49,32,-6
18666,77,85,396,82,50,13,37,24,-15
18667,80,85,396,82,68,17,51,22,15
18668,83,85,396,82,56,11,45,14,1
18669,35,64,8622,52,30,18,12,14,7
18670,38,64,8622,66,30,11,19,16,0
18671,38,66,8622,10,5,5,0,2,-7
18672,41,66,8622,80,25,12,13,24,-10
18673,47,66,8622,16,5,2,3,6,0
18675,50,65,8622,77,41,14,27,26,-4
18677,56,81,8622,18,6,3,3,8,-1
18683,74,84,8622,79,63,31,32,20,6
18684,77,84,8622,63,27,13,14,12,-30
18685,80,87,8622,81,55,20,35,16,-18
18686,83,68,8622,42,14,5,9,16,-7
18687,47,74,7961,1,0,0,0,0,-1
18688,50,89,7961,9,4,2,2,2,-4
18689,56,89,7961,12,2,1,1,10,4
18690,59,89,7961,9,3,1,2,4,3
18691,62,71,7961,8,2,1,1,2,-2
18692,65,82,7961,9,1,1,0,8,-2
18693,74,70,25497,51,10,0,10,8,-2
18694,77,70,25497,40,6,2,4,6,1
18695,77,62,25497,18,6,0,6,8,3
18696,80,62,25497,38,6,1,5,12,-3
18698,86,73,128448,6,0,0,0,2,-1
18705,59,83,8554,51,4,1,3,73,-8
18706,83,82,90945,2,0,0,0,2,0
18707,80,81,78348,10,2,1,1,2,-3
18708,83,81,78348,10,5,2,3,0,6
18709,86,75,78348,39,10,3,7,4,-14
18710,47,78,13617,3,0,0,0,0,-2
18711,2,79,21380,80,86,40,46,133,-1
18712,5,79,21380,80,123,54,69,254,8
18713,8,79,21380,72,111,55,56,177,17
18714,11,79,21380,83,88,41,47,155,-24
18715,14,79,21380,27,27,15,12,51,0
18716,17,63,21380,41,23,10,13,49,1
18717,17,88,21380,20,13,3,10,22,-11
18718,20,88,21380,69,34,14,20,96,-27
18719,23,74,21380,80,41,14,27,130,-7
18721,29,74,21380,38,8,3,5,43,-7
18722,32,77,21380,23,9,2,7,18,-2
18723,32,79,21380,32,23,8,15,55,-4
18724,35,79,21380,32,5,1,4,25,-9
18725,47,88,8899,55,5,2,3,138,1
18726,50,64,8899,2,0,0,0,0,-1
18727,50,1479,8899,32,1,1,0,102,-2
18728,53,1479,8899,69,5,1,4,183,3
18729,56,1479,8899,74,10,5,5,135,8
18730,59,1479,8899,57,4,4,0,136,4
18731,62,1479,8899,78,4,3,1,171,-4
18732,65,1479,8899,46,4,1,3,85,1
18733,68,68,8899,39,2,1,1,57,-15
18734,71,75,8899,22,1,0,1,85,-6
18735,77,80,49325,30,9,3,6,11,4
18736,80,80,49325,81,32,14,18,30,7
18738,86,80,49325,57,44,22,22,29,-13
18739,86,82,49325,21,12,4,8,0,4
18740,71,85,40259,1,0,0,0,2,2
18741,74,85,40259,13,2,1,1,2,1
18742,77,85,40259,66,11,2,9,10,-5
18743,80,85,40259,30,6,0,6,12,6
18744,80,83,40259,11,2,1,1,0,1
18745,2,78,21372,78,49,5,44,150,23
18746,5,72,21372,68,59,17,42,124,24
18747,8,72,21372,81,57,12,45,120,14
18748,11,72,21372,83,78,18,60,112,53
18749,14,72,21372,48,22,2,20,56,4
18750,17,72,21372,82,28,5,23,100,7
18751,20,72,21372,79,24,5,19,70,26
18752,23,72,21372,80,26,4,22,80,19
18753,26,72,21372,75,27,5,22,64,29
18755,32,72,21372,81,31,9,22,71,40
18756,35,72,21372,82,17,1,16,44,15
18757,38,72,21372,81,20,4,16,41,18
18758,41,72,21372,38,12,3,9,22,3
18759,68,81,18094,14,4,2,2,0,5
18760,71,81,18094,81,59,23,36,20,32
18761,74,81,18094,75,63,16,47,24,31
18762,77,81,18094,62,40,16,24,20,10
18763,80,81,18094,75,52,17,35,39,8
18764,83,81,18094,56,35,11,24,6,16
18765,86,81,18094,64,34,8,26,20,4
18766,35,76,250613,23,5,1,4,16,5
18767,38,76,250613,66,13,2,11,26,15
18768,41,76,250613,47,7,4,3,43,-9
18637,68,73,8606,36,21,4,17,26,-7
18638,68,89,8606,9,3,1,2,4,0
18773,59,76,250613,16,3,2,1,12,-1
18774,62,76,250613,64,16,3,13,35,-5
18775,65,82,250613,7,1,1,0,0,-3
18776,68,76,250613,13,3,3,0,4,-2
18777,71,76,250613,13,3,0,3,4,4
18778,74,79,62587,1,0,0,0,0,0
18779,77,79,62587,24,6,5,1,12,0
18780,80,79,62587,78,26,8,18,32,0
18781,83,79,62587,3,0,0,0,0,-2
18782,83,85,62587,17,0,0,0,0,-1
18783,83,67,62587,49,14,6,8,8,-17
18784,86,67,62587,15,3,0,3,4,-8
18785,2,72,67944,41,7,5,2,159,-6
18786,5,72,67944,1,0,0,0,5,0
18787,5,63,67944,4,0,0,0,17,-1
18788,2,63,54620,14,0,0,0,26,-4
18790,8,81,54620,8,1,0,1,7,-5
18791,32,1479,3725,46,14,5,9,16,-11
18792,35,1479,3725,9,0,0,0,6,-6
18793,35,73,3725,58,24,8,16,28,-4
18794,50,63,3725,64,14,9,5,34,-16
18795,32,78,8654,74,23,7,16,52,16
18796,35,78,8654,81,24,3,21,55,9
18797,38,78,8654,81,33,8,25,48,-1
18798,41,78,8654,48,10,3,7,18,2
18799,47,83,8654,64,12,6,6,60,-11
18800,74,81,70479,27,7,2,5,16,6
18801,77,81,70479,57,9,3,6,41,-6
18802,80,81,70479,35,12,3,9,20,-3
18803,80,75,70479,13,5,1,4,4,3
18804,68,84,45561,3,0,0,0,0,-1
18805,71,84,45561,15,1,1,0,4,-2
18807,77,83,45561,39,6,1,5,26,-12
18808,80,83,45561,2,0,0,0,6,0
18809,80,79,45561,2,0,0,0,2,-1
18810,83,79,45561,5,0,0,0,2,-1
18811,80,63,128424,3,0,0,0,0,1
18812,83,63,128424,8,0,0,0,0,-5
18813,83,74,128424,22,3,0,3,6,-2
18814,41,83,326,3,1,0,1,0,-1
18815,50,64,9149,22,5,1,4,11,10
18816,53,64,9149,72,19,8,11,40,12
18817,56,83,9149,66,23,6,17,43,-7
18818,59,83,9149,39,10,2,8,20,-11
18819,47,86,2612,34,1,0,1,27,3
18820,50,86,2612,35,3,0,3,31,0
18821,53,86,2612,66,10,1,9,98,20
18822,56,86,2612,75,7,0,7,38,6
18824,62,86,2612,73,14,1,13,44,5
18825,65,86,2612,60,4,0,4,31,3
18826,68,86,2612,29,3,0,3,26,-8
18827,68,79,2612,14,3,1,2,9,-1
18828,71,75,2612,53,2,0,2,42,-12
18829,71,83,45417,5,1,0,1,5,1
18831,50,84,2706,30,6,1,5,24,0
18832,80,82,56091,62,13,7,6,25,10
18833,83,82,56091,53,8,4,4,21,-3
18834,86,82,56091,47,6,4,2,10,-5
18835,29,63,2680,50,18,6,12,36,-10
18836,32,63,2680,62,23,12,11,38,2
18837,35,63,2680,6,0,0,0,2,-1
18838,35,88,2680,71,18,9,9,54,0
18839,38,88,2680,75,17,5,12,56,-15
18840,38,73,10983,2,0,0,0,0,-1
18844,74,1479,47773,28,3,0,3,31,1
18845,77,1479,47773,71,15,5,10,74,11
18846,80,1479,47773,82,17,5,12,82,14
18847,83,1479,47773,80,37,7,30,62,34
18848,86,1479,47773,74,16,3,13,62,-8
18849,41,88,10315,2,1,0,1,0,1
18850,47,88,10315,5,0,0,0,0,0
18851,50,88,10315,13,2,2,0,4,-6
18852,53,72,10315,1,1,1,0,0,0
18853,83,68,20707,8,0,0,0,0,-2
18854,77,80,90416,20,4,2,2,37,-4
18855,80,80,90416,7,0,0,0,0,-3
18856,83,80,90416,30,5,3,2,37,-5
18857,86,80,90416,14,1,1,0,4,-6
18858,35,86,2089,6,0,0,0,0,-2
18859,38,82,2089,36,9,4,5,22,-11
18861,80,79,122839,10,3,3,0,4,3
18862,83,79,122839,3,0,0,0,0,0
18863,83,87,122839,39,11,5,6,25,-2
18864,86,87,122839,68,22,12,10,15,1
18865,83,89,38634,8,1,0,1,2,2
18866,86,89,38634,53,20,5,15,6,6
18867,77,86,45613,45,4,2,2,14,0
18868,80,86,45613,25,8,1,7,14,2
18869,83,86,45613,63,20,0,20,34,-1
18870,86,80,45613,77,22,4,18,32,-1
18871,74,71,30870,17,3,1,2,2,-4
18872,77,71,30870,63,13,5,8,8,-10
18873,80,71,30870,14,4,2,2,2,2
18874,83,71,30870,40,3,2,1,6,1
18875,74,79,41108,2,0,0,0,0,-1
18876,38,86,12839,19,3,3,0,19,-4
18878,41,62,12839,12,2,0,2,2,-2
18879,47,62,12839,1,0,0,0,0,0
18880,74,69,45597,3,0,0,0,0,0
18881,77,69,45597,2,0,0,0,0,-1
18882,80,69,45597,52,9,7,2,10,7
18883,83,89,45597,5,0,0,0,2,-3
18884,47,76,67157,16,0,0,0,52,-2
18885,71,62,88447,1,1,1,0,0,1
18886,74,62,88447,80,64,24,40,14,11
18887,77,62,88447,79,78,30,48,20,4
18888,80,62,88447,72,61,18,43,4,-7
18889,83,62,88447,80,84,24,60,26,2
18890,86,62,88447,82,99,36,63,24,18
18891,41,71,2697,3,1,0,1,0,0
18770,50,76,250613,43,17,2,15,40,19
18771,53,76,250613,69,15,0,15,40,-9
18900,26,83,563,82,83,31,52,58,22
18901,29,83,563,73,73,32,41,46,16
18902,32,83,563,82,74,28,46,76,15
18903,35,83,563,82,80,41,39,94,6
18904,38,83,563,75,72,37,35,58,1
18905,41,83,563,81,75,31,44,52,11
18906,47,83,563,70,78,31,47,58,7
18907,50,83,563,75,76,27,49,62,-2
18908,53,83,563,74,78,32,46,76,17
18909,56,84,563,41,28,9,19,28,-5
18910,41,78,14193,1,0,0,0,5,-1
18911,29,81,70160,3,1,0,1,2,1
18912,38,84,9528,7,5,2,3,0,4
18913,41,84,9528,3,1,0,1,0,1
18914,50,84,9528,3,0,0,0,0,-1
18915,38,88,8882,22,2,0,2,21,-5
18917,47,73,8882,66,14,5,9,54,9
18918,50,73,8882,64,12,5,7,42,-8
18919,53,73,8882,81,16,7,9,50,-9
18920,56,73,8882,82,13,4,9,49,-6
18921,59,73,8882,69,13,9,4,54,-4
18922,62,73,8882,82,13,5,8,34,-6
18923,65,73,8882,53,5,1,4,30,-6
18924,65,68,8882,16,1,0,1,4,1
18925,68,68,8882,35,5,2,3,10,-4
18926,68,71,8882,10,1,1,0,2,0
18927,71,83,8882,18,0,0,0,9,-5
18928,77,88,20709,17,3,1,2,0,1
18929,74,87,34860,72,21,13,8,14,-19
18930,77,87,34860,82,37,14,23,10,-21
18931,80,87,34860,80,34,16,18,6,-8
18932,83,87,34860,58,19,8,11,6,-11
18934,86,71,34860,67,11,0,11,8,-8
18935,2,72,11224,71,46,15,31,48,7
18936,5,72,11224,17,4,1,3,8,-5
18937,74,63,45744,7,1,0,1,0,0
18938,32,77,8635,74,36,16,20,72,8
18939,35,77,8635,78,26,17,9,43,15
18940,38,81,8635,76,32,19,13,44,-7
18941,41,81,8635,77,39,17,22,30,14
18942,47,81,8635,80,41,26,15,44,-4
18943,50,81,8635,80,32,12,20,52,-3
18944,53,76,8635,67,33,16,17,40,-9
18945,56,79,8635,65,39,16,23,44,18
18946,59,79,8635,80,30,11,19,50,-17
18947,62,74,8635,66,25,10,15,25,9
18948,65,74,8635,73,20,9,11,16,-7
18949,68,77,8635,47,13,4,9,12,8
18951,5,75,68102,58,21,5,16,94,9
18952,5,67,68102,13,7,1,6,52,-8
18953,8,67,68102,40,26,2,24,59,3
18954,11,67,68102,60,16,2,14,89,11
18955,14,67,68102,26,5,0,5,60,-5
18956,14,77,68102,11,3,0,3,10,0
18957,17,77,68102,73,29,1,28,105,28
18958,20,77,68102,67,14,2,12,94,10
18959,23,77,68102,56,18,3,15,83,19
18960,26,77,68102,25,6,4,2,28,5
18961,26,81,68102,34,17,1,16,53,-4
18962,29,81,68102,70,25,2,23,170,-11
18963,32,81,68102,19,4,1,3,41,-4
18964,71,76,20370,10,1,1,0,6,-4
18965,77,80,8004,16,2,0,2,2,-6
18966,80,80,8004,33,11,3,8,4,5
18968,86,74,8004,37,6,2,4,9,3
18969,2,77,29027,80,45,17,28,92,2
18970,5,78,29027,68,46,19,27,91,9
18971,8,78,29027,59,27,12,15,99,-11
18972,11,78,29027,36,18,6,12,46,-1
18974,14,76,29027,27,5,1,4,21,-8
18975,17,63,29027,18,12,5,7,24,10
18976,20,86,29027,78,12,5,7,65,-8
18977,23,86,29027,57,9,2,7,22,-2
18978,26,86,29027,59,9,3,6,40,-8
18979,29,86,29027,78,11,5,6,34,-3
18980,32,62,29027,21,4,1,3,12,4
18981,77,72,45435,7,2,1,1,2,0
18982,80,72,45435,10,1,0,1,4,-5
18983,83,72,45435,2,0,0,0,0,0
18984,86,72,45435,19,1,0,1,6,-7
18986,5,76,22687,8,10,4,6,6,-5
18987,5,65,22687,61,50,18,32,30,-5
18988,8,65,22687,65,54,20,34,67,10
18989,11,65,22687,73,38,9,29,43,17
18990,14,65,22687,47,15,7,8,51,6
18991,17,65,22687,80,40,13,27,56,14
18992,20,65,22687,39,14,7,7,18,10
18993,23,65,22687,52,8,2,6,28,-6
18994,2,78,29030,77,27,16,11,122,6
18995,5,78,29030,77,25,9,16,107,7
18996,8,78,29030,84,27,13,14,100,-4
18997,11,65,29030,83,26,12,14,108,-8
18998,14,65,29030,15,0,0,0,28,1
18999,14,81,29030,4,0,0,0,0,0
19000,14,83,29030,18,3,0,3,10,-7
19001,83,69,107151,22,4,0,4,21,10
19003,80,63,49951,8,1,0,1,2,-1
19004,83,63,49951,75,14,6,8,40,-5
19005,86,63,49951,71,21,8,13,38,6
19006,41,74,10893,9,0,0,0,6,-2
19007,50,89,10893,18,8,2,6,12,-3
19008,50,80,10893,1,0,0,0,0,0
19009,53,80,10893,3,0,0,0,0,1
19010,56,84,10893,14,1,0,1,6,3
19011,56,64,10893,5,0,0,0,0,-2
19012,32,82,53124,9,2,0,2,8,-3
19013,77,75,52849,13,5,1,4,13,-1
19014,14,71,11804,2,0,0,0,0,0
19015,17,71,11804,8,0,0,0,47,-3
19016,23,71,11804,4,0,0,0,27,0
18897,17,83,563,76,83,33,50,46,8
18898,20,83,563,82,94,41,53,59,6
19021,38,80,11804,12,0,0,0,29,-1
19022,41,64,11804,1,0,0,0,0,0
19023,2,67,68097,15,9,3,6,13,2
19024,5,67,68097,64,20,2,18,71,5
19025,8,67,68097,63,22,8,14,30,-3
19026,11,67,68097,78,24,4,20,71,-6
19027,14,67,68097,12,3,1,2,30,-2
19028,14,71,68097,12,4,3,1,12,-1
19029,17,71,68097,32,8,0,8,39,-12
19030,17,78,68097,6,0,0,0,4,-1
19031,23,72,68097,13,0,0,0,6,1
19032,23,86,68097,8,0,0,0,15,-4
19033,26,72,68097,5,1,1,0,0,1
19034,29,72,68097,6,2,0,2,2,2
19035,32,72,68097,53,8,1,7,37,9
19036,35,76,68097,21,2,0,2,8,-5
19038,65,65,37683,37,23,12,11,50,-1
19039,68,65,37683,48,15,9,6,38,6
19040,71,65,37683,80,39,20,19,76,12
19041,74,65,37683,79,26,15,11,67,-8
19042,77,65,37683,78,34,14,20,69,11
19043,80,75,37683,68,29,12,17,110,4
19044,83,75,37683,51,20,10,10,53,-8
19045,86,75,37683,63,47,19,28,71,17
19046,17,84,27701,3,1,0,1,0,1
19047,20,84,27701,36,22,11,11,10,-3
19048,23,84,27701,31,3,2,1,4,-9
19049,23,83,27701,6,6,3,3,4,1
19050,26,83,27701,7,3,3,0,4,3
19051,2,62,21395,79,70,12,58,102,26
19052,5,62,21395,70,55,12,43,128,1
19053,8,62,21395,81,81,23,58,112,-1
19055,11,65,21395,16,5,2,3,18,-9
19056,14,65,21395,48,37,10,27,42,14
19057,17,65,21395,82,67,20,47,80,3
19058,20,65,21395,82,28,7,21,70,-4
19059,23,65,21395,73,42,14,28,74,1
19060,26,86,21395,1,0,0,0,0,0
19061,29,86,21395,76,34,6,28,52,7
19062,32,86,21395,68,34,10,24,84,8
19063,35,86,21395,82,33,6,27,57,13
19064,74,80,32735,2,1,0,1,0,1
19065,77,80,32735,42,12,3,9,6,2
19066,77,76,32735,20,5,3,2,4,3
19067,80,76,32735,50,18,5,13,18,-9
19068,83,76,32735,14,2,1,1,11,-3
19069,74,1479,13762,1,0,0,0,0,0
19070,77,1479,13762,5,0,0,0,2,-1
19072,23,67,13239,1,0,0,0,2,-1
19073,26,67,13239,8,0,0,0,16,1
19074,26,74,13239,31,4,1,3,46,-2
19076,71,68,45572,20,8,5,3,6,-11
19077,74,68,45572,50,22,7,15,24,9
19078,77,68,45572,76,53,25,28,44,15
19079,80,68,45572,82,54,23,31,43,-13
19080,83,68,45572,82,75,31,44,54,-9
19081,86,68,45572,55,34,10,24,54,-9
19082,77,84,79456,13,0,0,0,18,-3
19083,23,66,69043,9,1,0,1,2,0
19084,26,66,69043,15,1,0,1,8,1
19085,32,66,69043,2,0,0,0,0,0
19086,80,1479,45611,49,10,4,6,51,1
19087,80,84,45611,10,0,0,0,9,-1
19088,74,77,45562,11,0,0,0,2,1
19090,80,77,45562,60,16,6,10,31,-6
19091,83,87,45562,71,19,12,7,31,-7
19092,86,87,45562,81,27,7,20,35,-8
19093,74,65,38635,1,1,0,1,0,0
19094,77,82,38635,1,0,0,0,4,0
19095,2,63,32745,77,21,8,13,67,2
19096,5,63,32745,75,14,3,11,74,-9
19097,8,63,32745,84,34,7,27,68,34
19098,11,63,32745,75,21,6,15,50,29
19099,14,63,32745,47,22,3,19,24,6
19100,17,63,32745,77,28,4,24,42,-4
19101,20,63,32745,82,26,3,23,39,-5
19102,23,63,32745,59,16,1,15,24,12
19103,26,63,32745,81,12,2,10,64,14
19104,29,63,32745,81,14,1,13,48,-14
19105,32,63,32745,72,12,2,10,26,-1
19107,38,63,32745,67,8,3,5,24,-1
19108,41,70,32745,63,11,0,11,18,22
19109,83,74,114825,1,0,0,0,2,0
19110,86,74,114825,10,0,0,0,0,-1
19111,2,63,68036,80,48,15,33,115,12
19112,5,63,68036,63,20,6,14,103,-9
19113,8,67,68036,80,47,21,26,118,2
19114,11,67,68036,60,25,11,14,94,3
19115,14,67,68036,45,9,5,4,18,-6
19116,17,76,68036,66,12,6,6,59,-23
19117,17,62,68036,6,2,1,1,6,3
19118,29,72,611754,4,0,0,0,0,-1
19120,32,75,611754,3,0,0,0,0,0
19121,80,72,46901,23,2,1,1,27,-7
19122,83,72,46901,79,25,13,12,50,7
19123,86,72,46901,78,36,22,14,71,-19
19125,23,74,68929,1,0,0,0,5,0
19126,26,75,68929,5,0,0,0,19,0
19127,32,69,68929,41,5,3,2,117,-5
19128,35,69,68929,43,2,0,2,130,-11
19129,38,69,68929,2,0,0,0,4,0
19130,38,75,68929,17,0,0,0,43,-3
19131,77,67,41302,11,0,0,0,0,-2
19132,83,74,41302,1,0,0,0,0,-1
19133,77,68,37294,53,7,5,2,13,-7
19134,80,1479,37294,55,10,3,7,10,3
19135,83,1479,37294,42,8,2,6,4,-1
19136,83,75,37294,30,6,2,4,8,-5
19137,2,62,54559,42,16,7,9,8,1
19138,5,62,54559,11,3,1,2,4,0
19018,29,79,11804,28,0,0,0,80,-2
19019,32,79,11804,3,0,0,0,0,-1
19143,20,63,54559,36,21,10,11,14,0
19144,23,74,54559,56,29,11,18,26,7
19145,74,66,45499,2,0,0,0,10,-2
19146,83,71,45499,2,0,0,0,0,-1
19147,38,77,8834,24,3,2,1,27,9
19148,41,77,8834,23,5,3,2,25,-5
19149,41,65,8834,23,12,2,10,58,-6
19150,47,65,8834,76,24,6,18,116,-2
19151,50,65,8834,46,7,1,6,53,-3
19152,53,65,8834,26,9,2,7,44,3
19153,53,77,8834,28,6,1,5,27,-1
19154,53,62,8834,21,2,0,2,39,4
19155,56,62,8834,45,7,1,6,108,1
19157,62,71,8834,62,14,2,12,74,-15
19158,65,86,8834,25,4,1,3,33,3
19159,74,88,20722,34,7,1,6,10,0
19161,80,88,20722,70,17,6,11,20,-2
19162,83,88,20722,49,15,4,11,12,-4
19163,83,80,20722,6,1,0,1,0,1
19164,83,62,20722,9,3,1,2,4,0
19165,74,65,13260,4,1,1,0,2,-1
19166,74,87,13260,19,3,0,3,6,-7
19167,77,87,13260,71,8,2,6,28,-5
19168,80,66,13260,43,6,2,4,30,-12
19169,83,66,13260,33,5,1,4,21,-6
19170,50,69,11008,11,1,0,1,0,0
19171,56,73,11008,79,35,17,18,29,1
19172,59,73,11008,71,34,13,21,18,-5
19173,62,73,11008,80,29,10,19,42,-1
19174,65,89,11008,73,18,6,12,20,12
19175,68,89,11008,39,20,8,12,12,7
19176,71,89,11008,82,49,24,25,32,7
19178,77,86,11008,79,43,21,22,28,-15
19179,80,86,11008,78,29,10,19,30,-2
19180,83,86,11008,52,12,5,7,20,-2
19181,77,76,45423,2,1,1,0,0,0
19182,80,76,45423,61,18,5,13,8,-2
19183,83,76,45423,21,3,0,3,4,-2
19184,86,62,45423,13,5,3,2,6,0
19185,71,83,88746,7,2,1,1,0,0
19186,74,83,88746,9,1,1,0,4,-1
19187,77,83,88746,12,5,5,0,6,2
19188,80,83,88746,13,10,2,8,4,2
19189,83,83,88746,16,4,1,3,6,0
19190,86,83,88746,27,6,4,2,7,1
19191,86,84,88746,49,18,10,8,25,4
19192,71,68,45280,1,0,0,0,2,-1
19194,2,79,72167,39,11,3,8,93,16
19196,8,81,72167,61,9,1,8,150,8
19197,8,79,72167,11,5,1,4,34,4
19198,11,79,72167,60,14,2,12,142,5
19199,14,79,72167,13,1,0,1,12,1
19200,77,68,66515,9,0,0,0,2,-1
19201,80,68,66515,24,3,2,1,4,-3
19202,83,69,66515,3,1,0,1,0,0
19203,86,69,66515,6,1,0,1,0,0
19204,35,85,8714,36,4,2,2,68,1
19205,38,85,8714,39,11,5,6,120,7
19206,38,88,8714,12,4,1,3,33,0
19207,41,88,8714,76,28,9,19,261,2
19208,47,88,8714,75,39,15,24,257,-5
19209,50,88,8714,55,28,10,18,116,-10
19210,50,74,8714,29,20,8,12,58,11
19211,53,74,8714,57,33,15,18,154,6
19213,56,74,8714,18,12,5,7,34,4
19214,59,74,8714,69,31,11,20,160,0
19215,62,74,8714,76,24,3,21,174,-4
19216,65,74,8714,15,3,3,0,21,2
19217,2,89,42241,65,23,8,15,82,-4
19220,11,63,42241,2,0,0,0,2,0
19221,80,85,38640,19,0,0,0,2,2
19222,68,80,45143,9,4,2,2,0,3
19223,71,80,45143,28,2,2,0,12,-5
19224,74,80,45143,50,19,10,9,9,4
19225,77,80,45143,82,43,19,24,26,17
19226,80,80,45143,82,33,12,21,24,13
19227,83,80,45143,78,29,14,15,36,-14
19228,86,80,45143,39,12,4,8,14,-12
19229,77,69,49519,29,7,1,6,8,-4
19230,80,69,49519,17,1,1,0,2,1
19232,83,75,49519,19,8,0,8,8,1
19233,86,75,49519,57,11,3,8,16,0
19234,71,72,38642,23,7,2,5,4,2
19235,74,72,38642,11,1,1,0,0,-4
19236,77,72,38642,39,19,8,11,6,-13
19237,80,72,38642,9,2,0,2,2,0
19238,80,73,38642,3,1,1,0,0,1
19239,80,84,38642,27,7,5,2,6,-7
19240,83,84,38642,20,5,3,2,0,-12
19241,86,84,38642,1,0,0,0,0,0
19242,80,71,44500,3,0,0,0,2,0
19245,5,85,27953,1,0,0,0,0,0
19246,8,85,27953,4,1,1,0,2,-2
19247,11,70,27953,12,4,1,3,8,-7
19248,14,86,27953,26,14,3,11,10,1
19249,17,86,27953,45,23,7,16,20,-12
19251,23,70,27953,2,1,0,1,0,-1
19252,74,71,23294,4,2,0,2,2,-2
19253,71,78,26395,2,0,0,0,0,-2
19254,74,78,26395,11,2,0,2,2,0
19255,77,78,26395,13,6,4,2,4,1
19256,80,78,26395,4,0,0,0,0,0
19257,80,66,26395,5,2,0,2,0,-2
19258,83,71,26395,14,9,5,4,2,1
19259,86,71,26395,50,11,4,7,4,-2
19260,11,68,3723,0,0,0,0,0,0
19261,17,68,3723,7,2,1,1,4,-3
19262,20,68,3723,8,1,1,0,2,-3
19263,20,88,3723,44,16,8,8,74,-7
19264,23,88,3723,9,4,1,3,4,-1
19140,11,1479,54559,78,43,16,27,49,3
19141,14,1479,54559,13,2,1,1,2,-3
19269,71,76,45924,5,0,0,0,7,-3
19270,77,76,45924,6,1,1,0,11,-4
19271,80,76,45924,25,9,2,7,35,-1
19272,83,76,45924,47,12,2,10,45,-6
19273,86,76,45924,79,19,4,15,68,18
19274,14,68,73029,4,0,0,0,17,-1
19275,74,65,20719,4,2,1,1,2,1
19276,74,84,20719,17,2,0,2,8,1
19277,77,79,20719,9,1,0,1,10,3
19278,77,71,20719,20,6,1,5,10,3
19279,80,74,20719,31,11,2,9,17,3
19280,83,87,20719,5,2,0,2,2,-1
19281,86,82,20719,4,0,0,0,0,1
19282,74,68,38639,7,1,1,0,4,1
19283,77,68,38639,20,5,3,2,2,-4
19284,80,64,38639,4,1,0,1,2,-3
19286,86,73,38639,53,13,5,8,10,-2
19287,2,79,42501,46,18,6,12,44,1
19288,2,67,42501,10,8,1,7,6,2
19289,5,67,42501,70,31,15,16,100,-4
19290,71,63,41939,1,0,0,0,2,0
19291,74,63,41939,3,0,0,0,0,-2
19292,77,63,41939,5,0,0,0,0,-2
19293,2,78,67946,3,0,0,0,0,-3
19294,5,63,67946,12,1,0,1,17,-2
19295,11,88,67946,7,0,0,0,21,-6
19296,14,88,67946,1,0,0,0,0,-1
19297,26,63,24155,9,0,0,0,8,-1
19298,29,63,24155,6,2,0,2,4,-2
19299,32,63,24155,1,0,0,0,2,0
19300,74,66,15743,80,33,11,22,16,-14
19301,77,66,15743,80,48,21,27,24,-6
19303,83,66,15743,71,31,14,17,12,0
19304,86,66,15743,26,6,1,5,4,-3
19305,86,69,15743,23,3,2,1,4,-1
19306,68,78,65620,2,0,0,0,0,-1
19307,71,78,65620,18,2,1,1,8,-3
19308,74,78,65620,54,18,13,5,16,7
19309,77,78,65620,65,13,4,9,26,3
19310,80,78,65620,51,11,1,10,18,5
19311,83,78,65620,76,17,6,11,14,6
19312,86,89,65620,37,8,2,6,6,-5
19313,65,65,31274,2,0,0,0,0,0
19314,68,65,31274,46,27,10,17,12,17
19315,71,65,31274,78,47,19,28,20,20
19316,74,65,31274,82,52,23,29,12,7
19317,77,82,31274,78,53,31,22,14,1
19318,80,82,31274,82,53,24,29,8,23
19320,86,65,31274,80,47,23,24,12,-9
19321,71,85,45179,4,0,0,0,2,0
19322,74,85,45179,21,3,2,1,2,4
19323,77,85,45179,5,1,0,1,2,-2
19324,80,85,45179,66,12,3,9,51,2
19325,83,85,45179,45,7,0,7,6,-3
19326,86,75,45179,19,3,0,3,13,-3
19327,38,76,9159,19,0,0,0,48,-3
19328,41,76,9159,31,1,0,1,97,-2
19329,47,76,9159,57,4,2,2,115,-2
19330,50,62,9159,19,1,0,1,50,0
19331,53,62,9159,74,2,1,1,171,-8
19332,56,79,9159,71,4,2,2,171,-3
19333,59,79,9159,45,3,1,2,76,2
19334,62,79,9159,19,3,0,3,105,4
19335,71,76,16718,11,1,0,1,6,0
19340,14,89,21322,42,12,3,9,71,-5
19341,17,89,21322,71,13,3,10,113,26
19342,20,89,21322,56,8,2,6,118,3
19343,23,89,21322,47,17,8,9,39,9
19344,26,89,21322,48,6,0,6,108,-6
19345,26,85,10832,59,12,4,8,14,-7
19346,29,85,10832,49,16,7,9,12,-1
19347,32,69,10832,76,27,7,20,20,3
19348,35,69,10832,58,21,10,11,8,-3
19349,38,85,10832,2,0,0,0,0,0
19350,74,79,39667,10,0,0,0,4,-10
19351,77,83,39667,15,1,0,1,4,0
19352,80,82,39667,22,3,1,2,10,3
19353,83,82,39667,32,5,2,3,8,0
19354,86,82,39667,73,17,2,15,23,6
19355,71,85,62459,1,0,0,0,0,0
19357,83,74,62459,16,5,1,4,6,-6
19359,74,87,45183,26,5,2,3,8,-10
19360,77,75,45183,12,2,1,1,2,1
19361,74,73,43436,1,1,1,0,0,1
19362,77,73,43436,61,10,5,5,28,-1
19363,80,73,43436,5,0,0,0,2,-1
19364,83,73,43436,58,8,2,6,34,-8
19365,86,73,43436,37,7,3,4,8,5
19366,71,81,77291,52,18,9,9,14,3
19367,74,81,77291,82,65,29,36,37,38
19368,77,81,77291,77,66,30,36,30,9
19369,80,81,77291,74,85,40,45,38,13
19370,83,81,77291,80,100,39,61,42,15
19371,86,81,77291,82,128,41,87,62,24
19372,71,62,37197,14,4,0,4,4,-3
19373,74,62,37197,1,0,0,0,0,-3
19375,80,62,37197,4,0,0,0,0,-2
19376,65,64,10388,82,52,22,30,51,20
19377,68,64,10388,36,17,9,8,22,-4
19378,71,64,10388,81,65,26,39,71,21
19379,74,64,10388,82,59,23,36,79,-2
19380,77,64,10388,75,53,20,33,69,-5
19381,80,64,10388,72,33,18,15,62,-25
19382,83,64,10388,78,62,25,37,37,16
19383,86,64,10388,73,75,34,41,51,17
19384,68,68,45276,48,31,14,17,18,-15
19385,71,68,45276,69,28,9,19,37,-5
19386,74,68,45276,79,54,15,39,38,10
19387,77,68,45276,76,59,20,39,43,17
19388,80,68,45276,31,26,10,16,13,-2
19266,26,73,3723,3,0,0,0,6,-1
19267,32,74,3723,4,1,1,0,4,0
19393,71,72,10711,26,3,1,2,12,-1
19394,74,72,10711,64,24,3,21,34,2
19395,77,72,10711,82,18,3,15,77,15
19396,80,71,10711,79,19,4,15,55,21
19397,83,71,10711,63,13,4,9,34,10
19398,86,71,10711,82,20,3,17,44,-28
19399,71,76,44804,37,18,7,11,8,-1
19400,74,76,44804,81,50,17,33,47,23
19401,77,76,44804,71,28,8,20,28,-9
19402,80,76,44804,69,30,13,17,40,-8
19403,83,71,44804,82,34,13,21,33,-4
19404,86,71,44804,18,2,1,1,14,-1
19405,86,74,44804,63,33,18,15,50,-2
19406,65,80,23856,9,1,0,1,2,-3
19407,68,80,23856,42,20,7,13,6,9
19408,71,80,23856,69,33,16,17,18,-15
19410,77,80,23856,81,51,21,30,18,-2
19411,80,74,23856,56,37,14,23,16,9
19412,83,74,23856,72,47,27,20,14,-23
19413,86,74,23856,82,74,30,44,47,-12
19414,65,71,25647,62,52,18,34,16,-2
19415,68,71,25647,40,24,4,20,8,3
19416,71,71,25647,80,56,19,37,26,-12
19417,74,71,25647,76,56,24,32,25,-12
19418,77,71,25647,55,34,12,22,18,-9
19419,80,71,25647,82,43,18,25,29,-10
19420,83,71,25647,62,48,24,24,20,10
19421,86,71,25647,82,69,28,41,26,-13
19422,65,77,32895,77,27,13,14,14,18
19423,68,77,32895,46,15,4,11,10,-8
19424,71,77,32895,82,39,13,26,45,1
19425,74,77,32895,82,37,15,22,28,4
19427,80,77,32895,66,34,14,20,33,12
19428,83,77,32895,82,76,31,45,31,34
19429,86,77,32895,80,76,33,43,34,2
19430,68,63,45608,42,16,5,11,14,4
19431,71,63,45608,64,25,7,18,40,22
19432,74,63,45608,72,42,10,32,41,-3
19433,77,62,45608,82,43,12,31,46,-14
19434,80,62,45608,81,50,13,37,64,12
19435,83,62,45608,82,44,17,27,64,1
19436,86,66,45608,82,39,18,21,54,0
19437,68,69,19973,45,11,2,9,10,3
19438,71,69,19973,79,19,8,11,22,0
19439,74,69,19973,71,17,3,14,8,21
19440,77,69,19973,68,7,2,5,18,-5
19441,80,69,19973,68,25,3,22,20,5
19442,83,69,19973,73,21,6,15,30,23
19444,74,64,37254,1,0,0,0,0,0
19445,80,64,37254,3,0,0,0,2,-2
19446,83,64,37254,16,2,1,1,23,-5
19447,68,66,15019,4,0,0,0,2,-4
19448,71,66,15019,48,12,2,10,10,-9
19449,74,66,15019,37,13,4,9,8,-11
19450,77,66,15019,35,10,0,10,10,-1
19451,80,66,15019,27,2,0,2,8,-11
19452,83,69,15019,21,5,2,3,16,8
19453,86,69,15019,2,0,0,0,0,1
19454,86,72,15019,1,1,0,1,0,0
19455,65,62,33604,5,3,3,0,4,2
19456,68,62,33604,20,10,3,7,6,0
19457,71,62,33604,26,11,2,9,6,-4
19458,74,62,33604,15,4,0,4,6,-3
19459,74,84,33604,3,2,2,0,4,0
19461,80,84,33604,68,35,18,17,8,-6
19462,83,84,33604,53,29,14,15,20,3
19463,86,84,33604,26,14,9,5,6,-9
19464,68,70,37850,16,2,0,2,14,-5
19465,71,70,37850,7,0,0,0,2,-3
19466,74,70,37850,36,8,1,7,8,0
19467,77,70,37850,19,2,0,2,21,-5
19468,80,70,37850,41,7,5,2,37,-4
19469,83,70,37850,21,3,1,2,18,-6
19470,83,79,37850,47,14,4,10,69,13
19471,86,79,37850,36,11,4,7,37,5
19472,86,70,37850,21,1,0,1,8,0
19473,68,74,38633,26,4,2,2,8,-7
19474,71,74,38633,30,6,3,3,18,-6
19475,74,74,38633,58,23,10,13,23,5
19476,77,74,38633,82,43,22,21,46,10
19478,83,74,38633,63,40,13,27,28,-1
19479,83,81,38633,19,18,10,8,12,-3
19480,86,81,38633,75,47,13,34,30,8
19481,74,67,40634,1,0,0,0,0,0
19482,77,547,40634,43,10,4,6,12,2
19483,80,547,40634,57,19,10,9,20,-8
19484,83,547,40634,79,29,12,17,22,3
19485,86,75,40634,57,23,13,10,14,0
19486,68,75,37434,6,2,0,2,0,5
19487,71,75,37434,17,2,0,2,8,6
19488,74,75,37434,64,9,1,8,45,6
19489,77,75,37434,64,19,2,17,55,-6
19490,80,75,37434,74,28,4,24,44,8
19491,83,67,37434,59,9,1,8,36,-19
19492,86,67,37434,30,7,3,4,32,1
19493,86,547,37434,18,5,0,5,7,5
19495,80,70,26431,1,0,0,0,0,-1
19496,23,64,12796,15,1,0,1,18,-2
19497,26,1479,12796,45,6,2,4,48,0
19498,29,1479,12796,37,4,0,4,54,2
19499,32,1479,12796,57,10,6,4,73,-12
19500,35,64,12796,74,13,4,9,59,4
19501,38,73,12796,1,0,0,0,0,0
19503,74,87,45427,73,7,4,3,42,-27
19504,77,87,45427,78,17,6,11,48,5
19505,80,87,45427,77,17,2,15,45,-13
19506,83,65,45427,76,14,2,12,34,-3
19507,86,65,45427,52,13,5,8,40,12
19508,2,65,30697,69,54,19,35,129,8
19509,5,65,30697,11,8,2,6,26,-3
19390,86,68,45276,82,92,30,62,40,-14
19391,65,72,10711,65,18,2,16,20,-7
19514,17,72,30697,81,61,26,35,98,-2
19515,20,72,30697,57,34,15,19,46,9
19516,23,72,30697,55,24,14,10,32,4
19517,26,83,30697,78,73,28,45,33,26
19518,29,83,30697,81,63,26,37,68,1
19519,32,83,30697,57,34,8,26,46,0
19520,35,65,30697,34,15,11,4,17,0
19521,38,65,30697,69,17,4,13,51,0
19522,38,1479,30697,12,13,10,3,2,10
19523,41,85,30697,44,22,10,12,25,8
19524,74,1479,45575,1,0,0,0,0,0
19525,77,1479,45575,1,0,0,0,0,0
19526,80,1479,45575,12,2,2,0,2,2
19527,80,72,45575,32,8,6,2,22,4
19528,83,72,45575,72,27,13,14,36,12
19529,86,72,45575,41,8,3,5,28,-19
19531,77,63,37194,33,7,1,6,4,-7
19532,80,63,37194,17,1,0,1,8,-4
19533,83,75,37194,38,11,5,6,26,-11
19534,83,547,37194,18,5,1,4,0,7
19535,86,547,37194,41,7,1,6,20,0
19536,2,72,35030,1,0,0,0,0,-1
19537,5,72,35030,80,63,21,42,69,8
19538,8,72,35030,30,10,5,5,16,-4
19539,8,71,35030,25,13,4,9,10,-5
19540,11,65,35030,35,11,5,6,16,-2
19541,11,88,35030,12,11,3,8,8,-1
19542,14,88,35030,33,11,3,8,12,-5
19543,17,88,35030,74,43,16,27,38,6
19544,20,1479,35030,65,30,9,21,44,-7
19545,23,1479,35030,27,11,4,7,12,-5
19546,74,80,45581,13,3,2,1,8,6
19548,80,80,45581,13,0,0,0,7,-5
19549,80,74,45581,27,9,6,3,4,-6
19550,86,85,45581,8,1,1,0,2,-2
19551,74,65,45284,2,0,0,0,0,0
19552,77,65,45284,30,5,1,4,6,-3
19553,77,75,45284,21,5,3,2,8,-2
19554,80,75,45284,82,40,13,27,35,5
19555,83,75,45284,52,25,8,17,34,0
19556,86,75,45284,81,53,12,41,39,17
19557,71,81,39042,4,0,0,0,4,-1
19558,74,81,39042,43,16,9,7,13,1
19559,77,81,39042,80,35,14,21,45,17
19560,80,81,39042,74,28,10,18,31,-4
19561,83,81,39042,62,44,20,24,35,11
19562,83,74,39042,19,4,2,2,10,-5
19563,86,74,39042,78,31,11,20,44,-7
19565,5,71,2698,40,28,12,16,44,-8
19566,8,71,2698,66,33,14,19,76,-11
19567,8,74,2698,15,7,2,5,18,-13
19568,11,74,2698,83,54,22,32,114,5
19569,14,78,2698,43,35,12,23,22,13
19570,17,78,2698,11,5,1,4,18,1
19571,17,72,2698,9,2,0,2,4,-6
19572,17,84,2698,38,37,13,24,14,6
19573,20,84,2698,62,27,12,15,66,-9
19574,20,74,2698,14,3,1,2,6,0
19575,23,68,2698,28,9,1,8,16,-7
19576,23,89,2698,20,12,2,10,2,-4
19577,26,74,2698,32,3,0,3,38,-5
19578,68,84,32436,2,0,0,0,0,-1
19579,71,84,32436,17,6,3,3,10,-1
19580,74,84,32436,5,0,0,0,0,-1
19582,26,63,67480,4,0,0,0,0,2
19583,29,74,67480,1,0,0,0,0,-2
19584,74,83,45618,9,3,0,3,2,-4
19585,77,83,45618,3,0,0,0,0,-2
19586,68,1479,17440,4,0,0,0,0,-2
19587,71,1479,17440,18,4,0,4,2,-3
19588,74,1479,17440,71,31,9,22,10,6
19589,77,1479,17440,72,43,20,23,19,-1
19590,80,1479,17440,71,51,33,18,12,10
19591,83,1479,17440,77,69,34,35,14,6
19592,86,1479,17440,69,43,18,25,27,-13
19593,2,89,32142,61,15,6,9,24,-13
19594,5,89,32142,30,12,2,10,16,2
19595,8,79,32142,74,25,6,19,56,5
19596,11,77,32142,73,15,4,11,38,-20
19597,14,80,8663,42,11,3,8,28,-5
19599,20,80,8663,53,18,5,13,14,-4
19600,23,80,8663,65,16,7,9,16,-13
19601,26,80,8663,81,32,16,16,48,15
19602,29,80,8663,80,60,23,37,53,-2
19603,32,80,8663,74,59,23,36,52,27
19604,35,80,8663,82,70,25,45,52,3
19605,38,80,8663,70,54,22,32,36,6
19606,41,80,8663,66,44,12,32,66,2
19607,47,75,8663,61,21,6,15,52,-3
19608,50,75,8663,74,23,13,10,54,0
19609,53,73,8663,79,29,14,15,40,-31
19610,56,73,8663,66,25,9,16,34,-12
19611,2,88,67389,8,1,1,0,19,0
19612,5,88,67389,45,3,1,2,162,-1
19613,8,80,67389,15,1,0,1,41,-11
19614,8,88,67389,9,0,0,0,56,-1
19616,2,83,28716,20,9,2,7,4,-7
19617,35,74,70025,5,0,0,0,5,0
19618,41,74,70025,5,0,0,0,23,0
19619,2,88,31653,71,30,14,16,49,3
19620,5,65,31653,33,8,1,7,37,2
19622,74,63,45614,30,10,6,4,6,-2
19623,77,63,45614,4,1,0,1,4,-4
19624,80,83,45614,3,0,0,0,0,0
19625,80,68,45614,21,5,0,5,8,6
19626,83,67,45614,21,3,2,1,6,-6
19627,2,77,21410,70,71,40,31,150,2
19628,5,77,21410,42,29,13,16,102,3
19629,5,79,21410,19,30,14,16,49,12
19630,8,79,21410,80,109,48,61,252,28
19511,8,76,30697,79,87,37,50,111,3
19512,11,76,30697,78,75,42,33,139,-9
19635,20,63,21410,40,30,16,14,67,-3
19636,20,89,21410,13,10,5,5,31,0
19640,29,77,21410,16,6,3,3,23,4
19641,32,77,21410,60,36,14,22,83,10
19642,35,77,21410,14,2,0,2,28,-2
19643,47,75,4090,48,11,2,9,28,-6
19644,50,75,4090,76,36,10,26,14,-5
19645,53,75,4090,81,62,13,49,28,-6
19646,56,76,4090,74,56,16,40,62,5
19647,59,76,4090,82,49,11,38,48,0
19648,65,76,4090,82,47,7,40,46,-27
19649,68,76,4090,48,27,6,21,22,-14
19650,71,77,4090,82,44,10,34,44,3
19651,74,77,4090,81,52,9,43,36,-8
19652,77,77,4090,62,23,6,17,18,-1
19653,80,77,4090,49,21,5,16,22,-10
19655,83,75,4090,2,0,0,0,0,-2
19656,77,62,45535,1,1,0,1,0,1
19657,2,78,76942,22,6,2,4,4,5
19658,11,78,76942,48,8,1,7,32,3
19659,80,64,45162,1,1,1,0,2,1
19660,14,78,64315,27,13,3,10,29,4
19661,17,78,64315,23,3,3,0,12,-2
19662,17,88,64315,15,2,1,1,37,-9
19663,71,79,37628,2,0,0,0,2,-1
19664,77,63,61281,42,16,3,13,39,0
19665,80,63,61281,61,13,6,7,55,0
19666,83,20120,61281,82,41,10,31,53,-4
19667,86,20120,61281,65,29,3,26,44,0
19668,80,72,11583,3,0,0,0,4,-4
19669,2,63,54065,18,7,2,5,12,1
19670,5,76,54065,7,3,1,2,0,6
19672,11,80,54065,14,0,0,0,9,-7
19673,74,64,26403,1,0,0,0,0,0
19674,68,82,32889,2,0,0,0,0,-1
19675,74,81,32889,2,1,1,0,0,1
19676,77,81,32889,45,18,7,11,17,-10
19677,80,68,32889,75,51,30,21,38,-21
19678,83,20120,32889,77,75,27,48,40,36
19679,86,20120,32889,82,59,25,34,52,2
19680,2,79,22540,52,28,9,19,24,5
19681,5,79,22540,63,29,11,18,54,-11
19682,11,79,22540,41,15,4,11,36,-12
19683,77,69,92732,3,0,0,0,10,1
19684,80,69,92732,13,1,0,1,29,0
19685,86,72,92732,22,4,2,2,59,0
19686,2,83,5635,33,4,1,3,30,-15
19687,5,71,5635,15,1,0,1,43,-6
19689,11,71,5635,61,11,4,7,104,-15
19690,14,71,5635,47,22,10,12,89,-4
19691,17,71,5635,77,18,9,9,149,-25
19692,20,75,5635,73,20,10,10,128,-19
19693,23,75,5635,67,15,6,9,158,0
19694,26,75,5635,47,11,7,4,87,-2
19695,29,75,5635,35,5,2,3,70,-7
19696,29,70,5635,30,9,6,3,38,-5
19697,32,86,5635,73,36,19,17,114,4
19698,35,86,5635,77,42,26,16,116,11
19699,38,86,5635,41,21,9,12,41,-7
19700,41,86,5635,80,27,13,14,84,-6
19701,47,86,5635,71,21,10,11,84,-8
19702,50,88,5635,58,13,7,6,85,-15
19703,53,88,5635,47,8,5,3,39,1
19704,74,86,38685,5,1,0,1,0,2
19706,2,67,68622,18,4,1,3,4,0
19707,2,76,68622,20,7,3,4,4,-1
19708,8,81,68622,78,56,17,39,69,-12
19709,11,81,68622,66,40,17,23,28,9
19710,14,81,68622,46,25,12,13,14,-10
19711,17,81,68622,63,10,3,7,18,-8
19712,2,75,22348,19,12,5,7,20,-2
19713,5,75,22348,56,20,9,11,39,-4
19714,8,80,22348,72,43,25,18,104,-29
19715,11,80,22348,47,26,11,15,52,-25
19716,14,80,22348,33,19,11,8,29,-1
19717,2,67,8857,78,79,32,47,26,14
19718,5,67,8857,8,8,2,6,4,-1
19719,5,76,8857,69,87,38,49,16,8
19720,8,76,8857,83,132,58,74,26,-1
19721,11,76,8857,69,94,38,56,18,14
19723,14,75,8857,15,20,11,9,4,12
19724,17,75,8857,80,96,38,58,44,19
19725,20,75,8857,9,11,1,10,2,4
19726,20,78,8857,69,74,25,49,12,4
19727,23,78,8857,60,68,22,46,24,13
19728,26,78,8857,67,65,31,34,36,4
19729,29,78,8857,52,66,26,40,8,30
19730,32,78,8857,79,82,30,52,37,14
19731,35,70,8857,66,47,15,32,16,-4
19732,38,70,8857,65,42,12,30,18,4
19733,41,70,8857,76,40,15,25,20,17
19734,47,64,8857,62,46,16,30,32,1
19735,50,64,8857,17,7,4,3,10,-1
19736,2,74,22706,74,67,26,41,37,-5
19737,5,74,22706,71,53,30,23,57,11
19738,8,74,22706,71,53,25,28,40,-3
19743,17,86,22706,9,11,6,5,4,8
19744,20,86,22706,65,37,16,21,16,-8
19745,23,78,22706,62,18,12,6,26,6
19746,26,73,22706,40,9,4,5,16,-11
19747,29,73,22706,9,1,0,1,4,0
19748,47,82,8843,17,0,0,0,14,-2
19749,50,82,8843,23,1,0,1,6,-3
19750,53,82,8843,3,0,0,0,2,0
19751,56,82,8843,15,1,0,1,26,-1
19752,59,82,8843,9,0,0,0,10,-3
19753,50,71,9221,77,10,3,7,37,-16
19754,53,71,9221,65,4,0,4,58,-15
19755,56,71,9221,60,11,0,11,57,-6
19756,59,71,9221,51,9,1,8,39,5
19632,14,88,21410,36,35,18,17,70,-8
19633,17,88,21410,44,36,13,23,117,3
19761,71,62,9221,56,6,1,5,62,-4
19762,74,62,9221,31,1,0,1,13,-12
19763,77,62,9221,22,0,0,0,6,-7
19764,50,88,3191,4,0,0,0,0,-2
19765,53,88,3191,1,0,0,0,0,0
19766,2,78,77139,20,9,3,6,2,2
19771,14,78,51975,28,3,3,0,89,0
19772,17,78,51975,51,5,3,2,100,-1
19773,20,78,51975,64,3,1,2,121,-8
19774,23,78,51975,60,2,1,1,105,-4
19775,26,78,51975,63,8,2,6,149,0
19776,41,70,14375,6,0,0,0,21,0
19777,41,89,11729,7,1,0,1,9,2
19778,83,20120,56090,10,3,1,2,0,2
19779,86,20120,56090,17,4,1,3,2,-2
19782,38,80,8914,14,6,2,4,6,11
19784,47,80,8914,77,35,5,30,59,29
19785,50,89,8914,72,28,3,25,44,-11
19786,53,89,8914,38,14,5,9,20,5
19787,56,89,8914,9,3,1,2,4,0
19788,59,89,8914,41,11,4,7,10,12
19789,59,66,8914,20,4,1,3,11,-8
19790,80,69,45416,11,0,0,0,0,-1
19791,83,69,45416,23,5,3,2,4,-2
19792,17,88,43137,23,10,5,5,4,1
19793,20,88,43137,67,39,16,23,12,8
19794,23,88,43137,73,52,18,34,18,15
19795,26,88,43137,69,23,11,12,32,-7
19796,29,88,43137,29,13,6,7,4,6
19797,29,67,43137,34,19,6,13,10,17
19798,32,67,43137,36,14,7,7,10,2
19799,29,88,8725,1,0,0,0,2,0
19801,32,64,8725,21,7,3,4,2,-1
19802,35,64,8725,67,46,19,27,18,14
19803,38,64,8725,77,51,18,33,18,-6
19804,41,62,8725,44,29,7,22,4,1
19805,47,62,8725,52,29,10,19,24,10
19810,59,68,8725,82,38,16,22,18,-1
19811,62,68,8725,29,10,4,6,6,-2
19812,74,86,45413,60,12,4,8,35,-1
19813,77,86,45413,14,3,0,3,16,1
19814,80,86,45413,3,1,0,1,0,0
19815,83,86,45413,47,14,7,7,28,1
19816,86,86,45413,82,17,7,10,76,4
19817,32,1479,8524,16,1,1,0,6,0
19818,35,1479,8524,53,28,7,21,10,2
19819,38,1479,8524,46,21,10,11,14,-1
19820,41,1479,8524,79,30,9,21,24,-13
19822,50,1479,8524,82,78,27,51,46,16
19823,53,1479,8524,33,16,4,12,30,-4
19824,53,78,8524,49,36,14,22,32,-17
19825,56,78,8524,46,44,15,29,24,-13
19826,59,78,8524,79,57,24,33,18,-9
19827,62,78,8524,58,50,20,30,26,18
19828,65,78,8524,25,22,10,12,2,4
19829,68,78,8524,37,21,7,14,16,-2
19830,41,68,12766,11,1,0,1,2,0
19831,41,74,12766,13,3,1,2,2,0
19832,32,79,10456,29,3,1,2,79,-2
19833,35,79,10456,33,6,1,5,109,-13
19834,35,77,10456,9,1,0,1,69,-3
19835,38,74,10456,11,0,0,0,12,-2
19836,17,71,8553,13,2,1,1,12,-2
19837,20,71,8553,37,4,0,4,52,-2
19839,26,73,8553,6,0,0,0,4,-4
19840,26,64,8553,67,4,1,3,60,-3
19841,29,64,8553,69,9,2,7,73,-7
19842,32,64,8553,79,17,5,12,51,23
19843,35,64,8553,82,20,8,12,57,18
19844,38,64,8553,82,32,6,26,70,15
19845,41,74,8553,53,15,3,12,37,12
19846,41,80,8553,13,1,0,1,6,0
19849,53,73,8553,77,15,4,11,71,7
19850,56,73,8553,71,5,1,4,65,-15
19851,32,78,3731,3,0,0,0,0,1
19852,32,73,12469,27,6,2,4,14,-4
19853,35,73,12469,55,11,5,6,30,1
19854,38,73,12469,8,0,0,0,4,-3
19855,53,86,9616,3,0,0,0,0,-2
19856,56,86,9616,13,4,2,2,8,0
19858,32,82,10614,9,0,0,0,0,-4
19859,35,82,10614,14,2,1,1,6,-5
19860,38,82,10614,1,0,0,0,0,-1
19861,41,73,10614,2,0,0,0,0,-1
19862,50,86,10614,2,0,0,0,0,0
19863,53,81,10614,73,22,7,15,20,-14
19864,59,75,10614,29,10,5,5,4,2
19865,62,75,10614,59,26,12,14,10,7
19866,65,75,10614,61,12,5,7,18,-4
19867,35,78,8721,9,3,0,3,4,0
19868,41,78,8721,71,21,9,12,32,2
19869,47,78,8721,80,10,6,4,46,-14
19870,50,64,8721,66,12,6,6,31,3
19871,5,88,62480,27,5,0,5,89,-7
19872,8,88,62480,30,4,0,4,76,-4
19873,11,88,62480,24,1,1,0,81,-1
19878,38,82,14462,3,0,0,0,0,0
19882,47,88,8813,53,9,0,9,14,-3
19883,50,88,8813,39,9,3,6,16,-4
19884,53,84,8813,55,1,0,1,33,1
19885,56,78,8813,58,7,0,7,12,-3
19886,59,78,8813,77,10,1,9,29,10
19887,62,68,8813,82,13,2,11,34,1
19888,65,68,8813,82,16,0,16,14,-2
19889,68,68,8813,27,9,1,8,8,-3
19890,71,68,8813,55,6,0,6,23,-9
19891,71,75,8813,17,7,1,6,8,9
19892,74,75,8813,31,4,0,4,6,0
19896,47,80,3659,82,103,50,53,86,29
19897,50,80,3659,82,105,50,55,74,31
19758,65,71,9221,78,15,5,10,44,4
19759,68,71,9221,48,4,1,3,55,-1
19902,65,69,3659,82,53,24,29,28,2
19903,68,69,3659,36,21,11,10,8,-12
19904,71,69,3659,76,28,12,16,18,-18
19905,74,1479,3659,6,0,0,0,0,-3
19906,32,69,3661,71,36,18,18,32,-6
19907,35,69,3661,78,67,30,37,34,0
19908,38,69,3661,81,65,30,35,46,12
19909,41,69,3661,65,40,18,22,20,10
19910,47,69,3661,65,66,38,28,64,6
19911,50,69,3661,48,57,30,27,40,12
19912,53,69,3661,77,83,42,41,63,17
19913,56,69,3661,17,23,13,10,2,3
19914,59,74,3661,76,86,42,44,37,15
19915,62,74,3661,62,48,22,26,18,8
19916,65,74,3661,82,76,41,35,34,15
19917,68,74,3661,35,19,9,10,8,-8
19919,71,82,3661,22,14,6,8,6,0
19920,71,88,3661,19,16,5,11,4,7
19921,74,88,3661,69,47,27,20,16,7
19922,77,88,3661,54,22,12,10,20,-6
19923,80,88,3661,56,21,10,11,18,-4
19924,83,88,3661,30,14,7,7,18,9
19925,83,80,3661,16,7,4,3,6,-7
19926,32,82,8616,8,2,2,0,6,-1
19927,35,82,8616,75,16,8,8,74,-6
19928,38,82,8616,72,16,2,14,71,-22
19929,41,82,8616,47,13,2,11,27,-16
19930,47,82,8616,51,19,6,13,75,-4
19931,50,82,8616,75,22,9,13,105,-13
19932,53,82,8616,82,18,6,12,60,7
19933,56,82,8616,34,9,1,8,38,2
19934,59,82,8616,26,8,2,6,26,-7
19940,35,76,8854,14,1,0,1,6,2
19941,38,76,8854,17,5,0,5,10,0
19942,41,71,8854,80,34,20,14,65,12
19943,47,71,8854,82,41,27,14,50,4
19944,50,71,8854,82,34,15,19,88,-7
19945,53,71,8854,32,11,5,6,36,-4
19946,56,82,8854,51,20,12,8,23,-4
19947,59,82,8854,60,31,19,12,32,-8
19948,59,67,8854,14,5,0,5,2,-3
19949,62,84,8854,80,29,14,15,78,4
19952,68,86,8854,11,6,2,4,4,1
19953,71,86,8854,5,5,3,2,7,4
19954,32,73,8760,75,16,2,14,48,-8
19955,35,73,8760,75,41,14,27,111,5
19956,38,73,8760,82,34,12,22,101,-3
19957,41,73,8760,59,33,18,15,87,-5
19959,50,73,8760,64,39,22,17,96,19
19960,53,77,8760,80,43,24,19,159,2
19961,56,77,8760,82,60,30,30,143,14
19962,59,77,8760,81,44,14,30,155,-6
19963,62,77,8760,82,49,24,25,142,14
19964,65,77,8760,82,67,37,30,136,19
19965,68,77,8760,32,11,8,3,70,-5
19966,71,77,8760,78,52,20,32,103,11
19967,74,82,8760,77,60,28,32,100,1
19968,77,82,8760,79,49,23,26,112,-11
19969,80,82,8760,78,37,13,24,63,14
19970,83,73,8760,62,24,13,11,82,-3
19971,50,77,435,8,2,0,2,6,-4
19972,35,81,10219,44,8,4,4,8,-9
19973,38,81,10219,37,6,4,2,8,-6
19974,50,81,10219,63,21,10,11,12,10
19976,41,65,8646,30,8,1,7,8,-12
19977,47,65,8646,10,3,1,2,8,0
19978,47,68,8646,13,1,0,1,4,-1
19979,41,65,9555,18,4,1,3,4,1
19980,47,65,9555,39,21,9,12,34,-2
19981,38,1479,9552,44,5,3,2,18,-1
19982,41,1479,9552,8,1,0,1,2,0
19983,38,75,9033,21,0,0,0,2,-1
19984,41,75,9033,11,2,1,1,4,3
19985,47,82,9033,55,17,2,15,43,13
19986,50,82,9033,80,34,9,25,69,-19
19987,53,82,9033,78,32,8,24,25,-7
19991,65,547,9033,56,10,0,10,23,9
19992,68,547,9033,47,13,0,13,10,-8
19993,71,66,9033,82,15,4,11,45,-9
19994,74,66,9033,81,10,2,8,16,-14
19996,80,66,9033,56,14,4,10,17,-16
19997,80,79,9033,16,3,0,3,4,8
19998,83,83,9033,80,23,4,19,20,12
19999,86,83,9033,81,23,5,18,21,30
20000,35,64,8705,25,4,2,2,2,-4
20001,38,64,8705,42,9,4,5,20,8
20002,41,68,8705,32,7,4,3,12,-6
20003,35,75,4531,10,4,3,1,2,2
20004,38,75,4531,34,13,6,7,14,3
20005,41,75,4531,15,2,1,1,8,-3
20006,47,74,4531,64,16,10,6,28,-6
20007,50,74,4531,64,18,10,8,26,-4
20008,53,74,4531,36,8,1,7,24,8
20010,50,71,9348,2,0,0,0,0,0
20011,38,79,8935,6,0,0,0,2,-5
20012,41,79,8935,79,10,1,9,127,-36
20014,50,79,8935,70,6,0,6,82,4
20015,53,79,8935,78,11,1,10,57,11
20016,56,79,8935,79,19,2,17,73,10
20017,59,79,8935,73,25,2,23,64,6
20018,62,79,8935,63,13,1,12,66,12
20019,65,79,8935,73,18,2,16,61,19
20020,68,79,8935,46,8,0,8,32,17
20021,71,79,8935,72,13,2,11,46,-3
20022,74,89,8935,78,19,0,19,66,5
20023,77,89,8935,41,10,3,7,24,11
20024,80,89,8935,79,14,0,14,48,32
20025,83,89,8935,81,10,0,10,68,-9
20026,86,89,8935,53,9,2,7,32,8
20031,47,71,8712,6,0,0,0,2,-1
19899,56,80,3659,82,72,39,33,88,-11
19900,59,86,3659,82,82,39,43,54,14
20036,47,88,8587,69,54,21,33,40,17
20037,50,88,8587,82,71,35,36,34,-8
20038,53,88,8587,71,67,23,44,22,1
20039,56,88,8587,77,59,32,27,30,-6
20040,59,88,8587,81,51,19,32,26,-1
20041,62,74,8587,43,16,7,9,8,4
20042,38,80,8657,57,16,3,13,40,-4
20043,41,80,8657,19,3,1,2,8,1
20044,47,80,8657,75,17,4,13,53,21
20045,50,80,8657,78,19,1,18,67,37
20046,53,80,8657,67,15,1,14,55,14
20047,56,80,8657,68,10,2,8,36,-10
20048,59,80,8657,64,14,4,10,38,2
20049,62,72,8657,57,8,0,8,36,3
20050,65,72,8657,72,11,2,9,34,3
20051,68,72,8657,37,5,1,4,37,-1
20053,74,73,8657,46,7,0,7,14,4
20054,41,72,9032,65,4,0,4,72,12
20055,47,72,9032,38,4,0,4,21,5
20056,50,72,9032,43,1,0,1,26,2
20057,50,62,9032,11,0,0,0,10,-2
20058,53,62,9032,58,2,0,2,46,0
20060,59,81,9032,39,4,0,4,25,-2
20061,62,80,9032,25,5,1,4,6,7
20062,41,84,11025,2,0,0,0,0,-1
20063,47,84,11025,1,0,0,0,0,0
20064,50,84,11025,1,0,0,0,0,0
20065,53,79,11025,13,0,0,0,2,0
20066,59,69,11025,9,0,0,0,12,-4
20067,41,86,9088,1,0,0,0,2,-2
20068,47,63,9088,82,69,26,43,30,11
20069,50,63,9088,62,34,13,21,25,-17
20071,53,78,9088,82,65,43,22,20,1
20072,56,78,9088,82,72,33,39,26,-20
20073,59,78,9088,82,42,14,28,26,1
20074,62,78,9088,62,41,12,29,30,11
20075,62,67,9088,21,14,5,9,6,2
20076,65,67,9088,65,23,8,15,6,2
20077,68,76,9088,48,35,10,25,16,-6
20078,71,68,9088,78,36,21,15,28,-6
20079,74,68,9088,78,38,14,24,20,11
20080,77,83,9088,60,24,8,16,12,-6
20081,38,70,8938,26,7,3,4,31,6
20082,41,70,8938,73,12,2,10,152,-2
20083,47,70,8938,82,22,5,17,178,1
20084,50,70,8938,19,4,0,4,35,-4
20085,53,70,8938,73,22,11,11,147,2
20086,56,70,8938,64,46,19,27,135,3
20088,62,70,8938,82,32,12,20,183,-9
20089,65,70,8938,74,39,11,28,156,5
20090,68,67,8938,48,24,9,15,93,3
20091,71,67,8938,59,20,9,11,55,-26
20092,71,78,8938,23,3,0,3,37,-12
20093,74,78,8938,78,12,3,9,86,-8
20094,77,78,8938,21,2,0,2,34,-3
20095,80,85,8938,42,6,3,3,63,-6
20096,80,75,8938,11,1,0,1,17,-2
20097,35,89,8893,7,0,0,0,2,-3
20098,38,89,8893,72,11,2,9,93,7
20099,41,89,8893,30,2,2,0,28,-5
20100,47,89,8893,76,30,14,16,73,-17
20101,50,89,8893,69,17,7,10,78,-9
20102,53,89,8893,5,1,1,0,7,-2
20103,53,1479,8893,45,1,0,1,57,-2
20105,56,70,8893,42,9,5,4,52,-5
20106,59,70,8893,46,9,5,4,66,8
20107,62,70,8893,51,4,2,2,58,-10
20108,38,63,557,8,1,0,1,2,-1
20109,41,63,557,6,0,0,0,0,-1
20110,32,77,4502,63,25,12,13,22,6
20111,35,77,4502,75,40,17,23,32,11
20112,38,77,4502,41,24,8,16,22,15
20113,41,77,4502,47,26,6,20,32,10
20114,41,66,4502,32,18,5,13,32,2
20115,47,66,4502,82,76,31,45,60,1
20116,50,66,4502,82,67,33,34,73,-11
20117,53,66,4502,37,30,9,21,43,2
20118,56,66,4502,32,10,3,7,9,-9
20119,56,88,4502,12,4,1,3,8,1
20120,59,88,4502,49,29,10,19,39,3
20122,65,88,4502,82,59,22,37,44,10
20123,68,88,4502,48,33,11,22,22,15
20124,71,88,4502,82,43,19,24,48,14
20125,74,88,4502,81,41,18,23,29,8
20126,77,89,4502,82,52,22,30,36,15
20127,80,89,4502,80,48,24,24,50,14
20128,83,66,4502,82,51,16,35,56,-9
20129,86,66,4502,82,53,23,30,44,-4
20130,41,85,176,20,5,1,4,16,5
20131,47,85,176,27,9,1,8,28,11
20132,50,85,176,68,22,1,21,54,0
20133,53,85,176,65,35,7,28,44,25
20134,56,85,176,80,51,6,45,50,2
20135,59,85,176,48,22,7,15,32,5
20136,62,85,176,77,37,11,26,36,5
20137,65,85,176,82,36,15,21,38,-2
20139,71,85,176,79,49,8,41,44,0
20140,74,85,176,80,44,9,35,40,-4
20141,77,85,176,64,26,3,23,30,-21
20142,80,85,176,57,13,2,11,32,-7
20143,83,85,176,79,27,4,23,36,-14
20144,86,85,176,79,27,3,24,40,-5
20148,47,74,9378,2,0,0,0,0,0
20150,53,79,9378,45,12,5,7,8,2
20151,56,79,9378,8,2,0,2,2,-4
20152,59,68,9378,21,2,1,1,4,-1
20153,62,65,9378,1,0,0,0,0,0
20154,65,69,9378,5,2,0,2,0,2
20155,17,63,27770,39,7,1,6,44,-5
20156,20,63,27770,21,3,1,2,13,-1
20033,65,62,8712,13,1,0,1,2,-1
20034,38,88,8587,79,31,14,17,34,12
20161,50,69,8593,82,12,2,10,42,0
20162,53,69,8593,81,15,2,13,42,9
20163,56,69,8593,79,11,2,9,31,-4
20164,59,69,8593,80,20,1,19,43,-8
20165,62,69,8593,74,17,3,14,38,-4
20166,65,69,8593,62,3,1,2,30,-10
20167,65,71,8593,20,4,0,4,10,-2
20168,68,71,8593,48,9,1,8,24,-13
20169,71,71,8593,60,4,0,4,24,-11
20170,71,82,8593,9,1,0,1,4,-2
20171,74,77,8593,80,15,2,13,47,2
20172,77,77,8593,81,10,1,9,42,-1
20173,80,77,8593,28,4,0,4,10,1
20174,38,66,7499,14,5,3,2,2,1
20175,41,66,7499,3,0,0,0,0,0
20176,47,71,8826,19,1,0,1,21,-2
20178,53,70,8826,41,3,1,2,46,-9
20179,56,78,8826,64,21,13,8,89,-1
20180,59,78,8826,64,8,3,5,108,3
20181,62,78,8826,57,14,9,5,86,-9
20182,62,1479,8826,19,2,1,1,28,-9
20183,65,86,8826,67,10,6,4,88,-5
20184,35,63,9047,6,1,1,0,2,-2
20185,38,63,9047,14,3,0,3,7,-1
20186,41,63,9047,18,2,2,0,9,1
20187,47,65,9047,28,9,5,4,22,-4
20188,47,79,9047,19,18,7,11,16,8
20189,50,76,9047,81,28,8,20,34,10
20190,53,76,9047,70,16,8,8,18,2
20191,56,76,9047,67,27,11,16,22,-3
20192,59,69,9047,4,0,0,0,2,-2
20193,47,85,9638,1,0,0,0,2,1
20195,53,85,9638,77,12,5,7,43,2
20196,56,85,9638,79,19,6,13,46,-7
20197,59,65,9638,74,21,10,11,28,0
20198,62,65,9638,81,42,15,27,60,-13
20199,65,68,9638,80,32,10,22,32,-8
20200,68,68,9638,47,27,15,12,28,-8
20201,71,68,9638,49,12,4,8,18,0
20202,74,68,9638,64,8,2,6,28,-19
20203,2,84,52373,31,5,2,3,171,-14
20204,2,62,52373,13,4,1,3,69,0
20205,5,62,52373,72,22,13,9,338,0
20206,8,62,52373,70,25,10,15,207,4
20207,11,62,52373,71,29,9,20,243,6
20208,14,62,52373,39,13,9,4,163,4
20209,17,62,52373,52,15,10,5,111,2
20210,20,62,52373,79,17,7,10,157,-4
20212,29,86,52373,67,9,4,5,151,-9
20215,47,69,9152,58,28,10,18,60,-3
20216,50,69,9152,57,23,3,20,52,-3
20217,53,69,9152,56,19,7,12,37,0
20218,56,69,9152,10,6,1,5,6,7
20219,59,81,9152,71,42,8,34,48,-5
20220,62,71,9152,74,22,8,14,45,-12
20221,65,1479,9152,9,2,1,1,8,-5
20222,65,72,9152,28,12,3,9,23,-9
20223,65,69,9152,14,0,0,0,4,1
20224,68,77,9152,23,5,1,4,25,0
20225,32,89,8768,10,0,0,0,2,-1
20226,35,89,8768,61,10,7,3,44,-8
20227,38,89,8768,1,0,0,0,0,0
20228,41,89,8768,71,12,7,5,37,-9
20229,47,89,8768,71,38,20,18,39,-2
20231,53,89,8768,56,7,2,5,25,-11
20232,53,84,8768,20,6,4,2,11,0
20233,56,81,8768,59,15,8,7,24,-14
20234,59,84,8768,9,3,1,2,6,3
20235,32,82,9713,5,0,0,0,0,2
20236,35,82,9713,17,3,1,2,10,-11
20237,38,82,9713,34,9,4,5,18,-12
20238,38,71,8891,4,1,0,1,0,-3
20239,41,71,8891,68,21,10,11,42,8
20240,47,71,8891,82,68,22,46,74,4
20241,50,71,8891,51,39,13,26,48,2
20242,53,71,8891,81,36,14,22,74,-23
20243,56,88,8891,74,41,18,23,68,-7
20244,59,88,8891,73,47,16,31,40,13
20245,62,88,8891,82,43,20,23,42,-6
20246,65,88,8891,78,21,6,15,60,2
20248,71,88,8891,78,27,8,19,48,9
20249,74,88,8891,73,17,6,11,58,3
20250,77,74,8891,29,3,1,2,20,3
20251,77,69,8891,51,6,3,3,16,-4
20252,38,88,9507,17,4,2,2,0,-3
20253,50,65,450,3,2,0,2,2,1
20254,38,63,9440,14,1,1,0,2,-2
20255,41,63,9440,3,0,0,0,0,-1
20256,2,74,65335,21,0,0,0,61,-4
20257,2,85,65335,9,0,0,0,16,-3
20258,5,85,65335,27,1,1,0,72,1
20259,8,85,65335,9,1,0,1,20,1
20260,11,80,65335,55,7,2,5,214,-9
20261,14,80,65335,27,4,0,4,65,0
20262,17,80,65335,64,5,1,4,276,-13
20263,20,80,65335,11,1,0,1,25,0
20265,35,79,12247,4,1,0,1,4,-1
20266,47,79,12247,41,2,1,1,43,-9
20267,32,88,3473,2,0,0,0,4,-2
20268,35,88,3473,26,5,1,4,22,3
20269,38,88,3473,17,3,0,3,14,5
20270,38,68,3473,56,12,4,8,56,8
20271,41,68,3473,79,7,3,4,90,-8
20272,47,85,3473,82,15,2,13,98,18
20273,50,85,3473,57,5,0,5,54,6
20274,53,85,3473,79,12,2,10,93,-2
20275,56,85,3473,60,13,2,11,66,13
20276,59,85,3473,20,2,1,1,4,-2
20277,62,1479,3473,52,7,1,6,28,-15
20278,65,77,3473,46,6,0,6,34,9
20158,38,69,8593,75,10,3,7,23,11
20159,41,69,8593,79,16,6,10,16,12
20283,14,1479,42664,45,29,8,21,32,-4
20284,17,1479,42664,49,25,8,17,41,13
20285,20,80,42664,80,25,11,14,35,-8
20286,23,80,42664,80,19,4,15,48,4
20287,26,80,42664,79,17,6,11,30,3
20288,29,80,42664,75,28,9,19,37,20
20289,32,70,42664,59,23,7,16,16,5
20290,35,70,42664,19,6,2,4,6,-5
20291,35,75,42664,54,15,6,9,20,5
20292,38,80,42664,78,32,12,20,66,17
20293,41,80,42664,73,12,2,10,80,6
20294,41,72,9599,1,0,0,0,0,0
20295,47,72,9599,1,1,1,0,0,-2
20296,47,83,9599,2,0,0,0,0,-1
20297,50,83,9599,14,0,0,0,4,-6
20298,2,67,21555,71,52,25,27,74,11
20300,41,80,8832,57,14,7,7,16,5
20301,47,80,8832,82,33,21,12,44,17
20302,50,80,8832,77,39,19,20,52,-2
20303,53,80,8832,81,53,24,29,51,3
20304,56,80,8832,62,28,9,19,42,-12
20305,56,82,8832,17,13,7,6,8,5
20306,59,82,8832,82,65,27,38,32,2
20307,62,82,8832,82,47,19,28,60,0
20308,65,82,8832,60,27,8,19,12,-17
20312,74,87,8832,63,35,13,22,34,-23
20313,74,65,8832,19,3,0,3,6,-2
20314,77,87,8832,76,38,17,21,93,-14
20315,80,1479,8832,72,28,9,19,42,-7
20316,83,1479,8832,64,16,8,8,34,-5
20317,35,63,7601,1,1,0,1,0,2
20318,38,63,7601,41,17,6,11,30,3
20320,41,72,8774,70,24,6,18,4,12
20321,47,72,8774,80,37,5,32,32,1
20322,50,72,8774,82,26,3,23,18,-9
20323,53,72,8774,73,32,5,27,22,20
20324,56,72,8774,73,33,5,28,36,21
20325,59,72,8774,22,11,2,9,2,10
20326,62,79,8774,77,24,3,21,16,9
20327,65,79,8774,73,27,2,25,18,9
20328,68,79,8774,34,23,6,17,16,14
20329,71,79,8774,39,15,3,12,10,-4
20330,74,79,8774,74,20,3,17,20,17
20331,77,86,8774,78,20,3,17,22,13
20332,80,86,8774,81,26,4,22,20,10
20333,83,86,8774,14,2,0,2,2,3
20334,32,89,9635,3,0,0,0,0,-1
20335,35,89,9635,2,0,0,0,0,-3
20337,47,80,8656,11,0,0,0,4,-2
20338,50,82,8656,6,0,0,0,2,1
20339,2,84,67031,59,21,10,11,67,-23
20340,5,84,67031,65,25,8,17,56,3
20341,8,84,67031,48,13,6,7,77,6
20342,11,1479,67031,78,45,18,27,100,8
20343,14,1479,67031,36,9,3,6,34,-4
20344,17,1479,67031,79,24,12,12,125,8
20345,20,1479,67031,53,14,7,7,53,-2
20346,20,79,67031,17,7,3,4,25,-6
20347,23,79,67031,39,3,2,1,33,-3
20348,26,83,67031,77,29,8,21,53,8
20349,29,83,67031,73,24,10,14,44,-2
20350,32,83,67031,74,26,8,18,46,4
20351,35,83,67031,63,15,5,10,28,2
20352,38,65,67031,16,1,0,1,6,0
20354,50,70,13884,36,6,3,3,14,-5
20355,53,70,13884,55,14,3,11,22,-3
20356,56,70,13884,43,6,1,5,20,-9
20357,41,63,12282,10,1,0,1,2,1
20358,38,65,12243,7,5,5,0,4,-3
20359,41,65,12243,36,11,4,7,18,-2
20360,41,75,9637,4,0,0,0,0,-1
20361,41,74,9637,13,5,1,4,4,0
20362,47,84,9637,1,1,0,1,0,1
20363,38,66,10248,25,14,4,10,16,-5
20364,41,66,10248,44,6,3,3,22,-14
20365,50,66,10248,9,2,1,1,2,-1
20366,53,66,10248,31,6,3,3,28,-2
20367,56,66,10248,70,12,5,7,26,2
20368,32,81,12450,66,22,7,15,8,-9
20369,35,76,12450,5,0,0,0,4,-1
20371,41,1479,8865,55,5,1,4,32,-8
20372,41,64,8865,14,1,0,1,19,-3
20373,47,64,8865,37,5,1,4,24,5
20374,50,64,8865,48,6,0,6,24,-3
20375,53,64,8865,54,6,1,5,41,17
20378,41,73,10213,1,0,0,0,0,0
20379,71,76,37710,20,1,1,0,32,-1
20380,77,67,45978,2,0,0,0,0,0
20381,80,67,45978,4,1,0,1,0,2
20382,41,74,8962,5,3,0,3,0,0
20383,47,74,8962,82,18,9,9,28,4
20384,50,79,8962,59,15,6,9,46,1
20385,50,69,8962,10,2,2,0,10,3
20386,53,69,8962,30,3,1,2,10,-11
20387,53,83,8962,38,14,4,10,14,7
20388,56,83,8962,63,41,12,29,69,-1
20390,59,68,8962,48,17,8,9,35,-7
20391,59,75,8962,21,11,2,9,8,4
20392,62,81,8962,77,32,18,14,52,-12
20393,65,81,8962,56,19,4,15,48,-10
20394,65,86,8962,23,6,0,6,6,-8
20395,71,74,8962,73,18,6,12,18,0
20396,74,74,8962,82,27,10,17,28,5
20397,77,74,8962,80,15,6,9,32,-2
20398,80,63,8962,82,25,11,14,44,2
20399,83,83,8962,50,12,6,6,16,3
20400,74,79,38094,11,0,0,0,24,0
20401,77,79,38094,3,0,0,0,5,0
20402,77,72,38094,50,10,8,2,92,-2
20403,80,75,38094,3,0,0,0,17,0
20280,2,71,42664,2,0,0,0,0,0
20281,8,71,42664,21,5,1,4,6,-2
20408,47,66,281032,50,8,4,4,42,2
20409,50,66,281032,67,10,2,8,48,-2
20410,53,66,281032,66,8,2,6,54,-18
20411,56,66,281032,64,10,2,8,42,-1
20412,59,66,281032,47,5,0,5,26,-5
20413,59,86,281032,23,2,0,2,23,0
20414,62,86,281032,74,8,3,5,46,0
20415,32,1479,606,38,4,0,4,14,-7
20416,77,72,16706,22,2,0,2,8,-3
20417,47,78,9446,5,0,0,0,2,-1
20418,65,69,9446,1,0,0,0,2,0
20419,71,71,39239,3,0,0,0,0,-3
20420,74,71,39239,11,3,1,2,0,-6
20421,77,71,39239,7,0,0,0,2,-1
20422,80,78,39239,9,5,1,4,2,-2
20423,80,73,39239,3,1,0,1,0,1
20425,86,20120,39239,13,7,2,5,2,3
20426,86,69,39239,29,5,3,2,6,-5
20427,2,83,26346,2,1,0,1,0,-4
20428,53,72,3184,2,0,0,0,0,2
20429,32,88,8588,81,39,7,32,36,16
20430,35,88,8588,72,21,4,17,14,-5
20431,38,88,8588,57,24,8,16,28,2
20432,41,88,8588,58,29,8,21,26,8
20433,47,88,8588,80,67,17,50,50,7
20434,50,88,8588,69,58,18,40,26,1
20435,53,88,8588,82,41,8,33,34,-18
20436,56,71,8588,50,31,8,23,30,6
20437,59,71,8588,57,32,10,22,16,-4
20438,59,1479,8588,16,13,5,8,4,-6
20439,62,1479,8588,81,68,18,50,24,18
20440,65,1479,8588,68,27,6,21,47,7
20442,71,76,8588,24,11,3,8,10,-1
20443,74,76,8588,53,20,5,15,8,-3
20444,62,89,11564,7,1,0,1,2,-1
20450,14,74,21303,19,15,10,5,18,-2
20451,17,74,21303,69,82,41,41,129,29
20452,20,70,21303,81,53,17,36,128,3
20453,23,70,21303,82,57,31,26,170,15
20454,26,70,21303,78,34,17,17,133,11
20455,29,85,21303,68,48,22,26,95,22
20456,32,85,21303,67,30,15,15,73,0
20457,35,70,21303,64,20,7,13,72,-4
20458,65,63,37754,2,1,0,1,0,0
20459,68,63,37754,1,1,0,1,0,-1
20460,71,63,37754,79,40,14,26,28,18
20461,74,63,37754,78,39,12,27,20,13
20462,77,63,37754,81,44,4,40,33,9
20464,83,63,37754,76,59,14,45,36,0
20465,86,63,37754,64,53,6,47,33,-2
20466,47,79,8942,50,32,16,16,16,-13
20467,50,79,8942,73,48,19,29,30,-3
20468,53,81,8942,64,36,17,19,12,11
20469,56,84,8942,3,0,0,0,0,1
20470,71,64,19286,2,0,0,0,2,1
20471,74,64,19286,5,0,0,0,2,3
20472,74,86,19286,5,0,0,0,4,-4
20473,80,72,19286,11,3,0,3,13,-5
20474,68,89,38242,1,0,0,0,0,-1
20475,71,89,38242,1,0,0,0,0,-2
20476,74,89,38242,4,0,0,0,4,1
20477,86,547,38242,4,1,0,1,0,0
20478,5,63,67943,4,0,0,0,0,0
20479,5,72,39476,71,46,19,27,74,27
20481,11,77,39476,2,0,0,0,0,-1
20483,5,65,71061,29,8,3,5,56,-6
20484,56,64,11548,4,0,0,0,13,1
20485,59,64,11548,56,16,9,7,74,1
20486,62,89,11548,77,25,9,16,110,-2
20487,65,89,11548,78,9,4,5,95,-6
20488,68,89,11548,48,8,5,3,73,-6
20489,71,73,11548,44,4,2,2,54,-5
20490,71,71,11548,33,3,3,0,58,-6
20491,74,71,11548,71,16,8,8,76,-14
20492,77,71,11548,68,12,5,7,82,2
20493,80,71,11548,42,7,4,3,29,-3
20494,83,547,11548,60,13,5,8,39,-1
20495,86,69,11548,22,2,0,2,19,-2
20496,86,547,11548,4,1,0,1,0,0
20497,35,82,10664,2,1,1,0,0,-2
20499,41,82,10664,27,9,1,8,22,-6
20500,50,82,10664,9,2,2,0,0,-1
20501,71,83,24829,1,0,0,0,0,-2
20502,80,65,24829,1,0,0,0,0,0
20503,65,81,37812,5,1,0,1,0,2
20504,71,81,37812,63,19,4,15,6,-9
20505,74,81,37812,52,9,3,6,30,-2
20506,77,81,37812,78,22,8,14,59,16
20507,80,81,37812,64,6,3,3,73,-7
20508,83,81,37812,24,4,1,3,12,-1
20509,83,1479,37812,23,3,1,2,12,-4
20510,86,69,37812,56,8,3,5,29,0
20511,32,72,60897,2,0,0,0,6,0
20512,38,72,60897,17,2,2,0,35,0
20513,41,78,60897,68,12,7,5,141,-8
20514,68,67,33239,26,11,6,5,0,6
20516,74,67,33239,54,17,5,12,8,-3
20517,74,75,33239,9,0,0,0,0,-2
20518,77,75,33239,56,10,4,6,6,-3
20519,80,75,33239,51,10,6,4,4,2
20520,68,86,37808,4,2,0,2,2,2
20521,74,86,37808,27,8,2,6,16,0
20522,77,86,37808,29,4,1,3,0,1
20523,80,66,37808,45,6,0,6,6,-13
20524,83,67,37808,15,0,0,0,8,-8
20525,86,67,37808,4,0,0,0,0,-4
20526,41,78,11731,2,0,0,0,0,0
20527,47,78,11731,1,0,0,0,0,0
20528,32,82,1793,61,16,4,12,10,-11
20529,50,69,1793,51,20,3,17,22,-15
20405,35,66,281032,52,3,1,2,36,1
20406,38,66,281032,77,10,2,8,71,-19
20534,5,76,31908,74,60,18,42,35,0
20535,8,76,31908,56,21,8,13,34,-1
20536,11,76,31908,32,14,5,9,10,0
20537,2,76,31905,60,6,2,4,238,-13
20538,5,76,31905,74,6,0,6,293,-6
20539,8,76,31905,74,7,2,5,216,3
20540,11,76,31905,72,4,3,1,237,-5
20541,14,76,31905,39,2,0,2,109,1
20542,17,76,31905,32,2,1,1,106,-3
20543,20,76,31905,17,1,1,0,71,-2
20544,23,81,31905,42,1,1,0,116,0
20545,23,75,31905,22,0,0,0,76,-4
20546,50,65,10989,9,0,0,0,88,-3
20547,53,65,10989,18,0,0,0,68,-4
20548,56,81,10989,1,0,0,0,4,0
20549,56,78,10989,4,0,0,0,9,-2
20551,59,64,10989,43,1,1,0,84,-2
20552,62,64,10989,35,1,1,0,80,-5
20553,65,66,37750,1,0,0,0,4,0
20554,68,66,37750,5,1,0,1,0,1
20555,71,84,37750,19,1,1,0,6,-1
20556,77,78,37750,2,0,0,0,2,0
20557,71,85,38246,56,7,1,6,22,-8
20558,74,85,38246,82,18,12,6,34,5
20559,77,85,38246,81,21,8,13,46,4
20560,80,85,38246,74,14,3,11,26,-10
20561,83,85,38246,69,19,11,8,17,-14
20562,86,85,38246,78,23,10,13,15,2
20563,47,76,10641,3,0,0,0,2,-1
20564,41,65,8531,82,6,4,2,142,-17
20565,47,1479,8531,39,5,4,1,72,-3
20566,50,1479,8531,82,21,11,10,101,-4
20568,56,1479,8531,63,11,4,7,77,-17
20569,56,86,8531,19,5,3,2,14,-1
20570,59,75,8531,81,19,8,11,57,-2
20571,62,75,8531,79,16,6,10,96,-4
20572,65,75,8531,48,16,9,7,41,-3
20573,68,75,8531,45,6,2,4,32,-4
20574,71,75,8531,65,12,2,10,49,2
20575,74,75,8531,10,0,0,0,4,0
20576,74,70,8531,34,9,3,6,14,0
20577,77,70,8531,23,2,0,2,21,-3
20578,47,73,10215,4,2,0,2,6,0
20579,50,73,10215,66,8,3,5,32,16
20580,53,73,10215,78,5,0,5,24,-5
20581,56,73,10215,82,11,4,7,38,8
20582,59,69,10215,81,15,2,13,36,-10
20583,62,69,10215,82,7,0,7,48,-5
20585,65,63,10215,17,2,1,1,4,4
20586,68,64,10215,44,6,0,6,28,-16
20587,77,81,37317,2,1,0,1,2,1
20588,80,81,37317,20,8,6,2,8,-1
20589,83,81,37317,82,64,25,39,50,34
20590,86,81,37317,80,48,22,26,66,9
20591,71,62,38821,10,3,0,3,0,-3
20592,41,64,8728,79,34,10,24,28,7
20593,47,64,8728,82,49,14,35,44,5
20594,50,64,8728,71,44,14,30,24,0
20595,53,64,8728,81,32,6,26,26,2
20596,56,64,8728,75,39,12,27,31,-19
20597,59,64,8728,59,31,6,25,30,-2
20598,62,64,8728,76,46,6,40,35,-9
20599,65,83,8728,66,27,7,20,20,-14
20600,68,83,8728,32,11,2,9,4,-1
20602,71,66,8728,35,9,2,7,8,7
20603,74,66,8728,57,22,2,20,14,-9
20604,77,66,8728,64,15,6,9,16,-3
20605,77,63,8728,17,6,0,6,2,-7
20606,80,63,8728,36,5,0,5,4,1
20607,68,62,15124,39,17,9,8,14,-13
20608,68,73,4518,8,2,0,2,0,-2
20610,56,69,13405,36,3,1,2,47,-3
20611,47,69,9445,5,0,0,0,4,-2
20612,50,69,9445,1,0,0,0,0,1
20613,56,69,9445,31,2,1,1,41,-2
20614,56,74,9445,11,0,0,0,24,-4
20615,32,63,2663,62,10,2,8,26,-3
20616,35,63,2663,38,3,0,3,33,-1
20617,38,63,2663,2,0,0,0,0,1
20618,35,62,2705,28,5,2,3,4,-9
20620,17,72,10856,63,42,18,24,32,7
20621,20,72,10856,19,3,1,2,4,-8
20622,23,72,10856,58,36,16,20,22,0
20623,26,72,10856,80,72,29,43,22,16
20624,29,72,10856,79,68,25,43,26,24
20625,32,72,10856,73,81,35,46,32,36
20626,35,72,10856,73,48,21,27,44,12
20627,38,1479,10856,82,59,34,25,24,-7
20628,41,1479,10856,81,52,23,29,34,-9
20629,47,1479,10856,34,20,7,13,28,1
20630,47,74,10856,40,31,16,15,22,5
20631,50,71,10856,82,53,22,31,40,-20
20632,53,79,10856,81,63,28,35,41,1
20633,56,79,10856,76,46,25,21,36,3
20634,59,69,10856,14,3,2,1,8,-7
20635,65,72,10856,82,44,21,23,40,4
20637,68,75,74663,48,27,9,18,20,14
20638,71,75,74663,65,31,13,18,26,-12
20639,74,75,74663,80,46,20,26,39,8
20640,77,75,74663,82,56,30,26,20,-8
20641,80,75,74663,61,44,17,27,24,-5
20642,83,75,74663,82,51,19,32,22,-31
20643,86,87,74663,72,41,19,22,34,-19
20644,74,76,41197,8,1,0,1,6,1
20645,77,71,41197,29,1,0,1,20,-6
20646,71,83,41201,73,27,2,25,12,-13
20647,74,83,41201,81,29,8,21,14,-16
20648,77,83,41201,82,36,9,27,28,-17
20649,80,83,41201,76,27,6,21,21,-20
20650,83,83,41201,76,52,6,46,14,-4
20531,32,69,9178,30,11,7,4,29,-7
20532,2,71,42303,4,1,1,0,0,0
20659,50,73,9055,53,4,1,3,90,-2
20660,53,73,9055,45,3,1,2,60,-1
20661,56,84,9055,73,5,4,1,109,1
20662,59,84,9055,56,2,1,1,142,-7
20663,62,68,9055,64,5,1,4,76,-1
20664,65,71,9055,43,3,1,2,64,-3
20665,68,71,9055,4,0,0,0,2,-1
20666,68,71,21229,48,31,17,14,24,-4
20667,71,71,21229,63,24,11,13,36,-33
20668,74,71,21229,81,33,14,19,18,-35
20669,77,71,21229,60,23,8,15,24,-16
20670,80,78,21229,40,9,3,6,14,-3
20671,83,64,21229,58,16,9,7,26,2
20672,71,1479,34897,78,30,6,24,36,29
20673,74,1479,34897,78,34,7,27,32,25
20674,77,1479,34897,80,28,10,18,40,7
20676,83,1479,34897,69,31,13,18,34,16
20677,86,1479,34897,76,28,6,22,44,-5
20678,2,75,32768,25,1,0,1,12,-3
20679,5,84,32768,67,17,6,11,49,6
20680,8,84,32768,25,3,3,0,10,-2
20681,77,66,62798,41,17,7,10,18,0
20682,80,66,62798,36,7,1,6,15,-12
20683,83,66,62798,49,13,5,8,17,0
20684,86,66,62798,21,4,1,3,8,-2
20685,86,73,62798,3,0,0,0,0,-1
20686,80,73,648672,15,2,1,1,4,-2
20687,83,73,648672,37,8,2,6,8,8
20688,83,71,648672,16,8,2,6,2,1
20689,86,1479,648672,37,19,11,8,14,-10
20690,86,69,648672,22,6,1,5,6,-4
20691,71,69,53592,13,2,1,1,2,-5
20693,77,69,53592,81,26,10,16,38,1
20694,80,69,53592,76,34,11,23,59,15
20695,83,69,53592,82,50,14,36,41,15
20696,86,69,53592,32,22,12,10,21,-5
20697,2,63,8799,56,16,8,8,32,-14
20698,5,63,8799,15,3,0,3,12,-3
20699,5,77,8799,2,1,1,0,0,1
20700,11,62,8799,53,38,11,27,16,20
20701,14,62,8799,39,18,6,12,11,7
20702,17,85,8799,2,0,0,0,0,0
20703,32,69,8799,82,30,18,12,37,-8
20704,35,69,8799,64,30,10,20,43,0
20705,38,69,8799,80,32,13,19,63,11
20706,41,69,8799,57,25,12,13,32,5
20707,47,69,8799,82,37,19,18,61,7
20708,50,69,8799,62,24,9,15,30,3
20710,41,68,12250,5,1,1,0,0,1
20711,35,82,11027,3,0,0,0,0,0
20712,41,82,11027,2,2,1,1,2,-1
20713,50,84,11027,3,1,0,1,2,0
20714,20,86,8286,43,21,13,8,14,-10
20715,23,86,8286,7,2,1,1,0,-2
20716,26,86,8286,14,4,2,2,6,3
20717,29,81,8286,46,16,6,10,11,2
20720,38,72,8286,12,2,2,0,2,1
20721,59,79,13398,9,2,0,2,17,-2
20722,62,79,13398,63,10,3,7,123,-5
20723,65,79,13398,73,17,4,13,56,10
20724,68,79,13398,42,6,0,6,54,5
20725,71,79,13398,56,12,6,6,58,-6
20726,74,62,13398,76,11,2,9,53,-16
20727,77,62,13398,69,12,3,9,54,7
20729,83,20120,13398,79,23,5,18,24,6
20730,86,20120,13398,74,12,2,10,18,-3
20733,23,66,8965,3,0,0,0,0,0
20734,26,80,8965,36,7,4,3,10,4
20735,29,80,8965,2,1,1,0,0,-1
20736,29,81,8965,57,12,5,7,37,-11
20737,32,81,8965,20,2,1,1,13,-9
20738,32,76,8965,39,4,1,3,20,-7
20739,35,80,8965,14,1,1,0,4,1
20740,38,80,8965,14,5,2,3,10,3
20741,38,78,8965,28,6,3,3,18,-8
20742,41,78,8965,25,1,1,0,22,-7
20743,47,80,8965,4,2,1,1,0,2
20744,77,74,90407,7,0,0,0,4,1
20745,80,74,90407,80,39,5,34,42,11
20746,83,74,90407,82,25,4,21,39,-27
20748,68,72,77612,17,3,1,2,6,-1
20749,74,72,77612,7,1,1,0,4,0
20750,77,72,77612,20,1,1,0,13,-9
20751,77,75,77612,12,1,0,1,4,-4
20752,83,20120,77612,8,1,0,1,0,0
20753,71,88,76011,25,7,3,4,8,2
20754,74,88,76011,42,16,12,4,14,14
20755,77,88,76011,79,36,15,21,18,11
20756,80,88,76011,80,44,24,20,13,5
20757,83,88,76011,82,40,15,25,27,11
20758,86,88,76011,17,1,0,1,8,-9
20759,86,79,76011,44,14,9,5,13,-6
20760,86,84,76011,19,12,9,3,4,0
20761,68,77,76744,5,0,0,0,0,0
20762,74,77,76744,31,6,2,4,17,-1
20763,77,77,76744,71,21,7,14,34,-2
20765,83,77,76744,81,20,10,10,42,-10
20766,86,77,76744,82,32,12,20,53,-11
20767,23,63,67481,6,0,0,0,0,-1
20768,47,76,11557,2,0,0,0,2,-2
20770,71,79,43562,78,29,9,20,14,8
20771,74,79,43562,20,9,1,8,10,1
20772,77,79,43562,67,19,6,13,22,27
20773,80,79,43562,55,7,1,6,12,17
20774,83,79,43562,82,29,7,22,28,-1
20775,86,79,43562,60,14,1,13,12,9
20776,14,1479,8652,36,12,3,9,14,-6
20777,17,1479,8652,51,22,7,15,35,0
20782,29,1479,8652,82,51,15,36,30,5
20783,32,1479,8652,82,53,14,39,32,-11
20656,38,68,9055,3,0,0,0,15,-1
20657,41,68,9055,57,4,3,1,158,-10
20788,71,67,59893,70,22,8,14,14,-6
20789,74,67,59893,61,30,15,15,25,-16
20790,77,67,59893,71,18,7,11,20,0
20791,80,67,59893,75,16,7,9,18,-7
20792,83,67,59893,71,15,7,8,26,-12
20793,86,67,59893,72,18,5,13,17,-11
20794,14,71,8883,3,0,0,0,0,-1
20795,17,71,8883,48,11,2,9,28,-10
20796,20,71,8883,82,61,39,22,76,-7
20797,23,71,8883,65,33,20,13,44,-24
20798,26,71,8883,71,31,13,18,62,0
20799,29,71,8883,82,54,28,26,58,-2
20800,32,71,8883,82,70,31,39,58,10
20801,35,71,8883,61,50,15,35,48,7
20802,38,71,8883,66,61,27,34,67,5
20803,41,71,8883,82,59,23,36,70,11
20805,50,71,8883,53,53,31,22,38,2
20806,50,76,8883,18,15,5,10,14,0
20807,53,64,8883,55,37,14,23,50,-4
20808,56,64,8883,77,59,26,33,62,-15
20809,59,88,8883,67,53,22,31,42,8
20810,62,88,8883,82,47,23,24,35,-1
20811,65,71,8883,82,46,19,27,82,-5
20812,68,71,8883,47,13,2,11,40,-5
20813,71,71,8883,72,23,10,13,44,-18
20814,71,80,45595,49,9,3,6,14,-5
20815,74,80,45595,81,21,5,16,6,-4
20816,77,80,45595,75,26,10,16,18,9
20817,80,80,45595,79,17,2,15,20,-11
20818,83,80,45595,82,19,5,14,12,-27
20819,86,80,45595,74,26,7,19,18,-22
20820,14,81,8823,36,5,1,4,44,-2
20822,20,81,8823,63,14,9,5,134,-13
20823,23,81,8823,67,17,8,9,132,-9
20824,23,62,8823,12,5,4,1,28,-1
20825,26,62,8823,78,21,8,13,177,-12
20826,29,62,8823,64,22,11,11,120,-10
20827,32,62,8823,65,15,10,5,177,-15
20828,35,68,8823,70,31,11,20,178,-4
20829,38,76,8823,81,28,9,19,116,5
20830,41,76,8823,13,4,1,3,24,-1
20831,41,69,8823,62,18,7,11,106,-6
20832,47,62,8823,33,3,1,2,65,-3
20833,47,72,8823,16,1,1,0,38,-1
20834,14,76,40899,33,4,1,3,100,-8
20835,17,76,40899,18,3,1,2,47,-6
20836,17,89,8853,1,0,0,0,0,-1
20837,23,89,8853,4,1,0,1,0,0
20839,29,89,8853,8,1,0,1,2,1
20840,32,65,8853,8,0,0,0,6,-4
20841,38,84,8853,8,3,1,2,4,4
20842,41,79,8853,5,0,0,0,2,-7
20843,41,84,8853,9,3,0,3,2,3
20844,47,84,8853,70,34,5,29,30,11
20845,50,77,8853,6,1,0,1,21,0
20846,50,70,8853,7,2,0,2,0,0
20847,59,84,8853,12,2,1,1,2,7
20848,14,86,9157,48,25,15,10,14,-8
20849,17,86,9157,79,46,15,31,42,-19
20850,20,86,9157,82,62,28,34,75,-8
20851,23,86,9157,79,63,31,32,40,8
20852,26,86,9157,78,57,22,35,42,3
20853,29,86,9157,82,61,26,35,47,-2
20854,32,86,9157,64,36,12,24,56,7
20856,35,1479,9157,81,43,17,26,44,-1
20857,38,72,9157,81,51,23,28,26,23
20858,41,72,9157,81,37,17,20,26,8
20859,47,89,9157,33,7,3,4,24,-11
20860,47,1479,9157,18,4,1,3,8,-4
20861,50,62,9157,72,12,6,6,34,-2
20862,74,79,59793,34,7,2,5,4,-11
20863,77,79,59793,22,7,0,7,2,4
20864,80,79,59793,11,0,0,0,4,-4
20865,83,84,59793,71,22,3,19,39,-22
20866,86,84,59793,62,12,3,9,30,-1
20867,20,64,8747,5,0,0,0,11,-1
20868,23,64,8747,8,2,1,1,27,-3
20869,26,64,8747,22,0,0,0,71,-2
20870,26,62,8747,9,1,0,1,23,3
20871,29,62,8747,40,2,0,2,122,-4
20873,32,83,8747,16,2,1,1,31,-4
20874,35,83,8747,63,4,1,3,142,2
20875,38,83,8747,55,9,3,6,196,-2
20876,41,83,8747,34,2,1,1,109,0
20877,47,83,8747,55,3,0,3,109,-13
20878,50,83,8747,65,3,0,3,110,-8
20879,53,83,8747,30,1,1,0,66,-2
20880,53,68,8747,17,0,0,0,12,0
20881,56,68,8747,15,0,0,0,25,0
20882,56,73,8747,38,2,0,2,54,-1
20883,59,73,8747,39,2,0,2,58,0
20884,62,73,8747,15,0,0,0,18,-1
20885,68,67,42446,25,5,1,4,0,-1
20886,71,67,42446,18,3,2,1,2,-3
20887,74,67,42446,25,6,3,3,2,-10
20888,77,64,42446,74,27,6,21,8,2
20890,41,62,8998,79,29,16,13,32,4
20891,47,62,8998,55,26,6,20,48,-1
20892,50,62,8998,81,46,20,26,48,10
20893,53,62,8998,82,36,14,22,67,-6
20894,56,62,8998,50,30,9,21,30,11
20897,62,73,8998,2,0,0,0,0,-1
20898,65,83,8998,62,18,8,10,10,-19
20900,68,1479,8998,7,0,0,0,4,-2
20901,14,67,8571,1,1,1,0,0,-2
20902,17,67,8571,2,0,0,0,0,0
20903,20,67,8571,45,6,2,4,64,-2
20904,23,67,8571,69,12,6,6,87,9
20905,26,67,8571,67,13,5,8,38,-6
20906,29,67,8571,41,12,5,7,38,-8
20785,38,72,8652,50,13,5,8,22,2
20786,47,66,8652,72,23,3,20,37,-1
20911,38,79,8571,70,16,5,11,55,-30
20912,38,86,8571,7,2,1,1,0,2
20913,41,86,8571,72,29,9,20,90,4
20914,47,86,8571,21,8,5,3,17,-6
20915,47,63,8571,50,14,6,8,40,-10
20916,50,63,8571,51,15,7,8,75,-15
20917,50,62,8571,27,7,3,4,36,-2
20918,53,62,8571,43,10,3,7,26,-3
20919,56,62,8571,24,4,0,4,14,-3
20920,59,83,8571,59,8,3,5,35,-1
20921,20,75,11822,8,0,0,0,22,-1
20922,26,75,11822,5,0,0,0,21,0
20923,26,65,11822,61,8,1,7,184,-4
20924,29,65,11822,57,9,0,9,134,-1
20925,32,74,11822,48,4,1,3,107,0
20926,35,69,11822,51,4,0,4,123,-11
20928,41,69,11822,30,1,0,1,54,-1
20929,41,67,11822,13,2,0,2,12,3
20930,80,63,90403,2,0,0,0,2,0
20931,83,63,90403,61,15,3,12,22,21
20932,86,63,90403,66,18,3,15,68,9
20933,23,70,67479,4,0,0,0,19,-1
20934,26,70,67479,17,0,0,0,23,-2
20936,29,62,67479,2,0,0,0,0,-4
20937,35,62,67479,4,1,1,0,2,-3
20938,38,67,67479,17,5,1,4,14,1
20939,41,67,67479,19,3,2,1,14,0
20940,38,67,8803,1,0,0,0,0,0
20941,47,67,8803,78,24,9,15,65,4
20942,50,67,8803,54,22,9,13,74,11
20943,53,67,8803,82,36,10,26,85,-4
20944,56,67,8803,62,29,12,17,108,4
20946,62,67,8803,81,31,12,19,101,7
20947,65,67,8803,56,17,7,10,70,-1
20948,65,73,8803,14,4,0,4,6,0
20949,68,73,8803,23,5,2,3,20,-1
20950,71,73,8803,75,21,10,11,61,-6
20951,74,73,8803,73,14,4,10,60,7
20952,77,73,8803,63,6,2,4,46,-4
20953,77,62,94298,1,1,1,0,2,1
20954,83,80,94298,1,1,1,0,0,-2
20955,77,79,41635,18,4,1,3,4,0
20956,80,79,41635,10,0,0,0,2,-4
20957,83,78,41635,42,5,1,4,14,-5
20958,86,78,41635,74,31,14,17,22,-1
20959,17,79,42844,54,4,2,2,59,-6
20960,20,68,42844,47,8,2,6,42,5
20961,23,68,42844,61,15,5,10,47,4
20963,29,68,42844,13,0,0,0,14,-5
20964,20,72,4519,2,0,0,0,0,0
20965,26,72,4519,53,27,11,16,28,11
20966,29,72,4519,20,7,3,4,8,-6
20967,29,84,4519,17,3,2,1,14,-7
20968,35,77,12241,3,0,0,0,0,-1
20969,38,77,12241,14,0,0,0,4,1
20970,38,79,12241,12,6,2,4,0,1
20971,47,79,12241,9,0,0,0,9,-3
20972,59,63,12241,1,0,0,0,0,0
20973,26,1479,236,64,8,3,5,14,-9
20974,29,1479,236,5,1,1,0,2,0
20975,29,76,236,14,6,2,4,0,0
20976,14,80,6639,48,4,1,3,37,-20
20977,17,80,6639,82,12,3,9,54,-16
20978,20,80,6639,5,0,0,0,2,2
20980,26,80,6639,3,2,0,2,0,-1
20981,26,74,6639,18,0,0,0,8,-1
20985,32,81,6639,16,2,0,2,8,-1
20986,35,81,6639,77,8,1,7,24,-18
20987,38,81,6639,70,5,1,4,43,-6
20988,41,73,6639,1,1,0,1,0,2
20994,29,72,11358,4,1,1,0,2,-2
20995,32,82,11358,57,23,7,16,16,-19
20996,35,82,11358,75,25,7,18,26,-34
20998,41,65,11358,51,11,4,7,18,-26
20999,50,76,11358,5,0,0,0,0,0
21000,20,68,29039,19,2,1,1,4,-3
21001,20,83,29039,10,3,0,3,6,-2
21002,26,83,29039,4,0,0,0,0,0
21003,26,88,29039,6,0,0,0,5,-3
21004,29,88,29039,1,1,0,1,2,0
21006,23,71,6444,14,3,1,2,4,-4
21007,26,76,6444,75,25,8,17,12,-2
21008,29,76,6444,45,11,5,6,17,-8
21009,32,73,6444,18,2,1,1,8,-2
21010,38,66,6444,5,0,0,0,0,-1
21011,74,77,122838,2,0,0,0,0,-2
21012,77,77,122838,64,46,17,29,24,8
21013,80,77,122838,76,39,7,32,32,-21
21014,83,77,122838,78,65,13,52,25,10
21015,86,77,122838,78,37,9,28,22,-20
21016,32,63,10849,10,2,0,2,4,-3
21017,38,63,10849,4,1,1,0,0,0
21018,41,63,10849,2,0,0,0,0,-1
21019,17,68,8809,28,3,0,3,46,4
21020,20,68,8809,62,13,4,9,88,20
21021,23,68,8809,79,4,0,4,99,-16
21023,26,67,8809,13,1,1,0,20,3
21024,29,67,8809,61,3,0,3,89,18
21025,32,67,8809,77,19,3,16,78,10
21026,35,67,8809,65,10,5,5,113,15
21027,38,67,8809,50,9,0,9,63,1
21028,41,62,8809,77,17,3,14,97,8
21029,47,62,8809,61,6,3,3,54,7
21030,50,62,8809,62,10,4,6,67,6
21031,53,62,8809,31,4,1,3,21,-2
21032,23,68,9030,10,2,0,2,0,-4
21033,26,68,9030,1,1,1,0,0,0
21034,29,68,9030,66,16,4,12,14,1
21035,29,81,9030,14,2,0,2,2,-9
21036,32,81,9030,80,21,7,14,44,-20
20908,32,81,8571,47,15,2,13,77,-17
20909,32,79,8571,28,7,1,6,54,0
21041,47,78,9030,65,9,3,6,33,-21
21042,50,78,9030,59,11,7,4,47,-7
21043,53,78,9030,79,18,5,13,22,-2
21044,56,84,9030,62,9,2,7,12,1
21045,59,84,9030,58,5,1,4,12,-4
21046,62,65,9030,34,6,1,5,8,-2
21047,20,76,12764,4,1,1,0,0,1
21048,23,76,12764,8,0,0,0,4,-4
21049,26,67,12764,3,0,0,0,8,-1
21050,29,67,12764,9,1,0,1,0,0
21051,35,88,12764,3,0,0,0,0,-1
21052,38,88,12764,2,1,0,1,0,1
21053,41,88,12764,52,6,3,3,24,5
21054,50,68,7416,13,3,1,2,2,1
21055,56,68,7416,1,0,0,0,0,0
21056,80,81,41763,3,0,0,0,2,-2
21058,23,65,30070,66,13,6,7,55,-2
21059,26,65,30070,40,8,3,5,21,-7
21060,29,65,30070,54,8,3,5,43,-10
21061,32,65,30070,59,8,4,4,22,-9
21062,23,84,8869,76,24,13,11,165,-4
21063,26,84,8869,82,26,13,13,140,-12
21064,29,84,8869,21,4,0,4,24,-3
21065,29,76,8869,44,26,12,14,93,0
21066,32,76,8869,81,45,21,24,114,-9
21067,35,76,8869,80,27,12,15,111,-4
21068,38,76,8869,81,45,27,18,108,9
21069,41,76,8869,61,25,9,16,78,12
21070,47,63,8869,16,10,4,6,28,-2
21073,59,73,8869,16,5,3,2,17,3
21074,62,78,8869,8,1,0,1,6,1
21075,38,86,11749,4,0,0,0,4,-2
21077,47,74,11749,1,1,0,1,4,2
21078,77,76,89742,9,2,0,2,0,-1
21079,80,76,89742,44,10,3,7,6,-5
21080,83,76,89742,78,19,3,16,28,7
21081,86,76,89742,78,21,5,16,24,22
21082,80,74,121917,80,27,16,11,26,-13
21083,83,74,121917,79,28,17,11,20,-18
21084,86,74,121917,81,35,17,18,21,-6
21085,14,67,9094,1,2,1,1,2,2
21086,17,67,9094,4,0,0,0,0,0
21087,20,67,9094,28,7,4,3,18,4
21088,23,67,9094,63,24,12,12,34,11
21089,26,67,9094,78,47,16,31,56,23
21090,29,67,9094,74,51,22,29,42,19
21091,32,67,9094,70,32,10,22,34,15
21092,35,67,9094,82,37,20,17,32,-4
21094,41,67,9094,68,21,9,12,30,2
21095,41,86,9094,12,4,2,2,6,1
21096,47,65,9094,71,15,5,10,38,-9
21097,50,86,9094,78,20,8,12,56,-2
21098,53,86,9094,33,9,5,4,10,4
21099,20,74,19458,41,13,10,3,10,-5
21100,23,74,19458,11,2,2,0,4,-4
21101,29,74,19458,1,0,0,0,0,-1
21102,74,72,55919,51,17,5,12,22,-13
21103,77,72,55919,72,21,1,20,32,-8
21104,80,72,55919,80,31,3,28,58,-31
21105,83,72,55919,76,24,9,15,42,-8
21106,86,72,55919,82,39,11,28,58,-27
21107,17,83,31366,1,0,0,0,0,0
21108,23,76,31366,5,0,0,0,0,-3
21109,29,76,31366,5,2,1,1,4,3
21111,14,79,5208,1,1,0,1,2,1
21112,17,79,5208,56,10,4,6,36,3
21113,20,79,5208,1,0,0,0,0,-1
21114,20,1479,5208,11,2,1,1,10,0
21115,23,1479,5208,15,2,0,2,8,-3
21116,26,77,5208,7,0,0,0,0,-1
21117,35,69,5208,63,25,10,15,10,-1
21118,38,69,5208,81,24,14,10,16,-3
21119,41,69,5208,73,25,13,12,28,0
21120,47,84,5208,60,18,8,10,29,-2
21121,50,76,5208,82,26,10,16,33,4
21122,53,76,5208,82,32,12,20,20,-4
21123,56,76,5208,71,31,14,17,34,-13
21124,59,76,5208,81,31,9,22,28,-9
21125,65,79,5208,54,14,7,7,12,-1
21126,17,72,8694,1,0,0,0,0,-1
21128,23,72,8694,74,37,18,19,28,18
21129,26,72,8694,74,50,17,33,34,19
21130,29,72,8694,72,72,35,37,58,16
21131,32,72,8694,82,96,40,56,51,45
21132,35,72,8694,75,61,29,32,36,4
21133,38,72,8694,81,57,28,29,22,17
21134,41,72,8694,82,81,38,43,44,26
21135,47,72,8694,38,45,16,29,20,11
21136,50,72,8694,75,69,21,48,38,1
21137,53,72,8694,74,55,20,35,38,10
21138,56,72,8694,77,78,31,47,32,18
21139,59,72,8694,58,48,19,29,40,18
21140,62,72,8694,81,62,21,41,16,-4
21141,65,72,8694,81,78,26,52,16,-8
21142,68,72,8694,48,36,14,22,22,5
21143,71,72,8694,65,53,18,35,30,-4
21145,77,72,8694,16,8,2,6,10,5
21146,41,85,10994,22,2,1,1,74,-3
21147,50,85,10994,6,0,0,0,9,0
21148,53,76,10994,4,1,0,1,2,0
21149,80,74,131111,1,0,0,0,0,-1
21150,83,74,131111,28,9,1,8,12,6
21151,86,74,131111,43,10,4,6,8,-4
21152,2,72,8702,76,38,4,34,48,10
21153,5,72,8702,76,32,7,25,55,10
21156,11,65,8702,54,26,3,23,31,6
21157,14,65,8702,48,13,3,10,33,1
21158,17,65,8702,77,15,5,10,65,14
21159,20,65,8702,81,32,7,25,62,19
21160,23,65,8702,82,23,2,21,106,10
21038,38,68,9030,58,7,2,5,26,-13
21039,38,78,9030,17,0,0,0,12,0
21165,32,63,8702,22,6,1,5,10,-8
21166,35,77,8702,80,24,4,20,26,27
21167,38,77,8702,81,20,2,18,40,16
21168,41,77,8702,54,9,2,7,32,11
21169,41,78,8702,26,10,2,8,14,1
21170,47,78,8702,59,17,1,16,44,-10
21171,47,84,8702,16,0,0,0,8,-13
21172,86,79,430405,28,10,6,4,15,7
21173,23,79,8737,8,0,0,0,6,-1
21174,26,79,8737,17,0,0,0,6,-7
21175,29,79,8737,3,0,0,0,0,3
21176,32,79,8737,5,1,0,1,2,1
21177,32,71,8737,7,2,1,1,2,2
21178,35,71,8737,14,0,0,0,4,0
21179,38,76,8737,37,4,0,4,26,-6
21180,41,76,8737,41,7,1,6,30,-3
21182,38,67,22624,1,0,0,0,0,0
21183,71,67,45436,7,1,0,1,15,-3
21184,74,67,45436,2,0,0,0,0,0
21185,77,67,45436,77,14,4,10,51,6
21186,80,67,45436,76,20,3,17,26,-7
21187,83,67,45436,53,12,3,9,26,-11
21188,86,67,45436,59,14,4,10,35,-4
21189,14,75,14451,3,0,0,0,4,0
21190,17,75,14451,48,7,3,4,163,5
21191,20,75,14451,56,6,4,2,114,-8
21193,23,66,14451,7,1,0,1,22,2
21194,23,80,14451,46,8,5,3,96,1
21195,26,80,14451,38,7,1,6,65,-2
21196,26,65,14451,4,0,0,0,14,0
21197,29,70,14451,32,3,2,1,62,-7
21198,47,75,9120,8,0,0,0,4,2
21200,77,66,59905,21,4,3,1,10,-14
21201,80,66,59905,57,16,7,9,6,-11
21202,83,66,59905,80,30,16,14,22,-12
21203,86,66,59905,82,26,10,16,20,10
21204,17,76,8749,1,0,0,0,7,0
21205,23,76,8749,17,1,0,1,36,1
21206,23,84,8749,11,1,0,1,29,-3
21207,26,84,8749,65,3,0,3,114,-19
21208,29,84,8749,63,4,1,3,64,-13
21209,32,84,8749,60,5,1,4,64,16
21210,35,84,8749,44,6,2,4,96,4
21211,38,65,8749,48,5,2,3,87,-4
21212,41,65,8749,54,4,1,3,73,-16
21213,47,74,8749,65,7,3,4,66,-10
21214,50,74,8749,8,0,0,0,2,0
21215,53,74,8749,52,2,1,1,40,0
21217,59,71,8749,72,6,0,6,50,-18
21218,62,71,8749,43,2,0,2,23,-16
21219,38,76,2657,2,0,0,0,0,1
21220,41,76,2657,4,0,0,0,2,-2
21221,47,76,2657,18,0,0,0,16,-2
21222,71,89,90401,34,6,1,5,23,-9
21223,77,89,90401,3,0,0,0,0,-2
21224,77,83,90401,16,4,2,2,15,-3
21225,80,83,90401,67,8,2,6,51,8
21226,83,83,90401,47,12,4,8,27,5
21227,86,70,90401,14,4,1,3,13,-7
21228,86,72,90401,20,7,1,6,6,-6
21229,2,67,32764,43,3,1,2,86,-18
21230,5,67,32764,41,11,2,9,157,-3
21231,5,74,32764,11,0,0,0,24,2
21232,8,74,32764,53,10,1,9,107,-2
21234,14,74,32764,43,9,2,7,36,0
21235,17,78,32764,76,3,0,3,67,-8
21236,20,81,32764,21,0,0,0,13,-3
21237,35,62,8060,2,0,0,0,2,0
21238,38,62,8060,16,3,1,2,4,-5
21239,50,79,8060,3,1,0,1,4,-3
21240,53,78,8060,2,0,0,0,2,1
21241,17,75,1898,24,4,0,4,8,-3
21242,35,76,1898,27,6,0,6,4,0
21243,23,72,4501,60,10,3,7,85,18
21244,26,72,4501,70,8,1,7,110,5
21245,29,72,4501,52,8,0,8,70,-6
21246,29,75,4501,19,3,3,0,44,7
21247,32,75,4501,52,11,3,8,95,-11
21248,35,75,4501,34,8,3,5,62,-5
21249,41,75,4501,63,35,15,20,104,4
21251,50,75,4501,81,64,26,38,135,-28
21252,53,71,4501,26,10,3,7,36,-7
21253,56,71,4501,81,53,23,30,98,1
21254,59,71,4501,37,13,4,9,65,-19
21255,65,70,4501,64,21,6,15,73,11
21256,68,1479,4501,44,17,7,10,52,19
21257,26,64,8801,79,44,20,24,62,9
21258,29,64,8801,82,67,20,47,42,8
21259,32,64,8801,71,65,24,41,47,6
21260,35,64,8801,82,46,21,25,38,1
21261,38,62,8801,80,53,23,30,33,-9
21262,41,67,8801,76,53,18,35,68,8
21263,47,67,8801,81,67,30,37,32,-11
21264,50,67,8801,77,69,37,32,30,1
21265,53,74,8801,82,58,25,33,45,-3
21266,56,74,8801,81,56,22,34,32,-8
21268,62,74,8801,24,5,1,4,8,2
21269,32,79,70055,1,0,0,0,0,0
21270,32,79,13649,29,9,3,6,30,-5
21271,32,69,13649,28,6,2,4,21,-4
21272,35,69,13649,6,2,2,0,8,1
21273,2,63,8815,80,43,11,32,78,0
21274,5,63,8815,78,46,9,37,54,-9
21275,8,63,8815,64,33,8,25,47,-2
21276,11,63,8815,81,58,14,44,64,1
21280,23,66,8815,82,25,6,19,36,7
21281,26,66,8815,74,24,7,17,44,14
21282,29,66,8815,78,22,7,15,38,-4
21283,32,66,8815,71,21,5,16,42,-2
21284,35,66,8815,77,18,5,13,56,-8
21162,26,75,8702,66,18,6,12,77,-12
21163,29,75,8702,77,29,4,25,39,4
21289,50,66,8815,68,13,1,12,56,11
21290,53,66,8815,78,8,1,7,52,-3
21291,77,75,76375,3,2,0,2,0,2
21292,80,75,76375,3,2,0,2,2,1
21293,83,75,76375,72,30,10,20,38,-12
21294,86,75,76375,32,5,3,2,16,-9
21295,74,66,45690,2,0,0,0,0,-1
21296,77,66,45690,5,0,0,0,7,0
21297,29,62,8762,22,1,0,1,14,-3
21298,32,62,8762,29,6,5,1,38,0
21299,35,62,8762,64,17,10,7,79,-12
21300,38,62,8762,81,22,10,12,126,-11
21301,41,62,8762,82,25,10,15,106,-3
21302,47,89,8762,78,39,20,19,110,9
21303,50,89,8762,74,54,30,24,66,-10
21304,53,89,8762,18,9,5,4,43,0
21306,59,89,8762,38,15,4,11,27,-4
21307,59,82,8762,36,5,3,2,21,-8
21308,62,82,8762,53,15,5,10,38,-3
21309,77,66,69448,2,0,0,0,0,-1
21310,83,66,69448,1,0,0,0,2,0
21311,86,66,69448,1,0,0,0,5,-1
21312,83,64,122054,37,2,0,2,12,0
21313,86,64,122054,2,1,1,0,0,0
21314,77,77,45629,6,0,0,0,0,0
21315,80,77,45629,10,2,1,1,4,-1
21316,83,77,45629,39,5,1,4,6,-7
21318,20,62,10655,10,3,1,2,2,1
21319,23,62,10655,31,16,9,7,6,4
21320,26,62,10655,23,10,5,5,11,-4
21321,29,62,10655,32,14,5,9,12,0
21325,35,69,10655,27,6,1,5,10,-5
21327,77,66,97672,63,20,2,18,8,1
21328,80,66,97672,82,34,5,29,12,23
21329,83,66,97672,82,30,8,22,10,1
21330,86,66,97672,82,31,8,23,18,0
21331,17,68,1806,9,2,0,2,2,-1
21332,20,68,1806,39,14,7,7,32,1
21333,23,68,1806,41,21,9,12,8,-3
21334,26,68,1806,2,1,0,1,0,1
21335,77,85,86061,37,14,9,5,5,1
21336,80,85,86061,64,29,18,11,28,-7
21337,83,85,86061,71,33,16,17,16,-15
21338,86,85,86061,76,54,30,24,38,-9
21339,41,78,24040,6,0,0,0,25,0
21342,41,73,10313,7,1,1,0,0,-3
21343,47,73,10313,11,0,0,0,0,-6
21344,47,78,10313,15,7,3,4,10,1
21346,17,67,8659,1,0,0,0,0,0
21347,20,67,8659,5,0,0,0,2,0
21348,23,67,8659,27,11,5,6,15,0
21349,26,67,8659,72,31,7,24,61,11
21350,29,67,8659,76,37,10,27,62,12
21351,32,67,8659,75,31,10,21,81,-2
21352,35,67,8659,76,23,7,16,82,-7
21353,38,67,8659,44,11,7,4,23,-2
21354,38,80,8659,11,8,2,6,8,3
21355,41,80,8659,30,10,5,5,26,2
21356,47,80,8659,76,21,5,16,50,2
21357,23,70,8995,4,1,0,1,2,-2
21358,26,70,8995,14,3,1,2,19,3
21359,29,70,8995,60,4,3,1,50,-14
21360,32,70,8995,80,14,4,10,76,28
21361,35,70,8995,66,7,1,6,40,-1
21363,41,81,8995,79,19,5,14,24,29
21364,47,76,8995,57,13,1,12,32,-3
21365,47,72,8995,18,8,1,7,8,3
21366,50,72,8995,75,12,4,8,36,1
21367,53,81,8995,59,7,1,6,20,-15
21368,56,86,8995,58,8,0,8,12,5
21369,59,84,8995,13,2,1,1,4,5
21370,62,70,8995,5,0,0,0,0,2
21371,26,64,8598,82,48,14,34,26,8
21372,29,64,8598,82,72,36,36,16,14
21373,32,64,8598,80,79,41,38,36,32
21374,35,64,8598,62,44,21,23,24,0
21375,38,64,8598,82,98,50,48,32,52
21376,41,64,8598,82,75,35,40,20,19
21377,47,64,8598,74,58,24,34,24,13
21378,50,64,8598,80,70,35,35,44,10
21380,56,64,8598,82,59,27,32,16,-19
21381,59,64,8598,56,44,23,21,10,6
21382,62,64,8598,71,56,22,34,18,-23
21383,65,64,8598,81,37,14,23,14,-12
21384,68,64,8598,29,11,4,7,0,-7
21385,26,89,467570,30,4,2,2,8,-7
21386,32,89,467570,22,5,2,3,17,3
21387,35,68,467570,3,0,0,0,0,-2
21388,38,63,467570,3,0,0,0,0,0
21389,80,70,122990,17,6,3,3,21,-1
21390,83,70,122990,46,11,6,5,17,5
21391,86,70,122990,14,3,2,1,0,-1
21392,86,63,122990,3,0,0,0,0,-3
21393,74,62,88673,1,0,0,0,2,0
21394,77,62,88673,8,0,0,0,0,-2
21395,80,62,88673,21,3,0,3,12,-3
21397,86,75,88673,57,17,6,11,31,12
21398,41,63,8936,1,0,0,0,0,-1
21399,47,63,8936,20,0,0,0,27,0
21400,47,74,8936,15,1,0,1,44,1
21401,50,74,8936,53,3,2,1,126,-2
21402,53,74,8936,74,2,1,1,159,-13
21403,56,74,8936,82,5,1,4,193,-15
21404,59,83,8936,82,6,4,2,239,-4
21405,62,83,8936,46,2,2,0,128,-1
21406,65,83,8936,5,1,1,0,5,1
21407,68,83,8936,44,4,1,3,155,4
21408,71,83,8936,54,0,0,0,110,-3
21409,74,83,8936,1,0,0,0,0,0
21410,23,70,8483,21,6,4,2,2,8
21286,38,83,8815,7,3,0,3,4,3
21287,41,66,8815,74,6,0,6,32,18
21415,38,62,8483,19,4,2,2,12,1
21416,38,77,8483,4,0,0,0,4,-1
21417,26,63,13958,2,0,0,0,0,0
21418,29,63,13958,20,11,5,6,12,-1
21419,32,63,13958,7,0,0,0,4,-2
21420,38,78,13958,8,1,0,1,6,-2
21421,41,78,13958,44,18,7,11,44,-2
21422,41,65,13958,21,2,1,1,8,-6
21423,47,63,13958,16,6,2,4,8,2
21424,83,1479,121897,25,7,6,1,6,3
21425,86,1479,121897,3,0,0,0,0,-1
21426,71,81,649497,2,1,0,1,0,1
21427,74,81,649497,64,19,12,7,51,4
21428,77,81,649497,56,11,6,5,51,-2
21429,80,81,649497,58,10,4,6,80,-6
21430,83,81,649497,56,9,5,4,41,-5
21432,50,77,10206,8,0,0,0,11,0
21433,53,77,10206,70,4,1,3,202,2
21434,56,77,10206,63,3,0,3,174,-7
21435,59,77,10206,15,0,0,0,24,0
21436,29,81,182,28,4,2,2,36,-8
21437,32,81,182,43,20,9,11,40,-15
21438,41,86,182,82,55,22,33,34,30
21439,47,86,182,77,57,21,36,54,20
21440,50,79,182,34,15,6,9,24,-14
21441,23,1479,7297,48,7,3,4,40,-4
21442,26,1479,7297,63,4,0,4,60,-6
21443,29,1479,7297,57,17,2,15,34,12
21444,32,1479,7297,59,8,1,7,42,-12
21445,35,1479,7297,71,13,2,11,66,-5
21446,38,1479,7297,24,9,3,6,6,2
21447,38,68,7297,22,3,0,3,24,-1
21449,32,85,8707,5,3,0,3,2,1
21450,35,85,8707,25,10,8,2,4,2
21451,38,85,8707,16,6,3,3,2,3
21452,41,85,8707,49,13,6,7,15,1
21453,47,85,8707,80,58,21,37,26,4
21454,50,85,8707,58,26,11,15,24,7
21455,50,65,8707,20,6,4,2,20,-6
21456,53,65,8707,43,36,13,23,22,-2
21458,56,82,8707,39,29,12,17,16,5
21459,59,85,8707,44,15,6,9,8,-7
21460,62,70,8707,27,5,2,3,6,-2
21461,65,79,8707,8,2,1,1,4,1
21462,80,86,121985,3,1,1,0,0,-2
21463,83,86,121985,19,4,0,4,2,-3
21464,83,67,121985,2,0,0,0,0,1
21465,86,67,121985,1,0,0,0,0,0
21468,26,65,5365,7,0,0,0,2,-2
21469,77,65,8248,41,14,0,14,4,11
21470,83,65,8248,35,16,5,11,6,1
21471,86,65,8248,79,60,17,43,34,-6
21472,23,1479,7281,1,0,0,0,2,-2
21473,32,74,7281,6,0,0,0,5,-1
21474,35,63,7281,2,0,0,0,0,-1
21475,38,88,13960,10,2,0,2,5,-1
21476,32,71,13635,16,2,1,1,6,-1
21477,35,71,13635,8,2,1,1,0,-1
21478,38,71,13635,44,12,2,10,10,-7
21480,80,71,29277,62,15,3,12,29,8
21481,83,71,29277,73,21,6,15,49,5
21482,86,71,29277,70,17,5,12,33,11
21483,74,78,45360,23,3,2,1,26,-1
21484,77,78,45360,10,0,0,0,7,-4
21486,41,89,12012,37,2,0,2,135,-6
21487,80,88,90157,22,8,0,8,4,-5
21488,83,88,90157,12,4,3,1,6,5
21489,86,88,90157,33,5,2,3,12,0
21490,47,89,11745,2,0,0,0,5,-1
21491,77,65,91298,7,0,0,0,6,-1
21492,80,65,91298,49,14,6,8,17,-1
21493,83,65,91298,50,25,7,18,10,5
21494,86,87,91298,72,39,16,23,14,-4
21495,80,89,89903,3,0,0,0,0,0
21496,23,66,10212,33,6,2,4,10,-1
21497,26,66,10212,60,18,7,11,22,7
21498,29,66,10212,77,34,16,18,39,20
21499,32,66,10212,80,27,12,15,76,-14
21500,35,66,10212,82,46,21,25,44,-6
21501,38,66,10212,70,19,5,14,90,-17
21503,41,64,10212,4,1,0,1,4,-1
21504,41,89,10212,66,10,4,6,38,-23
21505,50,83,10212,82,31,12,19,45,9
21506,53,83,10212,13,0,0,0,7,-6
21507,17,80,6533,82,61,26,35,28,-18
21508,20,80,6533,76,71,24,47,30,5
21509,23,80,6533,55,45,17,28,18,7
21510,26,80,6533,58,33,11,22,14,8
21511,29,80,6533,57,59,21,38,28,11
21512,32,80,6533,68,70,24,46,30,11
21513,35,80,6533,78,71,37,34,45,3
21514,38,80,6533,78,78,27,51,42,15
21515,41,80,6533,77,80,32,48,24,12
21516,47,80,6533,77,103,43,60,50,29
21517,50,80,6533,77,87,29,58,42,42
21518,53,80,6533,70,89,40,49,34,15
21520,59,80,6533,70,71,20,51,22,8
21521,62,80,6533,54,31,14,17,18,-19
21522,65,80,6533,75,59,27,32,18,16
21523,68,80,6533,47,26,10,16,33,1
21524,71,85,6533,68,49,18,31,10,2
21525,56,88,10427,81,27,6,21,56,-17
21526,59,88,10427,82,59,16,43,54,20
21527,62,88,10427,76,40,11,29,68,13
21528,65,88,10427,77,36,10,26,69,-2
21529,68,88,10427,48,22,6,16,36,4
21530,71,88,10427,78,37,10,27,64,17
21531,74,88,10427,82,46,7,39,56,3
21532,77,88,10427,82,51,14,37,52,24
21533,80,88,10427,82,44,12,32,46,8
21412,29,70,8483,23,5,1,4,16,4
21413,32,70,8483,2,1,1,0,0,-3
21538,83,69,85379,1,0,0,0,4,1
21539,80,81,96110,35,11,0,11,35,10
21540,83,81,96110,48,11,3,8,38,17
21541,86,1479,96110,20,1,0,1,39,-4
21542,32,78,8860,75,10,2,8,69,-4
21543,35,78,8860,66,12,5,7,78,3
21544,38,78,8860,71,10,2,8,95,7
21545,41,78,8860,69,8,3,5,47,-4
21546,47,78,8860,46,5,1,4,26,-24
21547,50,78,8860,64,7,2,5,55,-5
21548,53,78,8860,56,11,1,10,43,12
21549,53,72,8860,8,0,0,0,11,0
21550,56,72,8860,76,16,3,13,78,-1
21551,59,72,8860,79,14,4,10,57,8
21552,65,72,8860,82,9,0,9,66,18
21553,68,72,8860,39,2,0,2,22,-12
21555,74,72,8860,15,2,0,2,20,-5
21556,77,72,99093,41,17,5,12,34,-14
21557,80,72,99093,27,9,3,6,26,-10
21558,83,1479,99093,3,0,0,0,2,2
21559,86,1479,99093,3,0,0,0,6,-1
21560,86,79,99093,6,0,0,0,0,0
21561,14,81,17588,43,16,10,6,14,-2
21562,17,81,17588,79,52,31,21,93,3
21563,20,81,17588,69,33,15,18,61,-3
21564,23,81,17588,70,35,16,19,85,-38
21565,26,81,17588,43,19,6,13,18,-8
21566,26,71,17588,29,14,8,6,24,0
21567,29,71,17588,67,47,27,20,46,2
21568,32,82,17588,59,19,8,11,38,-11
21569,23,86,10194,19,5,2,3,6,-5
21570,26,86,10194,55,30,12,18,26,3
21572,32,86,10194,70,25,12,13,41,2
21573,35,86,10194,32,10,3,7,14,2
21574,41,86,10194,63,37,19,18,18,20
21575,77,83,97394,7,6,1,5,0,-2
21576,80,83,97394,82,36,20,16,10,3
21577,83,83,97394,82,28,14,14,18,0
21578,86,83,97394,82,29,8,21,16,11
21579,56,78,11317,8,1,0,1,2,0
21580,59,78,11317,9,2,1,1,6,-9
21581,62,78,11317,79,43,11,32,19,18
21582,65,78,11317,81,51,12,39,36,16
21583,68,78,11317,47,24,5,19,10,0
21584,71,78,11317,81,51,8,43,32,20
21585,74,78,11317,81,46,7,39,28,-2
21586,77,78,11317,73,37,7,30,20,10
21587,80,78,11317,80,48,14,34,24,3
21589,86,78,11317,71,41,13,28,22,2
21590,77,84,78210,75,25,1,24,14,-21
21591,80,84,78210,71,19,5,14,31,-22
21592,83,84,78210,61,6,0,6,23,-9
21593,86,84,78210,69,20,5,15,43,-23
21594,2,85,72255,8,3,1,2,2,-2
21595,11,77,72255,10,4,1,3,8,-2
21596,83,64,60017,79,43,19,24,28,-7
21597,86,64,60017,78,42,15,27,38,-9
21598,17,63,45134,3,0,0,0,0,0
21599,20,63,45134,10,2,0,2,12,-5
21600,23,63,45134,0,0,0,0,0,0
21601,29,80,45134,73,7,4,3,145,3
21602,32,80,45134,64,8,3,5,169,1
21603,35,80,45134,56,14,6,8,148,3
21604,35,81,45134,9,2,1,1,63,-5
21606,41,81,45134,33,2,1,1,78,-5
21607,47,79,45134,42,3,2,1,116,-3
21608,50,79,45134,5,0,0,0,12,-1
21609,50,81,45134,51,3,1,2,116,-3
21610,53,81,45134,63,7,4,3,108,-1
21611,56,62,45134,44,3,3,0,83,-1
21612,2,63,67718,61,23,4,19,62,3
21613,5,63,67718,47,9,1,8,84,10
21614,8,63,67718,28,7,1,6,48,1
21615,11,63,67718,4,0,0,0,2,-3
21616,77,83,20067,4,2,0,2,0,4
21617,26,64,8783,1,0,0,0,0,0
21618,29,64,8783,15,3,2,1,6,1
21619,32,82,8783,81,30,13,17,107,-20
21620,35,82,8783,71,16,8,8,32,-20
21621,38,64,8783,66,10,4,6,64,-2
21625,83,1479,84817,14,1,0,1,2,-4
21626,86,1479,84817,28,4,1,3,12,-1
21628,65,547,9784,6,0,0,0,4,-1
21629,71,547,9784,3,1,1,0,0,2
21630,74,547,9784,2,0,0,0,0,-1
21631,20,77,12794,3,1,1,0,0,0
21632,23,77,12794,63,19,12,7,59,2
21633,26,77,12794,66,16,9,7,51,0
21634,26,81,12794,14,4,3,1,10,-5
21635,29,81,12794,8,0,0,0,18,-4
21636,29,80,12794,45,7,2,5,12,-1
21637,32,80,12794,39,1,0,1,31,-3
21638,32,74,12794,19,5,1,4,15,-3
21639,35,89,12794,38,8,5,3,15,-2
21640,38,89,12794,5,0,0,0,0,-2
21641,41,89,12794,2,0,0,0,0,0
21643,56,89,13428,26,5,1,4,14,4
21644,59,89,13428,40,6,2,4,22,-1
21645,62,89,13428,33,6,1,5,14,-6
21646,80,67,45409,5,0,0,0,4,0
21647,83,89,33214,63,14,3,11,10,13
21648,86,89,33214,45,10,1,9,4,9
21649,17,78,3575,25,5,2,3,48,-8
21650,20,88,3575,29,9,4,5,60,-7
21651,23,88,3575,25,3,0,3,55,-7
21652,26,88,3575,3,0,0,0,6,0
21653,26,65,3575,3,0,0,0,4,-4
21654,26,77,3575,48,3,0,3,80,-3
21655,32,80,8556,52,5,3,2,84,8
21656,35,80,8556,33,2,1,1,57,-10
21535,86,88,10427,82,45,8,37,44,-34
21536,77,69,85379,3,0,0,0,0,0
21663,53,63,8556,43,5,1,4,41,-4
21664,56,63,8556,65,12,3,9,45,6
21665,59,69,8556,70,14,2,12,66,-6
21666,62,63,8556,3,0,0,0,2,-2
21667,17,62,3569,5,1,1,0,2,-1
21668,23,62,3569,4,1,0,1,0,2
21669,26,83,3569,16,4,1,3,4,1
21670,29,1479,3569,77,21,5,16,27,-17
21671,32,1479,3569,51,7,4,3,42,-15
21673,35,85,3569,4,0,0,0,4,0
21674,38,62,3569,3,1,0,1,2,1
21675,20,76,59424,41,5,1,4,144,-10
21676,23,76,59424,20,0,0,0,35,-2
21677,26,76,59424,45,0,0,0,32,-10
21678,29,76,59424,65,4,1,3,103,-4
21679,32,76,59424,31,2,0,2,35,1
21681,38,76,59424,49,1,1,0,75,-5
21682,41,79,59424,5,0,0,0,2,-3
21683,41,76,59424,5,0,0,0,2,-1
21684,83,86,51979,62,12,3,9,8,13
21685,86,86,51979,44,7,0,7,15,-1
21687,2,62,32499,12,6,3,3,2,1
21688,5,62,32499,42,23,11,12,37,-6
21689,8,62,32499,22,11,4,7,8,10
21690,68,85,18940,44,26,12,14,12,-6
21691,71,72,18940,60,25,11,14,26,-11
21692,74,72,18940,17,7,2,5,8,-1
21693,47,83,10257,22,0,0,0,18,-10
21694,50,83,10257,16,2,0,2,20,-5
21695,53,83,10257,3,0,0,0,5,-1
21696,56,83,10257,11,0,0,0,34,-4
21697,2,65,22158,51,40,11,29,32,25
21699,8,86,22158,42,20,3,17,40,-28
21700,65,71,13623,24,1,0,1,25,-5
21701,74,89,84781,13,2,1,1,23,4
21702,80,89,84781,1,0,0,0,0,0
21703,83,89,84781,3,0,0,0,5,0
21704,2,78,23930,73,37,10,27,54,-1
21705,5,78,23930,64,29,12,17,46,10
21706,8,78,23930,78,19,8,11,44,-8
21707,11,75,23930,48,12,2,10,12,-2
21708,29,76,12240,14,9,0,9,10,0
21709,35,76,12240,2,0,0,0,2,-1
21710,38,72,12240,11,1,0,1,6,-2
21711,41,72,12240,11,3,0,3,4,-3
21712,53,84,11506,19,6,2,4,19,4
21713,56,84,11506,14,4,2,2,14,-2
21714,59,62,11506,3,0,0,0,0,-1
21716,83,88,98231,34,4,1,3,57,-4
21717,86,88,98231,11,1,0,1,11,-1
21718,56,76,103002,20,0,0,0,42,-4
21719,2,76,31698,76,42,24,18,45,-12
21720,5,76,31698,8,4,2,2,21,-3
21721,5,67,31698,70,36,20,16,65,-9
21722,8,67,31698,82,43,18,25,77,6
21723,11,67,31698,84,38,22,16,71,11
21724,14,83,31698,48,24,13,11,34,7
21725,17,83,31698,46,16,7,9,36,-4
21726,17,70,31698,30,5,1,4,26,-11
21727,20,76,31698,65,11,6,5,61,-7
21729,5,86,70554,60,19,4,15,107,-11
21730,8,86,70554,59,8,1,7,96,-50
21731,11,65,70554,72,12,3,9,116,2
21734,17,79,70554,41,12,2,10,87,12
21736,23,79,70554,34,6,2,4,24,0
21737,26,79,70554,24,0,0,0,22,-2
21738,71,81,28559,3,1,0,1,2,0
21739,56,62,11742,16,1,1,0,12,-2
21740,59,70,11742,11,1,1,0,2,1
21741,62,69,11742,11,1,1,0,4,-2
21742,65,69,11742,58,5,1,4,54,-15
21743,83,84,84456,5,2,0,2,2,4
21744,86,84,84456,17,1,0,1,2,-2
21745,26,88,3550,6,1,1,0,4,-1
21746,29,88,3550,1,0,0,0,0,0
21747,26,84,69990,73,36,16,20,98,-9
21748,29,84,69990,33,12,4,8,17,6
21749,29,76,69990,12,7,4,3,4,5
21750,32,76,69990,60,26,11,15,33,-4
21751,35,80,69990,70,8,0,8,46,-3
21758,17,64,71012,75,27,7,20,50,25
21759,20,81,71012,15,0,0,0,8,-9
21760,20,83,71012,23,4,0,4,13,3
21761,23,83,71012,10,0,0,0,6,-9
21762,80,84,76134,1,0,0,0,0,-1
21763,20,71,52945,1,0,0,0,2,0
21764,23,71,52945,11,4,4,0,8,-3
21765,26,71,52945,24,2,0,2,19,-6
21766,29,73,52945,57,14,3,11,28,-6
21767,32,73,52945,5,0,0,0,6,1
21768,32,81,52945,16,2,1,1,10,-8
21769,29,76,315927,68,28,11,17,16,-6
21770,29,1479,315927,13,3,1,2,0,-2
21771,17,72,8892,16,9,5,4,8,3
21772,20,72,8892,33,22,8,14,14,9
21773,20,83,8892,21,16,5,11,23,5
21775,26,83,8892,63,40,20,20,28,12
21776,29,83,8892,7,1,0,1,4,-1
21777,29,65,8892,73,64,22,42,52,20
21778,32,65,8892,81,75,34,41,54,3
21779,35,65,8892,78,60,21,39,67,23
21780,38,65,8892,82,61,26,35,42,15
21781,41,65,8892,56,43,15,28,36,-7
21782,41,73,8892,24,30,9,21,12,8
21783,47,73,8892,69,68,31,37,50,2
21784,50,73,8892,57,60,22,38,20,16
21785,56,73,8892,41,32,11,21,30,2
21786,59,73,8892,82,51,17,34,35,2
21787,62,73,8892,44,22,10,12,28,4
21788,65,79,8892,79,48,17,31,20,-3
21658,41,80,8556,37,5,0,5,72,2
21659,41,73,8556,9,2,0,2,10,3
21794,41,67,8552,44,3,1,2,110,-2
21801,65,72,8552,51,0,0,0,115,-12
21802,68,76,8552,15,0,0,0,36,-4
21803,71,76,8552,23,4,2,2,88,0
21804,74,76,8552,10,2,2,0,30,-1
21805,77,76,8552,6,0,0,0,2,-3
21806,41,74,60411,3,0,0,0,2,-1
21807,65,69,15377,1,0,0,0,2,0
21808,26,78,8944,2,0,0,0,5,-1
21809,29,78,8944,66,13,4,9,150,6
21810,32,78,8944,57,15,8,7,110,8
21811,35,78,8944,64,13,6,7,100,2
21812,38,78,8944,66,9,6,3,114,0
21815,17,89,8627,1,0,0,0,0,0
21816,20,89,8627,11,3,2,1,4,-5
21817,23,89,8627,65,26,17,9,28,-2
21819,29,89,8627,69,35,19,16,54,6
21820,32,89,8627,62,35,16,19,61,-2
21821,32,75,8627,12,9,3,6,10,-2
21822,35,75,8627,82,44,22,22,59,-3
21823,38,75,8627,80,50,31,19,79,4
21824,41,75,8627,81,50,26,24,63,5
21825,47,75,8627,67,30,16,14,48,-2
21826,50,89,8627,32,18,6,12,16,-4
21827,50,76,8627,10,3,1,2,2,-2
21828,53,68,8627,54,26,15,11,43,-5
21829,56,68,8627,70,33,17,16,46,2
21830,35,62,8723,11,3,1,2,26,-2
21831,38,62,8723,50,2,1,1,114,-9
21832,41,62,8723,26,3,1,2,50,-1
21833,47,62,8723,7,1,1,0,11,0
21834,47,68,8723,51,6,1,5,68,4
21836,53,68,8723,73,23,8,15,73,1
21837,56,1479,8723,65,20,4,16,125,14
21838,56,63,8723,13,1,0,1,18,3
21839,59,67,8723,78,23,5,18,75,0
21840,62,67,8723,73,26,5,21,83,16
21841,65,65,8723,52,14,5,9,45,4
21842,35,65,31353,37,6,4,2,19,-3
21843,41,77,31353,1,0,0,0,0,0
21844,71,79,46050,36,9,5,4,6,1
21845,74,79,46050,12,1,0,1,14,-2
21846,77,74,46050,6,2,1,1,2,-1
21847,80,84,46050,58,8,4,4,6,-4
21848,83,84,46050,1,0,0,0,0,0
21849,74,72,17652,1,0,0,0,0,1
21850,20,83,31457,73,41,25,16,2,-3
21851,23,83,31457,68,31,16,15,10,-3
21853,29,83,31457,61,39,26,13,2,8
21854,32,83,31457,79,50,22,28,8,2
21856,35,75,31457,29,10,4,6,4,3
21857,38,65,31457,66,31,18,13,8,-3
21858,38,89,31457,9,9,5,4,4,10
21859,20,85,641981,47,9,6,3,33,-10
21860,23,85,641981,57,22,5,17,44,6
21861,26,85,641981,82,34,13,21,69,-11
21862,29,85,641981,72,35,13,22,43,4
21863,32,85,641981,73,40,16,24,40,-12
21864,35,85,641981,69,26,8,18,58,-12
21865,38,85,641981,74,40,20,20,62,11
21866,41,85,641981,67,30,15,15,38,8
21867,47,85,641981,81,59,29,30,66,14
21868,50,85,641981,77,52,30,22,58,13
21869,53,85,641981,59,40,20,20,58,9
21871,59,85,641981,68,45,25,20,60,5
21872,62,85,641981,73,37,18,19,62,-6
21873,65,85,641981,74,24,11,13,40,-9
21874,62,62,14350,6,1,0,1,0,-1
21875,65,62,14350,9,0,0,0,0,1
21876,20,68,226,58,29,7,22,22,11
21877,23,83,226,22,5,1,4,10,-5
21878,23,80,226,9,1,0,1,6,3
21879,2,65,68884,61,16,3,13,77,6
21880,5,62,68884,47,13,4,9,45,-5
21881,8,62,68884,63,17,1,16,67,9
21882,11,62,68884,58,21,6,15,60,21
21883,14,62,68884,37,2,0,2,108,-4
21884,17,62,68884,69,3,0,3,88,-1
21885,20,78,68884,39,2,0,2,17,2
21886,23,65,68884,45,1,1,0,76,-5
21891,11,1479,10902,82,52,21,31,44,2
21892,14,83,10902,19,5,3,2,2,1
21893,23,78,10902,65,25,10,15,38,1
21894,26,78,10902,60,27,9,18,34,-9
21895,29,78,10902,26,13,4,9,22,2
21896,29,89,10902,35,11,6,5,12,2
21897,32,89,10902,12,3,0,3,8,0
21898,23,71,3574,2,0,0,0,0,-2
21899,32,69,3574,71,7,2,5,38,-11
21900,35,69,3574,74,8,1,7,28,-12
21901,38,69,3574,14,0,0,0,8,-3
21902,26,64,7591,2,0,0,0,0,0
21903,35,76,729606,62,19,3,16,38,-12
21904,38,79,729606,61,41,7,34,50,-11
21905,41,79,729606,80,52,16,36,38,-37
21906,47,79,729606,33,10,5,5,52,-10
21908,53,71,729606,29,5,1,4,40,-6
21909,53,82,729606,19,9,2,7,12,-5
21910,17,80,40679,50,15,7,8,28,-15
21912,2,79,8795,43,27,11,16,33,3
21916,17,64,8795,81,60,21,39,50,2
21917,20,64,8795,72,37,18,19,14,-5
21918,23,1479,8795,73,33,13,20,22,-13
21919,26,78,8795,75,52,24,28,27,8
21920,29,78,8795,75,39,24,15,18,12
21921,32,78,8795,81,73,40,33,30,15
21922,35,78,8795,67,41,19,22,26,11
21923,38,70,8795,79,42,23,19,30,24
21924,41,70,8795,53,16,8,8,14,-15
21925,47,78,8795,79,49,18,31,52,-32
21791,32,67,8552,35,3,1,2,94,-1
21792,35,67,8552,35,5,2,3,129,-1
21931,11,65,38190,11,8,5,3,8,1
21932,14,65,38190,15,9,4,5,6,4
21933,14,81,38190,29,19,8,11,12,-1
21934,17,81,38190,55,31,16,15,16,-19
21935,20,81,38190,39,17,5,12,4,1
21936,23,81,38190,82,40,13,27,32,-43
21937,26,81,38190,10,1,0,1,2,-5
21938,17,62,28725,41,16,6,10,14,2
21939,29,62,28725,9,2,0,2,4,0
21940,29,81,28725,5,2,0,2,2,1
21941,29,74,16533,76,21,6,15,46,-13
21942,32,74,16533,75,26,5,21,40,-3
21943,35,77,16533,82,41,11,30,42,12
21944,38,77,16533,82,39,10,29,38,11
21945,41,77,16533,80,42,13,29,26,16
21946,47,77,16533,47,25,6,19,34,5
21948,53,69,16533,80,27,4,23,42,-4
21949,56,69,16533,81,24,2,22,44,-3
21950,59,69,16533,52,14,6,8,26,3
21951,59,65,16533,8,3,1,2,4,7
21952,2,85,18900,80,108,51,57,34,-2
21953,5,85,18900,79,103,45,58,64,26
21954,8,85,18900,84,137,58,79,44,33
21955,11,85,18900,58,82,24,58,36,11
21956,14,85,18900,47,38,12,26,40,6
21957,17,85,18900,80,95,36,59,64,29
21958,20,85,18900,81,85,22,63,78,22
21959,23,85,18900,75,69,24,45,46,3
21960,26,85,18900,80,74,29,45,42,8
21961,29,85,18900,78,79,35,44,34,28
21962,32,85,18900,54,52,18,34,18,4
21963,35,85,18900,52,48,13,35,18,11
21965,41,85,18900,75,51,18,33,46,10
21966,47,85,18900,61,34,14,20,18,8
21967,2,85,61250,77,23,4,19,55,-2
21968,5,85,61250,3,0,0,0,15,-3
21969,5,78,61250,64,18,3,15,46,4
21970,8,78,61250,71,15,0,15,78,-2
21971,11,78,61250,74,10,2,8,85,-15
21972,14,78,61250,23,5,1,4,24,7
21973,17,63,61250,67,14,4,10,53,-7
21974,2,79,2084,66,48,12,36,59,15
21979,11,62,2084,13,10,3,7,18,0
21980,14,62,2084,48,28,4,24,46,9
21981,17,62,2084,80,29,12,17,115,11
21982,20,62,2084,2,0,0,0,0,-1
21983,23,62,2084,35,9,2,7,41,-12
21984,23,75,2084,28,6,1,5,22,-1
21986,65,88,10621,54,20,8,12,12,12
21987,68,88,10621,48,25,6,19,14,5
21988,71,88,10621,82,34,4,30,44,6
21989,74,88,10621,6,2,0,2,2,0
21990,17,62,8708,6,0,0,0,32,0
21991,20,62,8708,82,14,1,13,208,-14
21992,23,62,8708,53,6,1,5,109,-10
21993,26,62,8708,73,10,2,8,151,18
21994,29,68,8708,82,7,1,6,202,5
21995,32,68,8708,25,4,1,3,74,0
21999,41,1479,8708,46,7,4,3,105,-6
22000,41,80,8708,16,1,0,1,47,-1
22001,47,65,8708,45,3,0,3,116,-2
22002,47,75,8708,6,0,0,0,14,0
22003,71,84,62701,9,1,1,0,21,1
22004,35,81,17933,3,0,0,0,2,-1
22006,71,81,44415,43,8,1,7,16,3
22007,74,81,44415,72,13,0,13,34,10
22008,77,81,44415,77,21,4,17,30,-2
22009,80,81,44415,80,14,3,11,43,-10
22010,83,81,44415,44,7,2,5,18,-5
22011,86,1479,44415,5,0,0,0,6,0
22012,71,547,17512,30,7,3,4,10,-2
22013,74,547,17512,11,1,0,1,19,0
22014,77,80,76235,3,2,1,1,4,2
22015,80,80,76235,4,0,0,0,2,0
22016,74,67,38089,18,2,1,1,2,-5
22017,77,67,38089,17,3,1,2,2,3
22018,80,63,38089,59,14,7,7,23,-6
22019,83,63,38089,82,22,12,10,42,-5
22020,86,84,38089,47,10,3,7,9,-2
22021,71,74,38008,3,0,0,0,0,-1
22023,68,85,46960,11,1,0,1,2,4
22024,71,85,46960,65,23,4,19,30,10
22025,74,85,46960,80,31,2,29,42,11
22026,77,85,46960,78,20,8,12,44,2
22027,80,85,46960,82,12,4,8,33,-22
22028,83,85,46960,65,12,6,6,28,2
22029,86,85,46960,52,20,5,15,39,2
22030,17,78,67159,6,0,0,0,23,-2
22031,17,63,67159,2,0,0,0,5,1
22032,20,63,67159,2,0,0,0,0,0
22034,32,1479,67159,9,1,0,1,27,-1
22035,35,1479,67159,57,2,1,1,221,-4
22036,38,1479,67159,31,3,2,1,115,-2
22037,71,89,38051,29,6,2,4,6,4
22038,74,89,38051,39,4,1,3,10,-2
22039,77,89,38051,72,16,2,14,16,12
22041,83,20120,38051,76,36,5,31,16,19
22042,86,20120,38051,61,30,9,21,8,22
22043,71,86,31616,15,1,1,0,2,-2
22044,74,86,31616,4,0,0,0,2,-2
22045,71,63,37759,2,0,0,0,0,0
22046,74,63,37759,2,0,0,0,0,0
22047,17,70,447983,2,0,0,0,5,-2
22048,20,70,447983,3,0,0,0,27,0
22049,23,70,447983,3,0,0,0,15,-1
22050,26,73,447983,70,3,1,2,242,-7
22051,29,73,447983,21,0,0,0,70,-7
22052,32,71,447983,6,0,0,0,18,-2
22053,23,89,5299,9,3,0,3,6,1
22054,41,73,8572,9,0,0,0,38,-4
21927,2,85,38190,51,33,15,18,16,-8
21928,5,85,38190,79,75,35,40,55,44
22059,56,66,8572,27,1,1,0,40,0
22060,80,79,23955,27,7,3,4,4,2
22061,83,79,23955,44,5,2,3,4,-13
22062,86,1479,23955,62,20,7,13,12,0
22063,68,65,15515,2,0,0,0,0,-3
22064,68,67,37941,7,0,0,0,0,0
22065,71,67,37941,21,1,0,1,2,-3
22066,74,67,37941,4,1,0,1,0,3
22067,77,67,37941,1,0,0,0,2,0
22068,80,79,37941,34,10,2,8,8,9
22069,83,79,37941,44,5,2,3,16,-8
22070,86,79,37941,18,2,1,1,4,-9
22071,74,71,17840,9,6,1,5,0,-2
22072,77,71,17840,6,0,0,0,0,-1
22073,2,89,55546,20,12,7,5,10,-13
22074,2,83,55546,32,28,14,14,4,-7
22076,8,83,55546,70,35,12,23,24,0
22077,11,83,55546,41,16,8,8,19,5
22078,14,70,55546,30,11,6,5,19,-6
22079,17,78,55546,57,21,8,13,12,-2
22080,20,78,55546,35,13,4,9,12,6
22081,20,72,55546,18,3,0,3,4,4
22082,23,72,55546,5,3,0,3,0,2
22083,23,84,55546,25,17,5,12,2,13
22084,26,84,55546,41,14,6,8,16,5
22085,5,62,68903,5,1,0,1,42,-2
22087,5,86,55384,74,9,1,8,99,-23
22088,8,86,55384,80,7,0,7,150,-50
22089,11,86,55384,42,3,0,3,65,-7
22090,11,77,55384,33,4,0,4,69,-19
22091,14,77,55384,32,1,0,1,34,-3
22092,17,83,55384,29,1,0,1,48,-1
22094,23,83,55384,59,7,0,7,108,-8
22095,26,73,55384,2,0,0,0,2,-2
22096,29,89,55384,12,2,0,2,19,-1
22097,32,89,55384,29,4,0,4,55,0
22098,35,89,55384,49,5,1,4,56,3
22099,71,71,20512,57,7,1,6,34,-12
22100,71,77,15206,68,22,9,13,28,2
22101,74,77,15206,67,28,21,7,34,6
22102,77,77,15206,82,31,13,18,30,9
22103,80,77,15206,52,11,8,3,20,-7
22104,83,77,15206,76,22,13,9,28,9
22105,86,77,15206,67,18,6,12,32,-1
22108,32,80,52927,5,0,0,0,13,0
22109,71,71,16802,17,3,1,2,0,-6
22110,74,71,16802,60,20,2,18,4,-21
22111,77,71,16802,30,12,4,8,6,-4
22113,83,71,16802,66,21,5,16,18,-12
22114,86,71,16802,61,28,5,23,16,-11
22115,77,65,13531,27,4,2,2,4,-5
22116,47,75,10230,4,0,0,0,9,-1
22117,50,88,10230,66,8,4,4,140,-12
22118,53,88,10230,73,8,6,2,134,-10
22119,56,88,10230,76,2,2,0,145,-8
22120,59,88,10230,61,0,0,0,136,-8
22121,62,62,10230,1,0,0,0,5,-1
22122,65,62,10230,1,0,0,0,0,-1
22123,41,63,52057,35,1,0,1,132,2
22124,47,89,52057,2,0,0,0,19,-1
22125,80,63,67227,19,2,1,1,7,-2
22126,83,63,67227,1,0,0,0,0,0
22127,86,63,67227,1,0,0,0,0,0
22128,47,66,9161,1,1,0,1,0,2
22130,77,81,34840,6,1,0,1,0,1
22131,80,81,34840,18,3,0,3,4,2
22132,32,69,10399,1,0,0,0,0,0
22133,35,69,10399,4,0,0,0,2,-1
22134,41,69,10399,5,1,0,1,0,-3
22136,83,74,146246,28,5,2,3,14,-11
22137,86,74,146246,5,0,0,0,4,-3
22138,83,83,44007,9,3,2,1,0,-2
22139,86,83,44007,73,43,20,23,32,14
22140,86,89,88750,2,2,1,1,7,3
22141,80,68,97970,3,0,0,0,4,0
22142,83,68,97970,60,8,2,6,32,5
22143,86,68,97970,64,15,4,11,64,-3
22144,80,65,151880,33,7,4,3,14,2
22145,83,82,151880,31,5,3,2,2,-3
22146,83,84,151880,15,2,2,0,4,-1
22148,83,72,97644,81,44,5,39,8,1
22149,86,72,97644,78,30,4,26,18,-17
22150,86,66,73159,34,8,4,4,20,0
22151,83,547,118053,24,2,1,1,0,2
22152,86,63,131428,19,1,0,1,15,5
22153,86,65,94295,15,1,0,1,8,-8
22154,83,69,107526,3,0,0,0,2,-2
22155,80,88,108358,6,2,0,2,2,2
22156,83,88,108358,35,6,4,2,6,4
22157,86,88,108358,13,3,2,1,2,0
22158,86,68,76227,37,2,1,1,28,-3
22159,80,67,118715,1,0,0,0,0,0
22160,77,67,114852,7,2,1,1,4,2
22161,80,67,114852,10,1,0,1,2,-1
22162,83,67,114852,5,0,0,0,2,-1
22169,65,547,8564,78,21,13,8,42,-9
22171,71,547,8564,27,2,1,1,8,-5
22172,74,547,8564,82,13,5,8,58,-4
22173,83,77,56890,9,0,0,0,2,-2
22174,86,77,56890,2,0,0,0,0,0
22175,80,65,151879,12,4,1,3,4,3
22176,83,65,151879,47,13,4,9,54,-4
22177,86,65,151879,54,5,3,2,27,-12
22178,80,74,158958,41,20,8,12,13,6
22179,83,74,158958,74,43,14,29,20,-3
22180,86,74,158958,64,38,21,17,13,-10
22181,77,62,142291,1,0,0,0,0,0
22182,86,62,142291,38,8,3,5,10,3
22183,80,79,199922,40,33,16,17,10,7
22184,83,79,199922,82,48,22,26,42,-9
22056,47,84,8572,32,3,1,2,81,3
22057,50,63,8572,7,1,1,0,15,-1
22189,74,74,98715,18,7,1,6,4,4
22190,77,87,98715,81,44,20,24,49,12
22191,80,87,98715,58,15,5,10,14,-7
22192,83,87,98715,33,15,9,6,10,-5
22193,83,65,98715,23,8,2,6,6,0
22194,86,82,98715,53,19,11,8,12,-3
22195,86,80,98715,21,14,8,6,2,1
22196,74,71,117804,1,0,0,0,0,-1
22198,5,86,333317,8,1,1,0,14,-3
22199,74,75,70477,12,3,2,1,0,0
22200,77,75,70477,44,17,7,10,6,1
22201,80,75,70477,27,8,2,6,4,1
22202,80,64,70477,19,16,5,11,8,0
22203,83,64,70477,50,22,8,14,10,-15
22204,86,64,70477,64,17,7,10,14,10
22205,77,71,117801,11,1,0,1,2,-5
22207,83,71,117801,50,12,6,6,8,-4
22208,77,82,92850,12,8,4,4,0,6
22209,80,82,92850,26,13,6,7,6,4
22210,83,82,92850,82,40,11,29,9,4
22211,86,82,92850,77,36,23,13,8,8
22212,80,63,153255,11,2,0,2,0,0
22213,83,63,153255,6,2,1,1,2,2
22214,86,63,153255,20,6,4,2,6,3
22215,77,72,131941,1,0,0,0,0,0
22216,80,72,131941,60,17,8,9,86,-21
22217,83,72,131941,76,32,19,13,84,-6
22218,86,72,131941,63,24,10,14,91,-10
22219,77,80,149671,24,5,2,3,6,-3
22220,80,80,149671,1,0,0,0,0,-2
22221,83,80,149671,11,1,1,0,0,-4
22222,86,80,149671,20,2,1,1,4,-10
22224,83,88,94363,2,0,0,0,0,-1
22225,74,547,102016,1,1,0,1,0,2
22226,77,547,102016,77,13,7,6,6,8
22227,80,547,102016,64,17,9,8,18,8
22228,83,547,102016,82,28,9,19,14,17
22229,86,547,102016,69,25,11,14,6,20
22230,77,80,144126,5,1,0,1,2,1
22231,80,80,144126,6,0,0,0,0,-1
22232,83,80,144126,41,1,0,1,21,-21
22233,86,80,144126,51,5,1,4,56,-13
22234,86,64,103821,26,5,3,2,2,4
22235,74,89,38722,53,22,9,13,10,12
22236,77,89,38722,79,38,17,21,12,4
22237,80,89,38722,64,35,12,23,14,13
22238,83,89,38722,56,25,12,13,27,3
22239,86,89,38722,76,25,12,13,14,2
22241,77,62,52442,7,3,2,1,2,-4
22242,80,62,52442,7,1,0,1,2,-3
22243,77,75,135763,20,2,1,1,37,-10
22244,80,75,135763,31,5,1,4,41,-4
22245,83,75,135763,18,1,0,1,32,-1
22246,77,1479,101632,19,8,3,5,2,7
22247,80,1479,101632,34,9,2,7,28,-6
22248,83,20120,101632,61,29,6,23,14,5
22249,86,20120,101632,79,37,12,25,20,-4
22250,74,82,95010,35,21,8,13,14,12
22251,77,65,95010,13,2,1,1,2,0
22252,77,547,95010,21,8,4,4,8,-7
22253,80,547,95010,38,11,4,7,10,0
22254,83,547,95010,23,3,2,1,6,-2
22255,86,64,95010,8,0,0,0,7,-1
22256,83,62,62263,1,0,0,0,0,0
22258,80,70,117071,10,2,2,0,0,-3
22259,83,70,117071,27,2,0,2,17,-2
22260,86,70,117071,67,22,6,16,23,9
22261,74,65,90390,5,0,0,0,2,-1
22262,77,65,90390,3,1,0,1,0,-1
22263,80,65,90390,76,31,19,12,70,13
22264,83,65,90390,57,25,8,17,58,5
22265,83,73,90390,21,6,3,3,14,-4
22266,86,73,90390,64,20,10,10,44,7
22267,86,77,90390,19,6,2,4,30,-6
22268,80,68,90354,3,1,0,1,0,0
22269,83,68,90354,38,4,3,1,25,-10
22270,86,68,90354,19,2,1,1,8,-2
22271,77,64,117787,31,3,1,2,16,-2
22272,83,64,117787,15,1,0,1,2,-2
22273,80,81,90411,26,3,3,0,11,-9
22275,86,81,90411,65,20,7,13,40,10
22276,74,75,28446,33,6,4,2,12,-5
22277,77,75,28446,22,1,0,1,6,-6
22278,80,75,28446,9,0,0,0,4,-3
22279,83,75,28446,55,12,4,8,29,-2
22280,86,85,28446,60,9,3,6,16,-13
22281,80,64,114856,21,5,3,2,4,0
22282,83,64,114856,69,23,13,10,20,-29
22283,86,64,114856,66,32,16,16,31,-8
22284,80,66,155455,2,1,1,0,0,1
22285,83,66,155455,10,7,3,4,2,4
22286,86,66,155455,13,3,0,3,0,-1
22287,86,71,155455,5,0,0,0,2,-1
22288,86,20120,155455,10,2,2,0,0,-3
22289,77,87,126451,8,1,1,0,4,0
22290,80,87,126451,24,3,2,1,12,-2
22292,86,87,126451,1,0,0,0,0,-1
22293,80,70,127901,18,7,1,6,8,5
22294,83,70,127901,72,14,6,8,18,5
22295,86,67,127901,16,1,0,1,2,-3
22296,80,77,27407,1,0,0,0,0,0
22297,83,77,27407,70,9,3,6,32,5
22298,86,77,27407,82,20,5,15,63,-3
22299,77,72,96850,1,0,0,0,2,2
22300,80,72,96850,38,7,2,5,14,-6
22301,83,72,96850,36,10,2,8,21,0
22302,86,72,96850,39,4,1,3,16,-6
22303,77,547,82359,26,6,2,4,10,2
22304,80,547,82359,54,13,1,12,12,-13
22305,83,547,82359,15,2,2,0,6,0
22186,77,70,16631,73,29,15,14,16,12
22187,83,70,16631,81,34,19,15,24,-13
22310,80,69,39028,13,3,0,3,2,-1
22311,83,69,39028,41,8,0,8,14,0
22312,83,70,62284,6,1,0,1,26,3
22313,86,70,62284,5,1,0,1,0,4
22314,83,65,279269,11,3,0,3,0,-2
22315,86,65,279269,38,6,0,6,6,9
22316,77,67,117017,8,0,0,0,2,-2
22317,80,67,117017,32,4,2,2,4,0
22318,83,67,117017,12,4,3,1,2,-2
22319,86,77,117017,11,1,0,1,2,0
22320,83,89,97835,51,12,0,12,24,-3
22321,86,89,97835,33,6,1,5,38,3
22322,86,85,97835,17,4,1,3,8,-4
22323,80,75,43593,73,28,18,10,8,-1
22324,83,75,43593,66,21,12,9,20,-11
22325,86,75,43593,82,31,11,20,32,10
22327,83,20120,88714,37,3,1,2,19,-3
22328,86,20120,88714,54,9,8,1,29,-4
22329,80,85,125079,7,0,0,0,0,-1
22330,83,85,125079,48,24,7,17,39,-7
22331,86,85,125079,73,47,21,26,36,11
22332,2,84,40918,20,0,0,0,81,-11
22333,5,84,40918,24,0,0,0,56,-1
22335,80,89,242129,26,3,2,1,6,0
22336,80,78,242129,13,5,2,3,4,2
22337,86,78,242129,60,20,8,12,21,8
22338,74,62,129029,6,1,0,1,0,1
22339,77,62,129029,2,0,0,0,2,-1
22340,65,71,4277,60,9,4,5,45,-10
22341,68,71,4277,35,9,3,6,4,-4
22342,77,66,121918,69,16,4,12,16,-7
22343,80,66,121918,82,20,2,18,20,23
22345,86,66,121918,73,29,7,22,24,35
22346,80,67,106210,14,4,3,1,6,1
22347,83,67,106210,33,6,4,2,14,-4
22348,71,64,83018,82,63,24,39,26,20
22349,74,64,83018,64,38,14,24,34,-7
22350,77,64,83018,72,52,21,31,20,-4
22351,80,64,83018,82,53,16,37,16,-14
22352,83,64,83018,74,97,39,58,55,11
22353,86,64,83018,82,99,41,58,34,20
22354,71,68,50059,54,24,8,16,10,-3
22355,74,68,50059,71,36,16,20,16,-4
22356,77,68,50059,66,59,28,31,8,18
22357,80,68,50059,61,52,21,31,10,13
22358,83,68,50059,79,78,27,51,14,9
22359,86,68,50059,82,96,35,61,8,-3
22360,74,81,118709,70,32,4,28,34,3
22362,80,81,118709,73,53,21,32,16,-13
22363,83,75,118709,77,46,13,33,30,-28
22364,86,75,118709,81,53,18,35,26,-8
22365,71,73,90409,77,25,6,19,24,-23
22366,74,73,90409,82,27,8,19,20,3
22367,77,73,90409,40,11,1,10,10,-5
22368,77,82,90409,41,20,2,18,12,-9
22369,80,82,90409,75,42,12,30,24,6
22370,83,82,90409,78,57,16,41,30,10
22371,86,82,90409,75,46,9,37,28,1
22372,71,66,33399,58,21,9,12,4,-14
22373,74,66,33399,81,39,17,22,14,-23
22374,77,66,33399,82,39,11,28,24,-23
22375,80,66,33399,72,45,11,34,16,-2
22376,83,66,33399,81,44,16,28,18,-8
22377,86,62,33399,81,78,27,51,20,30
22379,74,62,85065,81,62,31,31,12,8
22380,77,62,85065,81,63,27,36,18,-6
22381,80,62,85065,82,58,27,31,20,-1
22382,83,62,85065,74,64,31,33,24,3
22383,86,62,85065,78,82,34,48,12,7
22384,74,71,97406,2,0,0,0,0,-2
22385,77,71,97406,69,10,3,7,60,-13
22386,80,71,97406,44,11,5,6,33,0
22387,83,71,97406,82,26,6,20,67,15
22388,86,71,97406,82,41,10,31,87,-5
22389,71,67,43533,34,4,2,2,6,-15
22390,74,67,43533,78,20,8,12,26,-32
22391,77,67,43533,82,41,9,32,33,-21
22392,80,67,43533,79,45,6,39,58,-9
22393,83,67,43533,73,41,6,35,48,-25
22394,86,67,43533,78,43,5,38,38,-41
22396,77,84,117063,82,40,16,24,18,-30
22397,80,84,117063,81,52,20,32,27,-7
22398,83,84,117063,64,44,22,22,10,-1
22399,86,84,117063,82,61,27,34,33,-4
22400,71,70,108714,79,34,14,20,8,20
22401,74,70,108714,8,1,0,1,2,-5
22402,77,70,108714,79,29,9,20,12,2
22403,86,70,108714,57,10,0,10,0,-4
22404,80,77,126446,1,0,0,0,0,0
22405,83,77,126446,2,0,0,0,4,1
22406,86,77,126446,5,0,0,0,4,-3
22407,77,87,95535,81,52,18,34,72,3
22408,80,87,95535,59,38,9,29,40,-9
22409,83,87,95535,82,45,9,36,73,-7
22410,86,75,95535,82,72,28,44,80,20
22411,2,88,22376,73,53,23,30,148,27
22413,8,88,22376,48,15,6,9,49,1
22414,11,88,22376,33,7,4,3,28,-1
22415,74,62,31305,1,0,0,0,0,-1
22416,77,82,31305,1,0,0,0,0,-2
22417,77,76,86817,15,4,2,2,5,1
22418,80,76,86817,1,0,0,0,0,1
22419,83,76,86817,68,32,10,22,14,-4
22420,86,76,86817,82,37,9,28,22,21
22421,71,67,108698,7,1,1,0,4,-4
22422,74,67,108698,60,15,3,12,51,-10
22423,77,64,108698,22,2,0,2,12,-5
22424,80,64,108698,56,10,0,10,73,-20
22425,83,64,108698,77,20,7,13,103,4
22426,86,64,108698,70,14,7,7,75,19
22307,86,83,82359,5,1,1,0,0,-3
22308,80,1479,33490,5,1,0,1,2,-1
22431,83,62,81170,65,12,2,10,23,-8
22432,86,62,81170,1,0,0,0,0,-1
22433,74,86,95095,39,4,1,3,10,-8
22434,77,86,95095,11,0,0,0,7,-4
22435,80,86,95095,4,2,1,1,0,2
22436,83,72,95095,28,4,0,4,4,1
22437,86,72,95095,53,11,1,10,17,-3
22438,74,82,82962,5,3,0,3,2,3
22439,77,82,82962,32,9,2,7,15,5
22440,83,75,82962,4,2,1,1,2,-2
22441,86,62,82962,2,0,0,0,0,-1
22442,77,85,104121,10,3,2,1,2,-6
22443,80,85,104121,60,36,17,19,53,10
22444,83,85,104121,80,48,24,24,52,-1
22445,86,85,104121,67,48,25,23,30,-8
22446,77,83,128556,7,1,0,1,0,-5
22448,83,83,128556,9,1,1,0,0,-4
22449,86,83,128556,70,14,3,11,12,3
22450,74,82,37056,68,20,4,16,22,-19
22451,77,82,37056,69,40,8,32,2,-1
22452,80,82,37056,80,59,13,46,21,9
22453,83,82,37056,66,35,8,27,12,22
22454,86,82,37056,75,25,2,23,12,-1
22455,80,79,128515,1,0,0,0,2,0
22456,83,79,128515,5,1,1,0,2,1
22457,86,72,128515,20,5,3,2,6,-1
22458,86,79,128515,3,1,1,0,2,1
22459,20,64,24167,21,0,0,0,4,7
22460,23,64,24167,62,16,4,12,20,4
22461,26,64,24167,31,6,4,2,14,0
22462,29,64,24167,61,9,3,6,24,0
22463,32,64,24167,64,12,5,7,26,-3
22465,38,64,24167,72,14,4,10,16,-2
22466,41,68,24167,21,3,0,3,16,-2
22467,77,76,106205,1,0,0,0,4,0
22468,83,76,106205,24,6,3,3,62,0
22469,86,76,106205,17,4,1,3,23,3
22470,83,63,84472,3,0,0,0,2,0
22471,86,63,84472,20,5,1,4,8,-1
22472,86,71,84472,33,3,2,1,8,-4
22473,83,87,56370,9,0,0,0,0,-2
22474,86,87,56370,1,0,0,0,0,1
22475,77,66,108709,2,1,0,1,0,1
22476,80,66,108709,2,1,0,1,0,0
22477,83,89,101480,7,1,1,0,4,1
22478,83,71,101480,2,0,0,0,2,-1
22479,86,89,101480,3,1,0,1,2,1
22480,83,68,45520,1,0,0,0,0,0
22482,77,84,22454,8,0,0,0,6,-1
22483,74,62,76139,60,24,12,12,16,1
22484,77,62,76139,59,13,4,9,39,-1
22485,80,74,76139,12,2,1,1,6,1
22486,80,87,76139,42,10,3,7,10,-3
22487,83,66,76139,31,6,3,3,16,-7
22488,83,79,76139,9,0,0,0,0,0
22489,77,547,66635,72,38,15,23,21,3
22490,80,547,66635,82,64,25,39,38,1
22491,83,547,66635,82,60,29,31,26,14
22492,86,547,66635,62,37,21,16,15,2
22493,80,86,482660,19,4,1,3,4,-1
22494,83,86,482660,32,7,5,2,5,-5
22495,86,86,482660,80,30,17,13,23,10
22496,86,70,233554,4,1,0,1,0,-1
22497,35,82,8710,4,0,0,0,2,-2
22499,41,82,8710,34,7,0,7,39,-15
22500,47,82,8710,78,28,6,22,133,1
22501,50,82,8710,23,10,4,6,18,-13
22502,53,82,8710,23,4,1,3,30,-10
22503,83,87,110905,8,3,1,2,0,5
22504,80,70,65509,16,5,1,4,4,-4
22505,83,70,65509,42,4,1,3,14,-1
22506,86,70,65509,29,4,0,4,10,-2
22507,77,83,159080,10,0,0,0,0,0
22508,83,75,159080,2,0,0,0,2,0
22517,59,72,3656,27,27,10,17,8,9
22518,62,72,3656,81,60,31,29,28,-26
22519,65,72,3656,77,83,37,46,33,-9
22520,68,72,3656,37,31,11,20,18,-6
22521,86,88,3656,64,34,16,18,10,-26
22522,38,80,3657,33,21,7,14,8,-3
22524,47,80,3657,68,90,19,71,33,23
22525,50,80,3657,67,87,34,53,45,19
22526,53,80,3657,76,92,34,58,66,26
22527,56,80,3657,82,73,32,41,79,-14
22528,59,80,3657,60,57,23,34,20,0
22529,62,80,3657,62,57,21,36,28,-7
22530,65,80,3657,80,84,34,50,36,11
22531,68,80,3657,5,5,2,3,2,3
22532,71,80,3657,75,66,23,43,46,-26
22533,74,70,3657,82,62,17,45,28,-7
22534,77,70,3657,75,63,33,30,22,4
22535,80,70,3657,68,50,15,35,29,-18
22536,83,70,3657,78,26,8,18,12,-12
22537,86,70,3657,76,27,8,19,29,-13
22538,38,81,3660,63,8,4,4,58,-4
22539,41,81,3660,11,3,0,3,4,0
22541,50,82,3660,76,18,7,11,145,-10
22542,35,68,8811,7,2,1,1,0,0
22543,38,68,8811,77,21,6,15,17,-13
22544,41,68,8811,50,29,12,17,10,-10
22545,47,68,8811,41,21,9,12,22,-2
22546,50,68,8811,74,48,20,28,28,-1
22547,53,68,8811,74,42,13,29,40,14
22548,56,68,8811,78,61,14,47,22,19
22549,59,68,8811,80,60,28,32,40,-7
22550,62,68,8811,76,49,21,28,49,-9
22551,65,68,8811,80,57,20,37,60,5
22552,68,68,8811,17,4,1,3,25,-13
22553,71,85,8811,26,4,2,2,12,-4
22554,74,85,8811,52,25,9,16,16,-2
22428,77,80,81170,76,20,6,14,18,-1
22429,80,80,81170,33,1,0,1,4,-10
22559,77,82,189468,3,1,0,1,0,1
22560,80,82,189468,4,0,0,0,0,-3
22561,83,82,189468,55,22,14,8,10,-8
22562,86,82,189468,8,1,1,0,0,0
22563,38,75,9017,21,1,0,1,28,-6
22564,41,75,9017,46,4,0,4,34,4
22565,47,75,9017,71,6,2,4,116,-1
22566,50,75,9017,82,19,4,15,96,7
22567,53,75,9017,75,17,4,13,101,9
22568,56,75,9017,66,11,2,9,121,0
22569,59,83,9017,34,4,0,4,40,-9
22570,62,83,9017,75,10,1,9,86,-8
22571,65,83,9017,45,5,1,4,41,-13
22572,68,83,9017,4,0,0,0,2,2
22573,71,66,9017,32,4,0,4,14,-4
22574,41,65,2691,82,44,23,21,58,-31
22576,50,65,2691,71,38,17,21,95,4
22577,53,65,2691,60,21,6,15,75,3
22578,53,66,2691,17,11,4,7,16,1
22579,56,66,2691,79,54,26,28,79,0
22580,59,66,2691,54,35,14,21,50,-4
22581,62,66,2691,82,57,19,38,54,1
22582,65,66,2691,72,34,18,16,50,-3
22583,68,66,2691,17,9,4,5,8,-6
22584,71,66,2691,57,16,5,11,34,-19
22585,71,72,2691,19,8,3,5,10,1
22586,74,72,2691,77,13,7,6,28,-3
22587,77,72,2691,33,1,0,1,8,-7
22592,53,74,569,18,2,2,0,8,0
22593,56,74,569,79,13,7,6,30,-11
22594,59,62,569,46,6,1,5,8,2
22595,59,83,569,19,5,2,3,4,-4
22597,41,73,9036,80,26,7,19,57,-12
22598,47,73,9036,82,38,7,31,70,11
22599,50,73,9036,81,20,6,14,66,8
22600,53,73,9036,80,27,4,23,66,-4
22601,56,73,9036,82,26,3,23,67,-4
22602,59,73,9036,78,24,5,19,49,4
22603,62,84,9036,64,23,6,17,34,29
22604,65,84,9036,82,37,4,33,46,29
22605,68,84,9036,47,24,4,20,12,9
22606,71,84,9036,79,22,5,17,26,13
22607,74,84,9036,59,23,1,22,44,0
22608,77,84,9036,58,13,3,10,28,-2
22609,80,70,9036,79,16,1,15,23,-7
22610,83,70,9036,80,24,3,21,33,-6
22611,86,73,9036,57,5,0,5,28,-2
22612,38,71,8595,59,30,6,24,14,5
22614,47,71,8595,81,77,19,58,64,-5
22615,50,71,8595,64,53,13,40,40,-7
22616,53,71,8595,74,71,20,51,34,-9
22617,56,71,8595,72,66,23,43,32,1
22618,59,71,8595,22,22,7,15,8,7
22619,62,71,8595,47,42,14,28,18,3
22620,65,71,8595,69,36,10,26,43,-13
22621,68,71,8595,38,20,9,11,16,-6
22622,71,71,8595,55,26,9,17,20,-13
22623,71,80,8595,20,17,4,13,4,-2
22624,74,70,8595,76,32,11,21,16,-8
22625,77,70,8595,75,39,13,26,20,3
22626,80,70,8595,15,7,4,3,0,-1
22627,83,75,8595,7,0,0,0,10,-1
22628,38,62,9013,23,6,4,2,8,-3
22629,41,62,9013,70,17,6,11,51,-12
22631,50,62,9013,40,17,4,13,37,7
22632,50,63,9013,10,2,1,1,25,-6
22633,53,63,9013,73,39,22,17,29,6
22634,56,63,9013,68,42,21,21,56,5
22635,59,63,9013,7,1,0,1,2,-2
22636,59,69,9013,42,14,9,5,16,-9
22637,62,69,9013,63,16,9,7,19,-6
22638,65,64,9013,58,14,7,7,51,-10
22639,68,64,9013,37,9,5,4,21,6
22640,71,79,9013,33,2,2,0,15,1
22641,47,69,2692,64,21,6,15,40,-9
22642,50,69,2692,82,54,20,34,58,6
22643,53,69,2692,57,42,11,31,42,13
22644,56,69,2692,79,67,20,47,66,2
22645,59,69,2692,80,71,22,49,50,-2
22646,62,69,2692,71,62,17,45,50,4
22648,68,69,2692,48,37,11,26,26,2
22649,71,69,2692,65,54,11,43,24,0
22650,74,69,2692,80,48,14,34,38,2
22651,77,69,2692,82,56,17,39,40,6
22652,80,69,2692,80,58,18,40,34,27
22653,83,69,2692,82,45,14,31,46,9
22654,86,69,2692,48,29,8,21,22,-2
22655,47,77,8816,73,38,20,18,18,9
22656,50,77,8816,81,28,16,12,41,-32
22657,53,77,8816,74,50,13,37,19,0
22658,56,82,8816,82,46,26,20,53,-10
22659,59,82,8816,82,55,23,32,40,-16
22660,62,82,8816,82,57,25,32,38,3
22661,65,82,8816,77,40,20,20,27,-10
22662,68,82,8816,48,18,8,10,16,3
22663,71,82,8816,74,34,18,16,26,-3
22665,77,77,8816,39,11,2,9,15,1
22666,38,83,9115,2,1,0,1,0,0
22667,41,83,9115,2,1,0,1,2,1
22668,47,83,9115,21,7,2,5,17,0
22669,50,83,9115,48,17,8,9,22,5
22670,53,83,9115,28,6,2,4,10,-4
22671,56,83,9115,10,1,0,1,6,-2
22672,56,78,9115,63,29,3,26,29,2
22673,59,78,9115,67,32,7,25,60,8
22674,62,78,9115,65,26,6,20,23,-4
22675,65,78,9115,64,19,2,17,22,7
22676,68,85,9115,6,1,0,1,2,-4
22677,71,78,9115,25,4,1,3,18,-4
22678,74,77,9115,33,8,2,6,10,0
22556,41,1479,8516,56,18,2,16,26,-16
22557,50,1479,8516,1,0,0,0,0,0
22683,11,84,40900,68,37,13,24,20,-1
22684,14,84,40900,31,15,5,10,12,1
22685,14,70,40900,12,6,3,3,4,-4
22686,17,70,40900,66,43,22,21,33,-21
22687,20,70,40900,50,36,21,15,2,27
22688,23,70,40900,49,32,14,18,20,11
22691,32,68,40900,60,23,11,12,10,-3
22692,38,63,8958,11,0,0,0,8,0
22693,41,63,8958,30,8,1,7,10,10
22694,41,89,8958,3,0,0,0,0,0
22695,47,89,8958,80,14,1,13,91,7
22696,50,89,8958,78,13,3,10,106,3
22697,53,89,8958,76,10,1,9,63,4
22698,56,89,8958,72,13,3,10,77,4
22699,59,89,8958,68,12,1,11,68,8
22700,62,67,8958,62,5,1,4,32,-2
22702,5,77,31941,50,17,7,10,98,-4
22703,8,77,31941,83,23,8,15,51,-10
22704,11,89,31941,6,0,0,0,21,-4
22705,11,76,31941,71,9,2,7,50,-1
22706,47,79,9061,47,40,16,24,58,15
22707,50,79,9061,80,34,12,22,67,2
22708,53,79,9061,54,24,9,15,50,6
22712,62,83,9061,50,23,8,15,38,-1
22713,65,83,9061,29,3,1,2,9,-8
22714,68,75,9061,37,5,2,3,12,1
22715,47,86,8586,81,22,8,14,22,-7
22716,50,86,8586,78,13,5,8,24,-2
22717,53,86,8586,51,8,5,3,12,-15
22718,56,86,8586,55,11,2,9,18,-6
22719,59,73,8586,73,30,12,18,14,10
22720,62,73,8586,51,24,9,15,6,10
22722,68,68,8586,42,19,9,10,8,-6
22723,71,68,8586,62,23,11,12,31,-7
22724,71,79,8586,12,2,0,2,4,0
22725,74,79,8586,43,6,2,4,4,-2
22726,74,78,8586,31,3,1,2,4,-1
22727,47,67,8670,14,3,2,1,0,-5
22728,50,67,8670,50,13,6,7,26,-2
22729,50,89,8670,18,6,0,6,2,-2
22730,53,82,8670,65,22,8,14,24,-10
22731,56,82,8670,42,7,4,3,14,4
22732,35,68,8546,5,0,0,0,0,0
22733,41,68,8546,18,7,1,6,12,-2
22734,47,68,8546,67,16,2,14,50,1
22735,50,84,8546,78,16,3,13,64,-4
22736,53,84,8546,39,11,2,9,36,-3
22737,56,81,8546,71,19,2,17,48,-8
22739,59,77,8546,27,2,1,1,14,-10
22740,47,75,8665,67,19,9,10,38,5
22741,50,75,8665,61,15,6,9,48,11
22742,41,88,9158,47,7,0,7,21,1
22743,47,88,9158,78,21,2,19,77,0
22744,50,66,9158,57,6,2,4,57,-10
22745,53,66,9158,80,19,3,16,84,5
22746,56,66,9158,70,12,0,12,68,3
22747,59,66,9158,61,19,5,14,78,0
22748,62,66,9158,82,16,2,14,85,-11
22749,65,66,9158,82,18,1,17,71,12
22750,68,66,9158,42,9,0,9,40,-3
22751,71,66,9158,17,1,0,1,10,-7
22752,71,83,9158,39,5,1,4,55,-14
22753,74,66,9158,55,7,1,6,44,-18
22754,74,89,9158,17,2,0,2,11,5
22756,50,78,9506,34,7,1,6,12,4
22757,53,78,9506,27,8,2,6,12,2
22758,56,78,9506,65,18,3,15,57,8
22759,59,70,9506,36,3,0,3,11,-6
22760,62,70,9506,63,11,2,9,24,5
22761,65,74,9506,27,6,1,5,8,2
22762,71,73,15163,6,2,1,1,2,0
22763,47,89,9382,7,0,0,0,0,1
22764,50,89,9382,5,0,0,0,2,-2
22765,53,89,9382,67,12,5,7,34,1
22766,56,89,9382,76,19,8,11,34,2
22767,59,89,9382,79,16,5,11,19,4
22768,62,89,9382,57,11,5,6,24,-3
22769,62,72,9382,18,1,1,0,2,-3
22770,65,83,9382,76,13,8,5,10,-14
22771,68,83,9382,13,1,0,1,0,-2
22773,71,1479,9382,6,0,0,0,0,0
22776,53,76,11469,9,1,0,1,7,-2
22777,41,67,8805,49,19,9,10,12,-8
22778,47,67,8805,70,46,18,28,57,1
22779,50,67,8805,75,63,21,42,60,37
22780,53,67,8805,78,81,32,49,46,13
22781,56,67,8805,82,70,28,42,38,-5
22782,59,67,8805,80,69,26,43,48,9
22783,62,67,8805,35,35,10,25,16,-1
22784,65,67,8805,80,44,17,27,54,-7
22785,68,70,8805,30,22,4,18,4,3
22786,68,84,8805,12,6,3,3,2,1
22787,71,78,8805,75,37,9,28,30,-1
22788,74,73,8805,26,10,1,9,2,0
22789,74,71,8805,46,22,11,11,22,-13
22790,41,73,9387,2,0,0,0,0,-1
22792,86,71,45256,21,5,2,3,2,2
22793,50,75,11010,5,1,0,1,0,-2
22794,41,82,10320,19,3,1,2,16,-7
22796,50,88,10320,5,0,0,0,10,-1
22797,53,76,10320,36,4,1,3,57,-3
22798,56,76,10320,69,12,5,7,155,-17
22799,59,76,10320,54,9,4,5,98,-4
22800,62,62,10320,82,23,10,13,86,4
22801,65,62,10320,75,7,1,6,94,-21
22802,68,62,10320,42,5,1,4,76,-9
22803,71,62,10320,10,1,1,0,41,-1
22804,71,1479,10320,26,4,3,1,62,-2
22805,74,1479,10320,55,7,5,2,86,-4
22806,77,1479,10320,2,0,0,0,4,-2
22680,2,84,40900,55,45,21,24,10,-5
22681,5,84,40900,76,57,30,27,26,8
22811,47,74,8686,77,25,6,19,58,1
22812,50,74,8686,66,14,2,12,44,-8
22813,53,74,8686,82,20,5,15,43,5
22814,56,82,8686,82,34,9,25,81,1
22815,59,82,8686,80,32,6,26,49,-7
22816,62,82,8686,80,27,7,20,32,-12
22817,65,82,8686,66,26,5,21,49,-21
22818,68,82,8686,48,22,4,18,28,9
22819,71,82,8686,69,26,4,22,44,6
22820,74,82,8686,67,15,3,12,40,8
22821,77,82,8686,61,3,1,2,28,-6
22822,80,64,8686,69,13,1,12,38,-25
22823,77,84,31580,1,0,0,0,0,-2
22824,2,79,40985,6,1,0,1,25,-2
22825,2,71,40985,3,1,0,1,0,-1
22826,2,72,729552,47,14,2,12,44,1
22828,8,72,729552,36,6,1,5,14,0
22829,11,72,729552,62,19,2,17,36,20
22830,14,72,729552,48,15,5,10,20,9
22831,17,72,729552,53,13,1,12,14,0
22832,17,62,729552,20,1,0,1,4,1
22833,20,62,729552,72,15,4,11,14,-8
22834,23,62,729552,69,19,2,17,32,9
22835,26,62,729552,60,6,1,5,8,-11
22836,29,62,729552,41,10,4,6,12,-3
22837,32,62,729552,77,20,1,19,22,2
22838,35,72,729552,42,4,1,3,4,0
22839,38,72,729552,37,7,1,6,6,10
22840,41,72,729552,45,4,1,3,4,7
22841,47,72,729552,36,6,0,6,2,4
22842,41,71,11732,2,0,0,0,0,0
22843,41,1479,8567,1,0,0,0,0,0
22849,47,72,2711,11,2,1,1,10,-1
22850,50,72,2711,2,0,0,0,0,0
22851,38,88,9099,28,8,5,3,22,-4
22852,41,88,9099,31,15,9,6,20,1
22853,47,88,9099,80,55,26,29,50,-14
22854,50,88,9099,81,80,34,46,48,5
22855,53,88,9099,63,47,19,28,30,-16
22856,56,62,9099,81,82,39,43,44,-2
22857,59,75,9099,65,50,26,24,16,7
22858,62,75,9099,67,47,19,28,33,2
22859,65,75,9099,38,22,9,13,10,-6
22860,65,62,9099,28,19,11,8,16,-4
22861,68,62,9099,44,32,13,19,25,-15
22862,71,62,9099,63,45,26,19,26,-13
22863,74,72,9099,68,42,27,15,28,2
22864,77,72,9099,42,38,14,24,18,15
22866,83,88,9099,15,7,3,4,4,1
22867,83,71,9099,51,22,4,18,14,-4
22868,47,67,8851,2,1,0,1,7,-1
22869,50,79,8851,39,5,3,2,69,1
22874,65,547,8851,72,11,4,7,83,-6
22875,68,547,8851,42,4,2,2,70,-5
22876,71,547,8851,55,11,2,9,65,0
22877,74,547,8851,81,14,7,7,76,-5
22878,77,547,8851,82,12,6,6,81,-1
22879,80,547,8851,64,4,3,1,95,-7
22880,83,78,8851,50,7,1,6,60,-4
22881,86,78,8851,1,0,0,0,0,0
22882,35,88,10862,22,6,4,2,8,-4
22883,38,88,10862,15,9,0,9,4,3
22884,38,68,10862,52,18,5,13,14,-2
22885,41,68,10862,13,2,1,1,4,2
22887,50,79,10328,22,2,1,1,22,1
22888,50,68,10328,2,1,1,0,2,3
22889,53,68,10328,4,0,0,0,7,1
22890,56,68,10328,23,2,1,1,11,-5
22891,56,81,10328,17,0,0,0,14,-4
22893,41,67,8804,1,0,0,0,0,0
22894,47,67,8804,57,30,18,12,22,-4
22895,50,67,8804,82,68,34,34,30,25
22896,53,67,8804,82,80,27,53,20,16
22897,56,67,8804,82,66,20,46,18,-4
22898,59,67,8804,82,62,24,38,22,13
22899,62,67,8804,73,52,22,30,15,1
22900,65,67,8804,82,73,30,43,12,-7
22901,68,67,8804,37,25,10,15,8,1
22902,68,69,8804,10,9,4,5,0,0
22903,71,69,8804,82,60,30,30,16,3
22905,77,69,8804,75,36,11,25,12,10
22906,80,69,8804,78,47,13,34,4,2
22907,83,67,8804,82,34,16,18,8,-17
22908,86,67,8804,73,31,16,15,4,-4
22909,47,78,9515,67,27,6,21,30,-23
22910,50,78,9515,81,36,8,28,55,3
22911,53,78,9515,81,22,9,13,26,-17
22912,56,78,9515,82,26,12,14,29,-10
22913,59,78,9515,82,29,11,18,22,0
22914,62,78,9515,56,16,6,10,18,-13
22915,62,64,9515,24,4,1,3,12,-8
22916,65,64,9515,80,17,10,7,31,-8
22917,68,83,9515,48,17,8,9,11,0
22918,71,83,9515,81,10,4,6,32,-8
22919,74,66,9515,82,21,7,14,17,-7
22920,77,66,9515,77,11,3,8,24,-17
22922,47,67,8901,1,1,0,1,0,-1
22923,50,67,8901,63,24,2,22,50,10
22924,53,67,8901,59,9,2,7,27,3
22925,56,67,8901,23,6,2,4,25,3
22926,59,67,8901,11,2,1,1,6,2
22927,59,82,8901,10,0,0,0,6,-5
22928,41,65,10193,20,5,2,3,10,-5
22929,47,65,10193,2,0,0,0,0,0
22930,50,65,10193,2,0,0,0,4,-2
22931,53,76,10193,3,0,0,0,0,-1
22932,38,66,10218,41,2,0,2,43,-5
22933,41,66,10218,2,0,0,0,2,-1
22934,47,80,10218,2,0,0,0,2,4
22935,50,80,10218,1,0,0,0,0,0
22808,38,83,11484,17,7,3,4,12,-7
22809,41,83,11484,50,19,2,17,22,2
22942,41,68,11710,3,0,0,0,5,0
22943,2,71,21560,74,55,24,31,59,-7
22944,5,83,21560,72,57,24,33,100,-13
22945,8,83,21560,76,65,22,43,117,19
22946,11,83,21560,73,35,17,18,50,-6
22947,11,74,21560,12,6,4,2,12,1
22948,14,78,21560,36,26,12,14,37,9
22949,17,71,21560,17,10,4,6,27,0
22950,17,78,21560,15,4,2,2,6,-11
22951,41,75,8664,2,0,0,0,0,0
22952,47,75,8664,67,29,9,20,32,4
22953,50,75,8664,81,47,20,27,36,10
22954,53,75,8664,81,69,29,40,42,15
22955,56,75,8664,80,39,20,19,54,-9
22956,59,75,8664,82,70,25,45,50,5
22957,62,75,8664,77,57,22,35,60,8
22959,68,75,8664,47,33,14,19,24,3
22960,71,75,8664,81,43,20,23,38,11
22961,74,75,8664,82,60,26,34,46,8
22962,77,75,8664,82,54,14,40,36,4
22963,80,75,8664,78,28,10,18,24,10
22964,83,75,8664,60,24,6,18,39,3
22965,83,83,8664,17,2,0,2,6,-2
22966,86,75,8664,3,1,1,0,0,0
22967,2,72,41148,1,0,0,0,5,0
22968,5,86,41148,48,12,4,8,143,-17
22969,53,66,8357,6,1,0,1,0,-2
22970,80,88,86367,25,6,2,4,6,-3
22971,83,88,86367,81,37,16,21,49,11
22972,86,88,86367,81,28,12,16,50,-10
22973,74,87,96116,2,0,0,0,0,-1
22974,77,87,96116,14,3,1,2,0,-2
22976,41,74,8954,20,1,1,0,24,-5
22977,47,75,8954,36,6,5,1,44,-2
22978,50,75,8954,43,3,2,1,32,-10
22979,53,75,8954,1,0,0,0,0,0
22980,53,68,8954,6,0,0,0,19,0
22982,23,71,5593,1,0,0,0,0,1
22983,26,1479,5593,2,1,0,1,0,0
22984,32,71,5593,20,1,0,1,13,2
22985,35,71,5593,50,5,3,2,75,11
22986,38,71,5593,78,8,3,5,120,11
22987,41,71,5593,52,6,1,5,80,-5
22988,47,69,5593,15,0,0,0,22,-3
22989,47,83,9517,8,1,0,1,2,5
22990,50,83,9517,5,0,0,0,6,-5
22991,56,83,9517,7,1,0,1,10,-2
22992,59,66,9517,38,6,1,5,50,-8
22994,65,66,9517,72,23,9,14,60,-10
22995,68,66,9517,47,10,3,7,51,-10
22996,71,66,9517,68,15,4,11,44,-1
22997,74,66,9517,20,4,1,3,42,-5
22998,74,547,9517,35,5,2,3,23,4
23000,8,89,30600,60,8,2,6,18,-2
23001,11,89,30600,50,9,0,9,12,-1
23002,14,77,30600,1,0,0,0,0,0
23003,41,82,10226,29,8,2,6,32,-2
23004,47,82,10226,26,8,2,6,23,9
23005,50,82,10226,61,10,3,7,38,-9
23006,53,76,10226,30,2,0,2,30,2
23007,56,65,10226,38,8,3,5,33,19
23008,59,62,10226,22,3,1,2,19,0
23009,59,71,10226,19,7,3,4,16,-6
23010,65,82,10226,56,16,3,13,26,-12
23012,50,76,10697,3,1,1,0,5,-2
23013,53,76,10697,5,1,0,1,4,-1
23016,8,81,1974,77,27,16,11,14,-14
23017,11,81,1974,76,25,13,12,23,8
23018,14,81,1974,36,11,4,7,4,-3
23019,17,81,1974,64,19,8,11,2,0
23020,20,81,1974,70,19,5,14,8,1
23021,23,81,1974,72,17,6,11,29,-4
23022,26,81,1974,40,5,2,3,4,-8
23023,26,77,1974,7,1,0,1,0,1
23024,29,77,1974,36,5,2,3,0,-2
23025,29,76,1974,19,3,0,3,4,-1
23026,41,89,11488,4,1,0,1,0,-1
23027,38,69,8836,38,5,3,2,23,-6
23028,41,69,8836,19,10,2,8,20,0
23029,47,69,8836,71,16,7,9,63,-13
23031,53,69,8836,77,18,11,7,61,-13
23032,56,69,8836,81,23,13,10,40,-17
23033,59,81,8836,77,9,3,6,48,-14
23034,65,72,8836,1,0,0,0,0,0
23035,65,69,8836,21,2,0,2,15,-2
23036,71,69,8836,34,3,3,0,21,-2
23037,74,69,8836,12,2,1,1,10,0
23038,47,81,8633,72,17,4,13,90,-4
23039,56,81,8633,73,16,6,10,151,1
23040,59,1479,8633,37,9,4,5,41,0
23042,38,77,8876,3,0,0,0,2,0
23043,41,77,8876,41,7,5,2,55,-3
23044,47,77,8876,22,8,5,3,10,4
23045,47,65,8876,50,23,9,14,36,1
23046,50,65,8876,80,35,20,15,74,-15
23047,53,65,8876,80,62,36,26,55,23
23049,59,65,8876,82,66,25,41,28,24
23050,62,65,8876,74,71,34,37,38,-1
23051,65,65,8876,74,69,33,36,38,28
23052,68,65,8876,28,20,6,14,14,8
23053,71,65,8876,82,78,34,44,40,13
23054,74,65,8876,68,43,16,27,33,-8
23055,77,70,8876,76,55,20,35,27,-3
23056,80,70,8876,48,18,8,10,31,-22
23057,83,65,8876,70,21,10,11,14,-16
23058,50,80,10872,1,0,0,0,7,0
23059,41,73,9516,70,8,4,4,137,-6
23060,47,73,9516,34,10,4,6,55,9
23061,50,73,9516,65,9,3,6,116,-11
23062,53,73,9516,63,18,11,7,100,-8
22937,50,83,9509,31,5,1,4,19,-3
22940,56,80,9509,53,21,6,15,24,-5
23067,68,85,9516,42,8,3,5,78,0
23068,71,85,9516,11,1,0,1,5,-3
23069,74,72,9516,68,15,10,5,72,1
23070,77,72,9516,66,9,4,5,102,-26
23071,80,65,9516,50,3,2,1,28,-6
23072,35,1479,2707,17,3,0,3,2,0
23073,35,69,2091,8,5,2,3,0,0
23074,41,86,8578,41,12,1,11,14,4
23075,47,86,8578,64,23,5,18,32,10
23076,50,86,8578,82,33,10,23,63,8
23077,53,86,8578,77,22,1,21,72,9
23078,56,86,8578,77,42,8,34,63,-12
23079,59,84,8578,80,44,14,30,42,36
23080,62,84,8578,79,50,14,36,52,19
23081,65,67,8578,66,32,5,27,47,-2
23082,68,67,8578,47,22,5,17,34,6
23084,74,79,8578,49,14,3,11,26,8
23085,77,88,8578,40,10,2,8,32,-10
23086,77,65,8578,8,2,0,2,2,-1
23087,50,62,50945,1,0,0,0,0,0
23088,35,75,2696,1,0,0,0,0,2
23089,41,74,9447,8,0,0,0,0,-4
23090,47,74,9447,1,0,0,0,2,-1
23091,50,74,9447,1,0,0,0,0,0
23092,47,88,13419,2,0,0,0,2,-2
23093,56,81,13419,11,3,0,3,21,5
23094,62,71,13419,2,0,0,0,2,1
23095,80,84,248430,9,5,4,1,0,0
23096,83,84,248430,62,55,29,26,16,-5
23097,86,84,248430,69,56,26,30,22,-2
23098,38,79,8675,26,11,4,7,10,0
23099,41,79,8675,47,23,11,12,16,-8
23101,5,86,72194,1,0,0,0,0,0
23102,47,80,8875,56,10,4,6,48,4
23103,50,80,8875,80,25,8,17,56,30
23104,53,80,8875,82,24,8,16,64,7
23105,56,80,8875,50,6,3,3,26,-8
23107,2,67,21422,80,69,36,33,32,11
23108,5,67,21422,80,91,41,50,71,-9
23109,8,67,21422,52,61,29,32,48,-8
23110,8,83,21422,31,38,25,13,8,12
23111,11,83,21422,83,99,53,46,98,22
23112,14,83,21422,48,38,22,16,34,-7
23113,17,83,21422,61,44,20,24,54,-11
23114,17,72,21422,15,13,8,5,10,2
23115,20,72,21422,82,61,27,34,48,38
23116,23,72,21422,75,48,14,34,26,19
23117,26,72,21422,52,28,15,13,20,1
23119,29,64,21422,14,3,1,2,2,-9
23120,32,67,21422,74,33,20,13,32,0
23121,35,81,21422,82,38,21,17,109,-12
23122,38,81,21422,72,34,20,14,34,-12
23123,41,81,21422,82,39,21,18,42,-9
23124,47,81,21422,42,18,6,12,16,-13
23125,41,83,8812,1,0,0,0,0,-1
23126,47,83,8812,81,45,11,34,14,0
23127,50,83,8812,48,42,12,30,0,3
23128,53,83,8812,59,21,8,13,0,-12
23129,56,84,8812,74,27,18,9,4,2
23130,59,84,8812,75,25,14,11,12,6
23131,62,86,8812,35,13,5,8,0,10
23132,65,547,8812,77,47,18,29,4,3
23133,68,547,8812,39,15,6,9,2,0
23136,62,67,11566,3,0,0,0,2,1
23140,50,78,8907,11,0,0,0,0,-4
23145,62,84,8907,7,0,0,0,0,-1
23146,50,86,8581,3,0,0,0,0,0
23147,53,86,8581,22,3,2,1,4,4
23148,56,86,8581,64,13,5,8,22,-4
23149,47,76,12557,1,0,0,0,0,1
23150,41,64,8970,44,5,2,3,73,-4
23151,47,64,8970,45,8,4,4,29,1
23152,50,64,8970,6,1,0,1,6,1
23153,53,64,8970,40,4,2,2,50,5
23154,56,64,8970,55,12,1,11,92,-5
23155,62,67,8970,81,20,8,12,142,2
23156,65,67,8970,50,4,1,3,56,-7
23157,68,67,8970,8,0,0,0,10,-2
23158,71,67,8970,29,5,1,4,45,-8
23159,71,69,8970,14,2,1,1,7,2
23161,2,84,27418,2,0,0,0,0,-2
23162,5,84,27418,4,0,0,0,29,-1
23163,8,84,27418,2,0,0,0,0,0
23164,11,84,27418,55,3,1,2,190,-11
23165,14,84,27418,7,0,0,0,46,-4
23166,14,77,27418,25,0,0,0,61,0
23167,17,77,27418,64,4,1,3,204,-4
23168,20,79,27418,13,0,0,0,49,0
23169,20,1479,27418,2,0,0,0,2,1
23170,23,1479,27418,9,1,1,0,18,1
23171,50,77,3189,14,4,0,4,6,-10
23172,47,84,9671,39,6,0,6,77,-1
23173,50,84,9671,81,42,12,30,134,1
23174,53,84,9671,34,12,2,10,90,-11
23175,56,84,9671,72,43,11,32,97,-4
23176,59,84,9671,55,22,3,19,85,-5
23178,65,84,9671,78,44,8,36,94,12
23179,68,84,9671,36,12,6,6,48,6
23180,71,84,9671,76,24,4,20,104,-8
23181,74,84,9671,60,14,4,10,77,0
23182,77,1479,9671,71,15,4,11,99,-7
23183,80,1479,9671,81,14,3,11,63,0
23184,83,1479,9671,59,8,0,8,83,-13
23185,35,72,49145,39,9,4,5,22,-12
23186,38,89,49145,32,5,1,4,14,-1
23187,41,83,667942,7,0,0,0,2,0
23188,47,74,667942,29,3,1,2,22,-2
23189,53,1479,667942,4,0,0,0,0,-2
23190,77,75,33742,10,6,0,6,0,0
23191,80,75,33742,7,0,0,0,4,-3
23064,59,73,9516,51,16,6,10,40,2
23065,62,73,9516,54,18,8,10,61,8
23196,47,77,8584,29,7,2,5,4,-4
23199,50,66,8584,20,6,1,5,2,-12
23200,53,66,8584,47,15,0,15,18,6
23201,56,66,8584,70,30,5,25,37,-9
23202,59,68,8584,62,23,2,21,33,-3
23203,59,63,8584,17,9,2,7,6,9
23204,62,63,8584,81,32,7,25,41,3
23205,65,63,8584,80,23,5,18,39,15
23206,68,63,8584,46,17,4,13,10,18
23207,71,63,8584,34,10,1,9,10,11
23208,74,63,8584,82,14,3,11,34,-1
23209,77,63,8584,61,12,1,11,24,-1
23210,80,76,8584,73,22,5,17,32,25
23211,83,76,8584,28,5,0,5,17,-9
23212,47,86,9112,18,2,0,2,9,-2
23213,50,86,9112,58,34,16,18,78,4
23215,56,86,9112,71,52,22,30,51,8
23216,59,86,9112,82,57,19,38,131,0
23217,62,86,9112,75,62,24,38,100,13
23218,65,86,9112,76,45,17,28,97,-5
23219,68,86,9112,28,11,0,11,79,-4
23220,68,74,9112,12,8,3,5,14,5
23221,71,72,9112,43,26,7,19,33,-10
23222,74,72,9112,13,4,1,3,4,-1
23223,41,73,3630,82,53,14,39,82,-16
23224,47,73,3630,67,49,12,37,82,8
23225,50,73,3630,79,30,4,26,72,8
23226,53,73,3630,79,43,5,38,63,-5
23227,56,69,3630,76,42,12,30,76,-12
23228,59,69,3630,78,43,6,37,67,-16
23229,62,69,3630,46,24,7,17,30,-6
23230,65,69,3630,41,14,0,14,24,-6
23232,68,72,3630,48,19,4,15,38,-12
23233,71,72,3630,81,42,12,30,60,-3
23234,74,72,3630,63,23,4,19,42,-7
23235,74,85,3630,21,11,3,8,14,-2
23236,77,76,3630,53,16,4,12,20,5
23237,71,76,76053,13,2,0,2,14,-5
23238,71,84,60415,2,1,0,1,0,2
23239,77,84,60415,3,1,0,1,2,1
23240,80,84,60415,1,0,0,0,0,-1
23241,47,63,9058,73,7,1,6,68,3
23242,50,63,9058,76,10,0,10,124,-15
23243,53,63,9058,35,2,0,2,39,4
23244,56,77,9058,79,13,1,12,61,6
23245,59,66,9058,62,10,2,8,74,7
23246,59,84,9058,14,2,1,1,13,-1
23247,62,84,9058,42,7,1,6,41,0
23249,68,84,9058,24,1,0,1,32,-7
23250,71,84,9058,10,0,0,0,0,1
23251,8,80,2119,44,15,9,6,32,-16
23252,11,80,2119,33,18,10,8,14,-7
23253,14,80,2119,14,4,2,2,19,-7
23254,17,80,2119,44,10,6,4,18,-14
23255,20,76,2119,7,0,0,0,4,-4
23256,53,86,10630,1,1,0,1,0,1
23257,56,86,10630,17,2,1,1,4,-2
23258,47,70,2712,81,55,17,38,30,2
23259,50,70,2712,82,48,14,34,18,8
23260,53,70,2712,52,28,14,14,14,2
23261,53,81,2712,20,14,2,12,4,-16
23262,56,81,2712,46,16,6,10,16,-8
23263,56,66,2712,25,11,1,10,12,-2
23264,59,66,2712,81,65,30,35,36,3
23266,65,66,2712,79,46,12,34,54,-2
23267,68,66,2712,33,11,6,5,18,-8
23268,68,79,2712,10,11,7,4,6,3
23269,71,79,2712,81,57,21,36,18,12
23270,74,68,2712,81,44,8,36,34,-2
23271,77,68,2712,81,60,18,42,42,25
23272,80,68,2712,69,28,11,17,39,-15
23273,83,71,2712,14,1,0,1,2,-3
23274,83,88,2712,18,5,1,4,4,0
23275,83,82,2712,14,1,0,1,4,-2
23276,83,84,2712,14,10,4,6,2,7
23277,41,80,9508,1,0,0,0,2,0
23278,41,89,9508,4,1,0,1,0,-1
23279,47,89,9508,73,21,7,14,26,-9
23280,50,89,9508,73,18,8,10,29,-2
23281,53,89,9508,82,37,21,16,35,-3
23283,59,89,9508,78,59,25,34,34,16
23284,62,89,9508,82,48,16,32,46,14
23285,65,89,9508,82,41,16,25,34,-8
23286,68,89,9508,9,4,1,3,6,2
23287,71,89,9508,51,15,8,7,16,-7
23288,74,89,9508,66,20,7,13,24,-2
23289,77,89,9508,60,7,1,6,16,-7
23290,77,83,9508,21,7,1,6,2,-6
23291,83,88,9508,12,1,0,1,6,-5
23292,71,81,44483,1,0,0,0,0,0
23293,2,77,74708,1,1,0,1,0,1
23294,83,87,107951,1,0,0,0,2,0
23295,71,65,76141,2,1,1,0,2,-1
23296,47,69,9079,65,6,2,4,158,2
23297,50,69,9079,48,1,0,1,120,0
23298,53,69,9079,34,0,0,0,74,-5
23300,59,69,9079,57,4,0,4,105,-12
23301,62,74,9079,22,2,1,1,45,0
23302,77,79,94534,44,10,7,3,8,-1
23303,80,79,94534,61,53,23,30,22,24
23304,83,79,94534,79,30,18,12,10,2
23305,86,67,94534,78,34,14,20,12,-18
23306,74,65,60281,18,1,0,1,2,0
23307,77,65,60281,82,14,3,11,31,-5
23308,80,65,60281,58,16,5,11,29,17
23309,83,66,60281,79,16,3,13,20,9
23310,86,66,60281,78,14,3,11,10,-4
23311,71,62,39641,6,0,0,0,2,-1
23312,38,84,9916,8,2,0,2,0,0
23313,41,84,9916,47,21,12,9,8,0
23193,86,70,33742,16,0,0,0,2,0
23194,38,77,8584,58,13,4,9,20,8
23318,83,20120,46962,36,14,9,5,9,0
23319,86,20120,46962,68,18,5,13,8,-6
23320,71,69,9794,1,1,0,1,0,3
23321,74,69,9794,40,10,2,8,13,3
23322,77,69,9794,26,4,0,4,11,-1
23323,80,69,9794,51,8,2,6,26,10
23324,83,88,9794,65,13,3,10,30,1
23325,86,77,9794,26,2,0,2,16,5
23326,86,75,9794,19,4,0,4,11,1
23327,74,71,84751,6,1,0,1,0,-4
23328,77,71,84751,17,5,0,5,0,1
23329,80,71,84751,2,0,0,0,0,-1
23330,83,65,84751,55,15,5,10,8,-11
23331,86,87,84751,71,20,6,14,12,-3
23333,5,63,50158,29,8,5,3,20,5
23334,50,72,967,76,11,2,9,61,-5
23336,56,72,967,82,29,7,22,30,21
23337,59,72,967,40,4,2,2,18,2
23340,65,547,967,63,13,2,11,33,-9
23341,65,65,967,18,5,1,4,0,3
23342,68,65,967,48,12,3,9,10,12
23343,71,65,967,77,16,3,13,38,11
23344,74,65,967,76,10,2,8,26,5
23345,77,70,967,82,21,4,17,26,8
23346,80,70,967,37,7,1,6,10,-2
23347,80,65,967,15,2,1,1,8,-2
23348,83,80,967,51,8,4,4,32,2
23349,83,77,967,1,0,0,0,0,-1
23350,47,80,10256,20,13,6,7,14,7
23351,47,65,10256,20,4,2,2,8,-9
23352,50,65,10256,10,2,2,0,2,-2
23353,50,63,10256,31,22,11,11,14,3
23355,53,1479,10256,12,4,2,2,6,2
23356,53,73,10256,8,3,1,2,0,2
23357,56,81,10256,7,1,0,1,2,-3
23358,59,81,10256,28,13,4,9,2,-1
23359,50,62,8955,41,18,10,8,12,5
23360,53,62,8955,41,11,4,7,10,-4
23361,56,62,8955,81,39,20,19,22,-5
23362,59,62,8955,64,17,8,9,20,-9
23363,62,62,8955,58,30,17,13,18,9
23364,65,62,8955,32,9,2,7,12,-3
23367,74,87,8955,60,12,4,8,24,-18
23368,47,77,300423,1,0,0,0,0,0
23369,50,77,300423,12,0,0,0,4,-3
23370,41,1479,166,6,2,1,1,0,-2
23371,41,64,8597,4,2,2,0,0,1
23372,47,64,8597,61,50,32,18,60,0
23374,53,64,8597,62,37,26,11,32,13
23375,56,64,8597,69,34,14,20,34,-6
23376,59,64,8597,54,11,7,4,35,-13
23377,62,73,8597,9,3,1,2,2,1
23378,62,80,8597,19,5,3,2,8,-1
23379,53,69,14115,55,14,7,7,141,-7
23380,56,74,14115,54,16,8,8,122,-9
23381,59,74,14115,41,7,3,4,89,-2
23382,62,1479,14115,12,0,0,0,43,-4
23383,86,85,45684,5,0,0,0,2,0
23384,47,74,9054,52,5,2,3,84,-3
23385,50,74,9054,78,3,1,2,131,-11
23386,53,74,9054,70,4,2,2,96,-12
23387,56,83,9054,25,2,0,2,38,-7
23389,47,63,8672,51,11,6,5,54,3
23390,50,63,8672,40,3,2,1,20,-5
23392,53,89,8672,75,9,1,8,30,4
23393,56,89,8672,79,14,3,11,68,1
23394,59,89,8672,27,4,0,4,14,0
23395,59,82,8672,17,3,1,2,10,2
23396,62,76,8672,46,17,4,13,30,-4
23397,65,76,8672,65,11,3,8,30,-34
23398,53,82,11558,39,10,6,4,12,0
23399,56,82,11558,67,11,8,3,10,-6
23400,59,82,11558,46,7,5,2,6,-6
23401,62,82,11558,29,8,4,4,4,2
23402,65,86,11558,39,4,1,3,4,3
23403,68,78,11558,1,0,0,0,0,0
23404,80,76,38028,4,0,0,0,2,1
23405,47,84,8607,7,1,0,1,12,2
23406,50,78,8607,6,1,1,0,0,0
23407,56,69,8607,4,1,0,1,2,-1
23411,5,63,31302,61,39,17,22,47,-4
23412,8,63,31302,26,4,2,2,11,0
23413,8,62,31302,32,19,8,11,41,11
23414,74,66,75091,7,0,0,0,4,-4
23415,77,66,75091,7,2,1,1,4,4
23416,80,66,75091,14,0,0,0,0,-6
23417,38,78,8604,51,38,9,29,20,16
23418,41,78,8604,70,26,12,14,16,12
23419,47,78,8604,71,41,10,31,54,-22
23420,50,78,8604,77,48,15,33,54,9
23421,38,85,17967,71,12,2,10,43,1
23422,50,65,9520,5,1,0,1,2,-1
23423,59,74,9520,22,8,3,5,4,-2
23424,62,76,9520,81,53,20,33,46,-8
23425,65,76,9520,80,67,18,49,89,-8
23426,68,64,9520,48,43,18,25,38,-11
23428,74,75,9520,56,22,8,14,30,0
23429,77,83,9520,77,41,20,21,68,0
23430,80,72,9520,59,27,13,14,35,-16
23431,80,73,9520,8,1,0,1,0,-2
23432,77,75,26301,23,9,6,3,8,0
23433,80,75,26301,33,9,2,7,6,4
23434,83,75,26301,38,16,6,10,8,2
23435,86,20120,26301,6,1,1,0,0,-1
23436,38,68,8625,82,12,4,8,92,-18
23438,47,89,8625,57,9,1,8,66,-2
23439,77,62,75070,14,3,0,3,31,-1
23440,80,62,75070,26,5,1,4,44,0
23441,83,62,75070,59,13,4,9,88,3
23442,86,62,75070,76,19,11,8,56,14
23315,77,86,46962,1,0,0,0,0,0
23316,80,86,46962,11,4,2,2,4,5
23447,38,71,10855,48,4,1,3,24,11
23448,38,74,10855,3,0,0,0,0,1
23449,50,88,4340,2,0,0,0,0,0
23450,74,62,28755,3,0,0,0,2,0
23451,74,64,30371,11,2,1,1,6,1
23452,77,64,30371,3,0,0,0,0,-2
23453,80,84,30371,1,0,0,0,0,0
23454,80,73,129084,9,1,0,1,0,1
23455,83,73,129084,20,3,0,3,2,0
23456,86,73,129084,55,4,3,1,2,1
23457,35,80,2662,10,1,0,1,0,-1
23458,38,80,2662,12,1,1,0,0,-1
23459,74,86,10013,53,24,13,11,20,-3
23460,77,86,10013,65,19,10,9,16,5
23461,80,86,10013,67,22,11,11,22,7
23462,83,86,10013,71,19,8,11,26,-5
23464,77,69,729541,1,0,0,0,0,-1
23465,56,78,12039,16,3,2,1,0,-4
23466,77,65,9980,44,9,4,5,4,9
23467,80,65,9980,68,8,4,4,12,-4
23468,83,1479,9980,27,4,1,3,8,4
23469,74,77,8337,81,12,6,6,18,-3
23470,77,77,8337,74,14,7,7,27,-8
23471,80,77,8337,82,8,4,4,20,-1
23472,83,20120,8337,72,16,6,10,14,5
23473,86,20120,8337,76,15,6,9,6,2
23474,77,85,102491,6,0,0,0,2,-2
23475,80,85,102491,11,1,1,0,2,-1
23476,83,20120,102491,67,15,7,8,14,6
23477,86,20120,102491,68,17,8,9,18,-10
23478,74,68,49058,81,39,12,27,32,12
23479,77,68,49058,78,36,15,21,41,18
23481,83,68,49058,82,38,16,22,71,9
23482,86,68,49058,82,37,13,24,47,1
23483,74,67,95102,9,1,0,1,2,-1
23484,77,67,95102,79,42,23,19,8,-8
23485,80,67,95102,79,47,17,30,8,-11
23486,83,67,95102,82,50,25,25,26,-24
23487,86,67,95102,82,65,22,43,16,-10
23488,74,62,117786,1,1,0,1,0,-1
23489,77,62,117786,77,36,18,18,37,-11
23490,80,62,117786,81,26,13,13,75,-16
23491,83,62,117786,82,26,11,15,59,-18
23492,86,62,117786,71,27,13,14,93,-6
23493,83,76,152118,4,0,0,0,0,0
23494,86,76,152118,28,7,3,4,2,3
23495,74,71,71963,37,9,2,7,4,-17
23496,77,71,71963,72,51,19,32,20,-2
23498,83,71,71963,78,70,25,45,30,-7
23499,86,71,71963,82,105,50,55,52,2
23500,83,66,119452,67,8,0,8,14,-2
23501,86,66,119452,20,1,0,1,2,4
23502,77,83,38712,22,13,6,7,4,1
23503,80,83,38712,81,61,22,39,32,-3
23504,83,83,38712,82,61,20,41,10,20
23505,86,83,38712,54,27,7,20,16,-4
23506,77,84,120251,55,13,7,6,45,-7
23507,80,84,120251,10,1,0,1,2,1
23508,83,84,120251,75,20,10,10,46,-11
23509,86,84,120251,70,25,15,10,44,-4
23510,77,1479,99090,33,4,2,2,37,-2
23511,80,1479,99090,77,28,14,14,62,4
23512,83,1479,99090,76,27,10,17,72,3
23513,86,1479,99090,60,31,9,22,82,6
23515,77,73,88033,5,1,1,0,0,0
23516,80,73,88033,54,16,11,5,18,1
23517,83,73,88033,80,48,23,25,26,20
23518,86,73,88033,64,32,10,22,26,-11
23519,86,69,88033,19,7,3,4,10,-12
23520,80,87,187047,57,21,14,7,20,-4
23521,83,87,187047,74,30,17,13,28,-2
23522,86,87,187047,22,6,2,4,8,-5
23523,86,65,187047,46,15,12,3,20,-12
23524,53,63,11730,6,0,0,0,0,-2
23525,56,65,11730,7,0,0,0,0,-4
23526,71,84,11730,3,0,0,0,0,0
23527,2,67,52381,8,7,4,3,4,-1
23528,5,67,52381,63,48,31,17,75,-1
23529,8,67,52381,44,19,12,7,51,-8
23530,11,67,52381,77,59,29,30,41,2
23532,17,67,52381,23,25,12,13,18,0
23533,20,67,52381,73,50,28,22,48,-6
23534,23,67,52381,75,44,24,20,59,10
23535,26,88,52381,49,36,18,18,51,7
23536,29,88,52381,49,32,12,20,45,6
23539,32,67,52381,12,8,2,6,12,1
23540,35,70,52381,20,12,4,8,12,2
23541,35,75,52381,13,6,1,5,8,1
23542,38,75,52381,54,23,11,12,19,-7
23543,41,75,52381,23,8,3,5,16,-4
23544,41,68,52381,28,13,6,7,22,-9
23545,80,89,101317,21,6,3,3,2,2
23546,83,89,101317,73,27,13,14,12,2
23547,86,89,101317,82,47,24,23,27,20
23548,56,81,14073,2,0,0,0,0,0
23549,59,88,14073,25,2,1,1,20,0
23551,62,70,14073,46,10,5,5,41,0
23552,65,81,14073,10,0,0,0,4,-2
23553,68,74,14073,1,0,0,0,2,0
23554,83,77,120990,49,10,2,8,20,-6
23555,86,77,120990,82,35,9,26,22,-4
23556,77,85,177746,80,45,23,22,34,11
23557,80,85,177746,80,32,17,15,37,-28
23558,83,85,177746,82,63,16,47,61,-9
23559,86,85,177746,76,73,32,41,75,-6
23560,80,87,89863,39,14,5,9,37,-13
23561,83,74,89863,32,8,0,8,11,-18
23562,86,74,89863,61,30,4,26,77,6
23563,38,73,9148,19,6,4,2,14,2
23564,41,73,9148,17,0,0,0,23,-6
23444,77,64,13537,15,0,0,0,0,-5
23445,50,73,5874,15,3,1,2,8,0
23571,65,70,9148,82,21,8,13,60,-13
23572,68,70,9148,46,17,4,13,48,3
23573,71,70,9148,76,23,6,17,37,3
23574,74,70,9148,80,29,13,16,34,-5
23575,77,70,9148,82,22,12,10,31,5
23576,80,72,9148,39,3,1,2,29,-11
23577,80,73,9148,20,1,1,0,37,-4
23578,41,69,8585,22,2,1,1,4,-7
23584,62,79,8585,73,19,5,14,30,0
23585,65,79,8585,62,13,2,11,24,0
23588,74,87,8585,53,8,2,6,12,-6
23589,74,78,8585,15,4,2,2,6,3
23590,77,87,8585,70,7,2,5,20,3
23591,80,87,8585,3,0,0,0,0,1
23592,77,83,92288,9,0,0,0,2,-3
23593,80,83,92288,8,1,1,0,0,-2
23595,86,83,92288,78,44,20,24,27,12
23596,80,65,157016,61,28,6,22,6,10
23597,83,65,157016,78,52,21,31,18,1
23598,86,65,157016,23,11,2,9,6,-4
23599,86,87,157016,17,14,5,9,2,-8
23600,77,84,189420,69,18,9,9,32,-6
23601,80,68,189420,29,7,1,6,4,-1
23602,83,68,189420,68,28,9,19,30,11
23603,86,68,189420,46,18,8,10,18,-9
23604,86,79,189420,32,17,11,6,13,8
23605,74,63,130435,46,27,10,17,8,12
23606,77,63,130435,51,26,15,11,20,3
23607,80,63,130435,75,70,34,36,34,11
23608,83,63,130435,82,80,35,45,37,10
23609,86,63,130435,66,81,38,43,32,6
23610,38,71,5668,5,2,1,1,9,2
23612,47,71,5668,75,35,15,20,38,3
23613,50,71,5668,55,25,8,17,28,-9
23614,50,76,5668,23,21,6,15,10,5
23615,53,76,5668,46,18,9,9,16,-14
23616,53,1479,5668,9,1,0,1,4,-2
23617,56,69,5668,72,32,14,18,30,5
23618,59,75,5668,60,34,13,21,16,-7
23619,62,81,5668,23,8,2,6,8,-10
23620,65,81,5668,43,24,4,20,20,6
23621,68,81,5668,12,5,1,4,4,3
23622,68,66,5668,13,4,0,4,5,-7
23623,80,75,209521,3,1,1,0,0,1
23624,83,75,209521,26,6,4,2,8,-5
23625,86,88,209521,8,1,1,0,2,-4
23626,80,76,161337,21,10,4,6,12,1
23627,83,76,161337,22,12,2,10,2,-7
23629,77,78,156982,72,37,18,19,25,-2
23630,80,78,156982,51,29,11,18,27,-16
23631,86,78,156982,32,6,2,4,6,-4
23632,80,72,84150,12,4,1,3,2,1
23633,83,72,84150,2,0,0,0,0,-3
23634,86,72,84150,19,1,1,0,4,-1
23635,83,547,177702,9,1,1,0,21,2
23636,86,547,177702,44,11,9,2,64,10
23637,86,74,177702,19,6,3,3,44,-4
23638,47,78,8820,67,24,8,16,83,-31
23639,50,78,8820,55,22,5,17,44,-7
23640,50,63,8820,20,3,1,2,27,-3
23641,53,63,8820,81,36,13,23,70,11
23642,56,63,8820,79,50,13,37,34,32
23643,59,63,8820,76,30,6,24,34,-14
23644,62,68,8820,61,33,9,24,33,-26
23646,65,89,8820,82,46,11,35,46,-8
23647,68,62,8820,46,22,6,16,12,-9
23648,71,62,8820,46,21,4,17,18,-15
23649,74,62,8820,80,56,15,41,34,6
23650,77,62,8820,51,19,2,17,30,-9
23651,80,62,8820,57,18,5,13,32,-6
23652,86,68,120679,42,12,7,5,16,-8
23653,80,78,108711,30,12,5,7,2,5
23654,83,78,108711,53,13,7,6,4,-1
23655,86,78,108711,80,26,14,12,17,-4
23656,77,86,160596,9,2,1,1,0,1
23657,80,86,160596,2,0,0,0,0,-1
23658,80,84,160596,12,3,3,0,0,1
23659,83,84,160596,38,14,8,6,6,-14
23660,86,84,160596,63,27,7,20,18,-10
23661,83,1479,4665,22,4,1,3,6,5
23663,86,79,4665,57,19,2,17,49,13
23666,8,80,71013,76,48,19,29,54,-20
23667,11,86,71013,65,17,12,5,38,2
23668,14,86,71013,43,11,7,4,22,-7
23669,17,86,71013,77,33,16,17,79,-19
23670,20,83,71013,58,16,8,8,28,2
23671,23,83,71013,13,5,0,5,10,1
23672,26,86,71013,1,1,0,1,0,1
23673,47,66,9065,7,1,0,1,4,-4
23674,50,66,9065,8,1,0,1,0,1
23675,53,66,9065,38,13,5,8,10,3
23676,56,89,9065,12,6,2,4,4,5
23677,59,89,9065,9,5,1,4,0,-2
23678,62,89,9065,1,0,0,0,0,0
23679,65,89,9065,27,11,3,8,0,4
23680,68,76,9065,41,12,6,6,4,-1
23682,86,72,123117,1,0,0,0,0,-1
23683,80,80,115204,5,0,0,0,2,-3
23684,83,80,115204,1,0,0,0,0,1
23685,86,80,115204,3,0,0,0,10,-2
23686,2,89,78184,1,0,0,0,0,0
23687,8,89,78184,1,0,0,0,2,0
23688,80,73,216715,2,0,0,0,2,-1
23689,83,64,216715,3,0,0,0,0,-2
23690,86,64,216715,23,5,2,3,10,-2
23692,5,84,26309,75,29,5,24,63,-2
23693,8,84,26309,43,19,3,16,44,6
23694,11,84,26309,73,32,4,28,52,0
23695,14,84,26309,40,14,3,11,18,-13
23696,17,84,26309,53,24,3,21,38,-5
23566,50,73,9148,72,26,11,15,40,11
23567,53,73,9148,79,32,11,21,47,-4
23701,26,88,26309,8,2,0,2,2,-2
23704,50,79,9675,3,0,0,0,2,-1
23705,50,65,9675,37,5,2,3,43,-2
23706,50,81,9675,7,0,0,0,2,-2
23707,53,81,9675,9,0,0,0,2,-2
23708,86,77,151193,9,0,0,0,0,1
23709,83,66,189421,10,3,0,3,19,3
23710,80,1479,98011,27,6,2,4,14,11
23711,83,1479,98011,80,32,9,23,42,16
23712,86,1479,98011,62,25,5,20,40,-16
23713,86,67,98011,20,10,3,7,16,-4
23714,47,63,9122,21,1,0,1,8,1
23715,47,78,9122,46,13,4,9,21,-15
23716,50,88,9122,53,10,1,9,12,-13
23717,53,88,9122,34,7,3,4,4,4
23718,83,63,184606,12,9,5,4,2,2
23720,86,69,184606,22,16,4,12,4,-4
23721,80,87,194936,78,33,15,18,22,7
23722,83,87,194936,78,37,15,22,22,-19
23723,86,87,194936,20,7,2,5,2,-2
23724,59,70,11511,8,0,0,0,4,-6
23725,71,70,11511,1,1,0,1,0,1
23726,83,85,120693,5,0,0,0,2,-2
23727,86,85,120693,4,0,0,0,0,-3
23728,86,68,152009,40,6,0,6,6,-7
23729,47,68,10247,11,1,0,1,4,-1
23730,50,68,10247,3,0,0,0,2,-1
23731,83,66,210370,2,3,2,1,0,3
23732,86,66,210370,77,15,10,5,20,-17
23733,47,75,9147,7,1,1,0,2,-2
23734,77,84,123167,13,2,1,1,10,-3
23735,80,84,123167,66,9,2,7,64,-7
23737,80,75,104284,2,0,0,0,0,-1
23738,83,75,104284,18,1,0,1,6,-5
23739,47,66,8987,49,13,1,12,35,7
23740,50,66,8987,80,18,6,12,10,-2
23741,53,66,8987,58,23,11,12,46,6
23742,56,66,8987,81,31,19,12,35,6
23743,59,66,8987,56,28,11,17,24,-2
23744,62,66,8987,82,31,16,15,59,-21
23745,65,66,8987,67,32,19,13,48,-15
23746,68,66,8987,35,4,2,2,29,-8
23747,80,81,62259,68,40,18,22,14,4
23748,83,81,62259,82,66,32,34,24,18
23749,86,81,62259,79,92,41,51,28,27
23750,80,82,45697,3,0,0,0,0,-1
23751,47,1479,10991,23,7,4,3,48,-4
23752,50,82,10991,6,0,0,0,20,-2
23754,56,81,10991,7,1,0,1,29,-1
23755,59,81,10991,74,5,2,3,265,-11
23756,62,76,10991,82,9,2,7,307,-14
23757,65,80,10991,55,5,3,2,193,-4
23758,68,69,10991,37,0,0,0,117,-4
23759,71,69,10991,36,2,1,1,55,-5
23760,71,67,10991,23,1,0,1,33,-4
23761,83,69,177739,1,2,0,2,0,1
23762,86,69,177739,2,0,0,0,0,0
23763,74,547,45643,80,23,11,12,46,1
23764,77,547,45643,74,17,7,10,53,-9
23765,80,547,45643,82,29,15,14,52,1
23766,83,547,45643,45,21,8,13,8,9
23767,86,547,45643,78,23,12,11,33,6
23768,86,77,107201,1,0,0,0,0,-1
23769,83,88,151440,37,8,4,4,8,-2
23775,5,86,60152,12,4,1,3,2,-7
23776,2,63,68030,3,3,2,1,0,2
23777,5,63,68030,3,1,0,1,0,1
23778,80,66,39035,8,2,0,2,2,1
23779,83,66,39035,11,1,1,0,2,-4
23780,86,66,39035,81,28,10,18,36,-8
23781,77,547,116960,2,0,0,0,0,1
23782,86,1479,116960,1,0,0,0,0,1
23783,80,547,120697,10,0,0,0,5,-1
23784,86,547,120697,1,0,0,0,0,0
23785,2,77,70154,67,16,8,8,74,-3
23786,5,78,70154,67,11,3,8,94,-3
23787,8,78,70154,53,4,2,2,59,-5
23788,11,78,70154,77,14,5,9,123,-14
23789,14,78,70154,39,5,0,5,93,9
23790,17,78,70154,82,11,2,9,190,3
23792,20,75,70154,60,6,1,5,107,-16
23795,26,84,70154,81,8,2,6,115,-23
23796,29,84,70154,81,12,2,10,67,8
23797,32,84,70154,82,11,3,8,63,-13
23798,35,84,70154,61,7,1,6,68,8
23799,38,84,70154,78,6,2,4,62,13
23800,41,78,70154,80,6,1,5,61,-6
23801,47,77,10243,3,0,0,0,14,0
23805,56,77,10243,19,3,1,2,57,-2
23806,86,85,115072,60,9,3,6,6,-5
23807,86,76,59624,48,18,5,13,4,7
23808,41,63,10346,12,2,2,0,0,2
23809,50,65,10346,7,1,0,1,2,0
23810,2,85,72030,70,40,18,22,55,20
23811,5,72,72030,41,18,6,12,32,9
23812,8,72,72030,62,14,6,8,61,1
23814,26,79,3410,3,0,0,0,0,-1
23815,74,73,27494,6,0,0,0,0,0
23816,77,73,27494,56,16,8,8,35,-8
23817,80,73,27494,80,61,31,30,28,16
23818,83,73,27494,78,61,29,32,36,20
23819,86,73,27494,58,48,34,14,26,12
23820,80,63,105873,8,0,0,0,2,-3
23821,83,63,105873,77,47,16,31,16,10
23822,86,63,105873,77,34,11,23,16,13
23823,86,87,223308,5,1,1,0,2,0
23824,2,78,31696,79,34,16,18,183,17
23825,5,78,31696,79,32,7,25,167,12
23826,8,78,31696,53,19,9,10,63,0
23827,11,78,31696,46,9,2,7,44,-14
23698,23,84,26309,47,9,0,9,37,-11
23699,23,77,26309,6,0,0,0,12,2
23834,29,78,31696,27,4,1,3,26,-3
23835,8,77,31298,8,4,2,2,9,2
23836,11,68,31298,2,0,0,0,0,-2
23837,14,79,31298,48,14,3,11,66,-4
23838,17,79,31298,5,0,0,0,18,-1
23839,29,88,31298,46,13,5,8,56,5
23840,29,68,31298,14,10,4,6,6,4
23841,32,68,31298,60,23,5,18,135,4
23842,80,65,86422,38,5,2,3,4,3
23843,83,65,86422,41,13,3,10,8,-2
23844,86,65,86422,43,9,3,6,30,-9
23845,86,66,191429,20,3,1,2,6,-3
23846,17,63,67490,6,0,0,0,4,4
23847,83,89,168758,3,1,0,1,0,-1
23848,83,77,86225,23,6,2,4,8,4
23849,86,77,86225,81,33,17,16,20,-9
23851,83,64,39033,48,4,0,4,14,4
23852,86,64,39033,2,0,0,0,0,-1
23853,83,63,183865,30,12,4,8,6,2
23854,86,63,183865,20,3,1,2,2,-1
23855,74,88,32747,18,3,2,1,18,1
23856,77,88,32747,60,10,8,2,76,1
23857,80,88,32747,36,2,0,2,70,-2
23858,83,88,32747,45,9,3,6,50,-6
23859,86,86,120248,13,1,1,0,2,-5
23860,2,76,28862,78,7,1,6,282,-14
23861,5,76,28862,44,1,0,1,202,-10
23862,5,83,28862,11,0,0,0,23,1
23863,8,83,28862,63,1,1,0,155,-11
23864,11,83,28862,64,8,4,4,185,-6
23865,14,83,28862,2,0,0,0,5,0
23866,17,83,28862,60,5,2,3,152,-5
23868,20,1479,28862,67,11,0,11,182,0
23869,23,63,28862,82,1,0,1,199,-14
23870,26,63,28862,69,4,1,3,119,-6
23871,83,1479,75107,7,2,0,2,0,-1
23872,86,1479,75107,26,4,1,3,8,-5
23873,80,86,133892,55,20,8,12,22,9
23874,83,86,133892,77,40,11,29,32,-6
23875,86,86,133892,82,56,17,39,36,-1
23876,5,84,67359,2,0,0,0,0,0
23877,8,86,67359,42,5,5,0,47,-25
23878,11,1479,67359,12,1,0,1,7,-3
23879,83,78,213875,11,3,1,2,6,1
23880,86,78,213875,32,4,2,2,6,-1
23881,83,65,146633,5,3,0,3,0,2
23882,86,65,146633,33,8,0,8,0,2
23883,86,67,27466,6,4,2,2,2,1
23885,47,74,9715,8,2,1,1,4,-3
23886,50,74,9715,44,8,4,4,16,-4
23887,53,74,9715,1,0,0,0,0,-2
23888,56,76,9715,59,3,1,2,35,-17
23889,41,89,10617,2,0,0,0,2,-1
23890,47,89,10617,3,0,0,0,0,0
23891,56,89,10617,2,0,0,0,0,0
23892,77,84,9195,6,0,0,0,2,-4
23893,80,84,9195,3,0,0,0,0,-1
23894,80,1479,165106,53,15,5,10,18,-1
23895,83,1479,165106,66,38,20,18,14,18
23896,86,1479,165106,30,20,11,9,2,0
23897,86,86,150922,3,1,0,1,2,-1
23898,74,75,41028,50,16,7,9,18,-2
23899,74,1479,41028,19,7,2,5,4,2
23900,77,1479,41028,22,3,1,2,4,0
23902,77,87,41028,11,2,0,2,10,-4
23903,83,65,130176,13,2,2,0,0,-4
23904,2,74,74512,6,0,0,0,6,-2
23905,5,74,74512,3,1,0,1,2,0
23906,2,63,39297,16,1,0,1,10,-8
23907,5,63,39297,31,5,0,5,29,-13
23908,8,81,39297,64,36,12,24,70,-25
23909,11,81,39297,16,6,1,5,12,-11
23910,11,71,39297,66,37,10,27,74,-11
23911,14,76,39297,22,9,2,7,6,-8
23912,17,76,39297,13,5,0,5,10,-2
23913,20,63,39297,27,7,3,4,8,0
23914,83,85,120262,5,3,0,3,2,5
23915,86,85,120262,11,0,0,0,0,-9
23916,2,83,5532,8,1,0,1,25,-6
23917,5,83,5532,1,0,0,0,0,0
23919,11,83,5532,49,10,2,8,63,-3
23920,14,83,5532,25,2,0,2,15,-10
23921,14,79,5532,4,0,0,0,13,1
23922,17,79,5532,1,0,0,0,0,1
23923,23,71,5532,67,7,1,6,169,1
23924,26,73,5532,74,17,2,15,140,-9
23925,29,73,5532,79,32,12,20,87,-4
23926,32,73,5532,66,24,6,18,100,-9
23927,32,84,5532,14,2,1,1,21,0
23928,35,84,5532,25,3,1,2,18,-5
23931,41,79,5532,47,21,5,16,50,-16
23932,41,83,5532,9,3,1,2,17,5
23933,80,84,75110,13,0,0,0,21,-2
23934,50,73,11017,3,1,0,1,12,0
23935,53,72,11017,44,8,0,8,63,0
23936,56,72,11017,15,0,0,0,25,1
23938,59,1479,11017,66,9,0,9,114,10
23939,62,1479,11017,40,0,0,0,63,-8
23940,65,1479,11017,80,14,3,11,72,11
23941,68,65,11017,26,1,1,0,21,-2
23942,71,65,11017,48,7,2,5,52,2
23945,8,75,21715,82,88,40,48,44,4
23946,11,75,21715,77,71,33,38,36,9
23947,14,75,21715,41,16,8,8,8,-7
23948,17,81,21715,79,49,23,26,39,-14
23949,20,81,21715,7,3,1,2,0,-4
23950,20,1479,21715,62,28,15,13,22,-11
23951,23,89,21715,11,9,6,3,6,-3
23952,26,89,21715,76,36,17,19,26,-12
23953,47,76,13506,8,2,1,1,0,1
23831,20,70,31696,46,12,5,7,41,5
23832,23,70,31696,58,7,3,4,57,-4
23958,8,71,62421,18,8,1,7,59,-1
23959,11,68,62421,73,30,6,24,107,-7
23960,14,68,62421,24,8,1,7,18,-6
23963,41,82,10233,9,4,1,3,6,-2
23964,47,82,10233,33,12,9,3,22,-1
23965,50,82,10233,6,3,1,2,2,2
23966,50,1479,10233,6,0,0,0,4,-1
23967,53,85,10233,23,4,3,1,16,-2
23968,2,67,31891,76,47,19,28,76,-8
23969,5,67,31891,3,1,0,1,0,0
23970,5,76,31891,72,75,30,45,67,30
23971,8,76,31891,70,75,33,42,108,13
23972,11,76,31891,83,69,36,33,73,-7
23973,14,76,31891,33,10,6,4,34,0
23974,14,83,31891,12,6,3,3,0,0
23975,17,83,31891,44,37,12,25,68,6
23977,20,70,31891,73,43,19,24,54,8
23978,23,70,31891,53,22,6,16,35,7
23979,26,81,31891,62,25,11,14,50,-12
23980,26,70,31891,12,4,1,3,4,2
23982,32,70,31891,34,10,3,7,26,-1
23983,35,70,31891,32,6,3,3,24,-4
23984,35,63,31891,17,8,4,4,9,-3
23985,35,89,31891,9,1,0,1,4,2
23986,2,76,70966,78,23,9,14,67,-3
23987,5,76,70966,47,14,5,9,28,-18
23988,8,76,70966,22,9,6,3,49,4
23989,8,83,70966,58,15,7,8,54,-1
23990,11,83,70966,83,19,8,11,93,-3
23991,14,83,70966,32,6,5,1,26,-11
23992,17,83,70966,23,2,1,1,33,-6
23993,17,74,70966,18,3,2,1,8,0
23995,23,74,70966,67,10,1,9,55,-15
23996,26,80,70966,44,4,2,2,28,4
23997,41,71,12858,14,2,0,2,19,0
23998,47,88,12586,48,7,3,4,26,0
23999,53,88,12586,53,6,0,6,14,-9
24001,5,86,60159,66,19,12,7,30,-26
24002,8,86,60159,28,7,3,4,28,-18
24005,8,81,31947,78,14,2,12,66,-16
24006,11,81,31947,83,16,1,15,87,-5
24007,14,81,31947,44,6,2,4,51,-6
24008,17,85,31947,70,10,1,9,33,7
24009,20,78,31947,82,4,0,4,53,-9
24010,23,78,31947,81,10,3,7,90,-2
24011,26,78,31947,52,2,1,1,99,-14
24012,29,78,31947,81,9,1,8,75,27
24013,32,78,31947,2,0,0,0,0,1
24015,35,78,31947,30,3,0,3,2,6
24016,38,79,31947,69,7,2,5,36,-9
24017,38,81,31947,1,0,0,0,0,-2
24018,41,79,31947,52,9,1,8,27,-8
24019,41,84,31947,9,2,0,2,2,2
24020,47,65,8848,29,16,7,9,2,7
24021,50,77,8848,3,0,0,0,0,-3
24022,65,68,8848,6,1,0,1,2,2
24023,47,78,8574,52,8,2,6,34,-16
24024,50,63,8574,46,2,0,2,33,-8
24025,53,63,8574,1,0,0,0,0,0
24028,2,89,77862,47,14,5,9,21,-1
24029,5,89,77862,22,5,1,4,2,-3
24030,8,81,77862,27,6,3,3,11,-5
24031,11,81,77862,51,11,6,5,6,-14
24032,11,89,77862,3,0,0,0,4,-1
24034,74,85,34764,63,18,3,15,14,6
24035,77,85,34764,44,6,4,2,16,-6
24036,80,85,34764,16,0,0,0,2,-8
24037,80,65,34764,13,1,1,0,2,-4
24038,83,65,34764,29,10,6,4,12,1
24039,2,77,31950,74,17,8,9,293,-6
24040,5,83,31950,40,12,5,7,109,-2
24041,5,62,31950,36,5,1,4,155,-3
24042,8,62,31950,77,12,4,8,209,-6
24043,11,89,31950,84,14,7,7,305,-4
24044,14,89,31950,43,6,2,4,173,-5
24045,17,89,31950,50,12,2,10,151,1
24046,20,89,31950,80,7,4,3,218,-11
24047,23,89,31950,74,15,6,9,189,-3
24048,26,89,31950,66,9,5,4,166,-7
24049,26,77,31950,11,0,0,0,28,-3
24051,32,89,31950,22,1,0,1,18,-3
24052,32,76,31950,38,2,0,2,54,-5
24053,35,62,31950,66,4,3,1,164,-2
24054,38,62,31950,55,6,2,4,100,-6
24055,50,85,9141,16,0,0,0,6,-1
24056,53,85,9141,35,6,2,4,12,1
24057,53,88,9141,19,2,1,1,14,2
24058,56,67,9141,45,12,7,5,12,4
24059,59,67,9141,72,13,3,10,12,-1
24060,62,67,9141,14,0,0,0,0,-4
24061,65,67,9141,60,8,3,5,25,-3
24062,68,67,9141,6,0,0,0,0,0
24063,71,67,9141,50,6,4,2,4,-6
24064,74,67,9141,39,2,1,1,4,-12
24065,83,68,84657,11,1,0,1,2,-5
24066,86,68,84657,31,10,3,7,8,0
24070,47,77,11028,1,0,0,0,2,0
24071,71,82,45599,72,29,16,13,45,6
24072,74,82,45599,31,17,9,8,12,-5
24073,77,82,45599,82,49,30,19,77,-15
24074,80,82,45599,82,34,18,16,52,14
24075,83,82,45599,75,32,13,19,39,1
24076,86,82,45599,77,38,16,22,42,6
24077,38,82,1797,51,21,11,10,12,-4
24078,41,82,1797,57,10,2,8,20,-6
24079,41,79,1797,13,12,6,6,0,3
24080,47,79,1797,25,7,4,3,18,4
24081,2,71,31982,67,10,3,7,150,6
24082,5,71,31982,18,5,0,5,78,4
24083,5,74,31982,56,11,1,10,122,19
23955,5,88,62421,53,32,2,30,99,4
23956,5,77,62421,22,14,2,12,35,-9
24088,20,74,31982,80,12,3,9,167,22
24089,23,74,31982,63,5,0,5,195,-25
24090,26,74,31982,45,9,0,9,60,-2
24091,47,89,9609,14,2,0,2,0,-7
24092,50,89,9609,29,8,4,4,8,-6
24093,53,89,9609,75,30,10,20,18,-7
24094,56,89,9609,73,37,19,18,20,-3
24095,59,89,9609,69,51,23,28,28,9
24096,62,89,9609,23,10,4,6,10,3
24097,62,64,9609,22,21,8,13,8,-1
24098,65,68,9609,82,61,27,34,26,-7
24099,68,68,9609,48,35,12,23,16,-10
24100,71,68,9609,80,28,8,20,22,-18
24101,74,68,9609,52,21,7,14,8,12
24102,74,1479,9609,14,6,1,5,4,0
24103,77,75,9609,57,20,10,10,28,-1
24105,38,82,3653,74,39,17,22,78,-27
24106,41,82,3653,80,57,41,16,87,-35
24107,47,82,3653,54,54,31,23,51,5
24108,50,82,3653,75,57,27,30,73,-8
24109,53,82,3653,80,69,38,31,95,2
24110,56,82,3653,78,79,40,39,52,11
24111,59,82,3653,76,67,33,34,58,-2
24112,62,82,3653,75,66,32,34,34,2
24113,65,82,3653,82,59,30,29,40,-19
24114,68,74,3653,44,42,21,21,26,16
24115,71,74,3653,65,39,26,13,36,10
24116,74,74,3653,79,69,42,27,36,29
24117,77,74,3653,60,36,15,21,30,8
24118,80,74,3653,67,38,23,15,26,9
24119,83,74,3653,60,28,18,10,24,-8
24120,83,63,3653,11,6,3,3,4,-4
24122,86,62,223246,44,13,8,5,12,11
24123,47,85,3194,4,1,0,1,2,1
24124,50,85,3194,73,17,10,7,20,8
24125,53,85,3194,78,36,19,17,28,16
24126,56,85,3194,80,40,12,28,42,9
24127,59,85,3194,55,35,11,24,24,-4
24128,62,85,3194,71,39,16,23,22,-1
24129,65,85,3194,81,66,23,43,14,18
24130,68,85,3194,41,17,9,8,6,-4
24131,71,81,3194,75,58,25,33,20,5
24132,74,81,3194,82,48,12,36,24,-14
24133,77,81,3194,76,31,8,23,46,-6
24134,80,81,3194,59,34,7,27,24,1
24135,80,77,3194,20,8,5,3,2,-2
24136,83,77,3194,81,33,11,22,20,-7
24137,86,76,3194,72,31,17,14,16,19
24142,59,68,9067,82,28,8,20,88,-7
24143,62,84,9067,65,7,2,5,53,10
24144,65,84,9067,47,7,1,6,64,0
24145,68,84,9067,36,2,0,2,29,-2
24146,71,69,9067,45,9,2,7,37,-7
24147,74,69,9067,14,1,0,1,26,-3
24148,47,88,9602,10,1,1,0,0,1
24149,47,83,639,34,1,0,1,14,-3
24150,53,83,639,18,0,0,0,7,-2
24151,56,89,639,3,0,0,0,0,-1
24152,59,62,639,11,3,1,2,2,-1
24153,74,70,45567,31,9,6,3,12,-1
24154,77,70,45567,8,1,0,1,7,-3
24155,80,70,45567,78,24,16,8,38,11
24156,83,70,45567,71,14,7,7,42,1
24157,86,70,45567,53,6,4,2,57,-7
24159,53,85,9503,32,3,0,3,6,-5
24160,56,85,9503,41,7,2,5,12,-12
24161,59,85,9503,49,6,2,4,19,-12
24162,65,547,9503,2,0,0,0,4,1
24163,68,547,9503,16,1,0,1,2,0
24164,50,65,10195,9,0,0,0,2,-4
24165,53,65,10195,81,8,4,4,214,-13
24166,56,65,10195,66,9,6,3,93,3
24167,59,65,10195,13,4,1,3,14,2
24168,62,70,10195,63,14,8,6,91,2
24169,65,70,10195,65,19,6,13,76,6
24170,68,86,10195,46,3,1,2,25,-7
24171,71,86,10195,15,0,0,0,6,-4
24172,74,86,10195,20,3,1,2,33,-6
24173,47,82,10318,39,0,0,0,44,-17
24174,50,82,10318,7,0,0,0,10,0
24177,47,81,9119,48,28,15,13,6,-4
24178,50,81,9119,72,27,14,13,55,-11
24179,53,81,9119,7,2,1,1,0,-1
24180,56,81,9119,54,6,2,4,60,-7
24181,59,81,9119,3,0,0,0,5,0
24182,62,79,9119,6,0,0,0,22,-3
24183,71,82,9119,6,0,0,0,0,-3
24184,74,82,9119,2,0,0,0,0,0
24185,2,85,162,5,0,0,0,0,-4
24186,71,62,19416,7,3,2,1,0,2
24187,74,62,19416,48,18,8,10,16,-4
24188,77,62,19416,31,7,4,3,8,-1
24189,77,84,19416,16,3,2,1,6,-3
24190,80,84,19416,69,32,19,13,14,-19
24191,83,84,19416,53,12,8,4,8,-10
24192,86,84,19416,77,22,12,10,20,-4
24194,5,88,73585,22,6,2,4,10,-1
24198,11,70,28860,13,5,2,3,2,-4
24199,11,67,28860,2,0,0,0,0,0
24200,17,65,28860,13,6,3,3,16,1
24201,20,65,28860,64,23,12,11,20,6
24202,23,65,28860,52,15,10,5,8,-8
24203,26,89,28860,75,30,16,14,14,5
24204,29,89,28860,49,17,8,9,6,-1
24205,32,89,28860,42,6,1,5,4,-3
24206,77,78,59530,67,9,1,8,63,0
24207,80,78,59530,69,15,3,12,60,11
24208,83,78,59530,69,17,7,10,57,-1
24209,86,78,59530,64,11,2,9,68,8
24210,47,74,8682,68,47,30,17,32,3
24085,11,74,31982,68,16,8,8,170,18
24086,14,74,31982,44,4,1,3,70,3
24218,47,81,8927,7,1,0,1,0,-2
24219,50,77,8927,14,0,0,0,18,-7
24220,83,80,84772,4,0,0,0,2,-1
24221,86,80,84772,6,0,0,0,0,0
24222,71,86,20721,66,24,10,14,16,-4
24223,74,86,20721,72,27,10,17,20,-12
24224,77,86,20721,67,17,8,9,10,-8
24225,80,86,20721,16,2,0,2,4,-3
24226,80,64,20721,43,11,7,4,4,-9
24227,83,64,20721,74,26,15,11,14,6
24228,86,64,20721,64,23,4,19,8,2
24229,47,81,8862,76,18,1,17,58,5
24230,50,81,8862,72,28,4,24,42,5
24231,53,81,8862,72,31,10,21,56,-13
24232,56,81,8862,42,13,2,11,56,-5
24233,59,81,8862,8,2,1,1,6,-2
24235,56,76,11474,18,2,0,2,4,5
24236,59,86,11474,1,1,0,1,0,1
24237,62,68,11474,27,1,0,1,12,-1
24238,53,66,10402,19,5,0,5,60,1
24239,56,66,10402,28,1,0,1,37,-1
24240,59,66,10402,12,0,0,0,24,-5
24241,50,71,11002,12,6,1,5,0,-1
24242,53,71,11002,82,33,13,20,20,-6
24243,56,71,11002,82,45,5,40,26,6
24244,59,71,11002,82,31,5,26,16,-10
24245,62,71,11002,79,26,6,20,32,-14
24246,65,71,11002,47,17,3,14,12,-3
24247,65,69,11002,20,5,0,5,8,-5
24248,68,69,11002,43,13,3,10,18,-11
24249,71,68,11002,73,28,3,25,18,-5
24250,74,75,11002,72,12,4,8,30,10
24252,80,88,11002,18,5,1,4,6,-4
24253,38,73,9513,8,1,1,0,0,2
24254,41,73,9513,7,1,0,1,0,-2
24255,47,73,9513,48,24,8,15,34,14
24256,50,73,9513,14,3,2,1,18,-1
24257,50,77,9513,18,13,6,7,8,4
24258,53,77,9513,61,30,14,16,74,2
24259,56,77,9513,55,21,7,14,63,5
24263,62,82,9513,21,7,6,1,10,-12
24264,65,68,9513,26,5,2,3,29,-3
24265,68,68,9513,27,5,4,1,25,-8
24266,71,68,9513,76,37,15,22,73,1
24267,74,68,9513,63,15,8,7,28,-8
24268,77,78,9513,70,14,6,8,44,5
24269,80,78,9513,73,18,10,8,45,-1
24270,83,78,9513,63,19,7,12,46,-1
24272,74,82,19442,3,2,1,1,0,2
24273,77,82,19442,81,20,9,11,6,-9
24274,80,82,19442,81,25,6,19,10,10
24275,83,20120,19442,82,78,43,35,12,49
24276,86,20120,19442,82,56,24,32,16,1
24277,41,70,9123,27,6,1,5,14,-6
24278,47,70,9123,81,14,3,11,87,-2
24279,50,70,9123,74,12,4,8,63,2
24280,53,70,9123,82,24,5,19,85,-1
24281,56,70,9123,75,25,7,18,73,2
24282,59,70,9123,77,22,6,16,25,3
24283,62,70,9123,82,27,8,19,34,7
24284,65,70,9123,79,25,4,21,42,3
24285,68,70,9123,44,13,4,9,14,1
24286,71,70,9123,67,25,9,16,38,10
24287,74,70,9123,68,38,16,22,34,-13
24289,77,79,9123,53,22,6,16,26,8
24290,80,79,9123,56,19,5,14,37,7
24291,83,85,9123,77,16,9,7,36,-5
24292,86,85,9123,44,8,2,6,12,-3
24293,50,88,11013,23,3,1,2,22,-2
24294,53,88,11013,36,1,0,1,23,-6
24295,56,88,11013,27,1,0,1,42,-2
24296,62,88,11013,4,0,0,0,0,-1
24297,56,76,8535,11,0,0,0,4,3
24298,41,89,8629,52,22,10,12,36,-2
24299,50,89,8629,77,73,38,35,90,-7
24300,53,89,8629,63,42,26,16,54,-18
24301,56,89,8629,62,79,34,45,77,25
24302,59,89,8629,73,84,40,44,66,36
24303,62,89,8629,65,54,28,26,71,22
24304,65,89,8629,77,54,21,33,56,9
24306,71,66,8629,65,42,22,20,42,1
24307,74,66,8629,57,19,6,13,32,-10
24308,77,75,8629,15,4,1,3,12,1
24309,47,71,9166,27,2,0,2,43,-6
24310,50,71,9166,78,10,1,9,109,-22
24311,53,71,9166,46,1,0,1,53,-3
24312,56,88,9166,82,14,2,12,111,1
24313,59,88,9166,75,9,2,7,83,4
24314,62,88,9166,71,11,2,9,70,3
24315,65,88,9166,82,15,4,11,58,4
24316,68,88,9166,5,1,0,1,8,-1
24317,71,88,9166,38,6,2,4,47,6
24318,74,88,9166,82,9,3,6,54,1
24319,77,88,9166,3,0,0,0,8,0
24320,80,88,9166,26,2,1,1,19,3
24321,47,72,9022,47,0,0,0,91,-3
24323,53,78,9022,12,1,0,1,18,-1
24324,56,78,9022,56,4,1,3,131,-5
24325,59,78,9022,43,0,0,0,190,-3
24326,62,78,9022,54,4,1,3,131,-6
24327,65,72,9022,48,1,0,1,75,-8
24328,68,72,9022,4,0,0,0,2,-1
24329,71,72,9022,24,3,3,0,22,3
24330,2,88,8577,75,46,12,34,125,3
24331,5,88,8577,57,20,7,13,102,-5
24332,8,88,8577,76,59,16,43,152,18
24333,11,88,8577,84,68,20,48,137,-7
24334,14,88,8577,24,11,4,7,38,-16
24335,17,88,8577,6,3,1,2,8,0
24336,20,88,8577,62,31,8,23,82,-28
24212,53,74,8682,62,17,7,10,22,3
24213,56,74,8682,28,9,4,5,16,-2
24341,32,64,8577,13,10,2,8,8,11
24342,35,64,8577,75,56,16,40,58,16
24343,38,64,8577,79,45,17,28,57,20
24344,41,64,8577,74,46,13,33,61,6
24345,47,64,8577,81,51,14,37,94,2
24346,50,88,8577,72,34,14,20,82,-26
24347,53,88,8577,71,31,9,22,98,-19
24348,56,86,8577,73,45,10,35,110,15
24349,59,86,8577,70,30,7,23,60,14
24350,2,74,74513,3,2,0,2,0,3
24351,5,74,74513,3,1,0,1,0,1
24352,56,66,9391,23,2,1,1,0,-2
24353,59,86,9391,4,1,1,0,0,-1
24354,47,89,9606,25,4,1,3,8,-11
24355,50,89,9606,41,10,3,7,28,-2
24357,59,1479,11420,3,0,0,0,2,-1
24359,41,77,2693,71,27,8,19,44,15
24360,47,77,2693,58,46,13,33,78,22
24361,50,77,2693,77,43,4,39,88,-25
24362,53,71,2693,63,26,8,18,56,-5
24363,56,66,2693,71,33,7,26,58,11
24364,59,66,2693,71,46,6,40,72,-11
24365,62,66,2693,72,35,5,30,60,-2
24366,65,66,2693,30,17,5,12,16,-15
24367,68,66,2693,22,9,1,8,12,2
24368,2,67,31949,58,28,5,23,54,-8
24369,5,67,31949,73,46,11,35,108,1
24370,8,67,31949,81,54,9,45,87,14
24371,11,67,31949,75,39,7,32,76,8
24372,14,67,31949,44,20,3,17,47,-3
24373,17,67,31949,16,5,0,5,18,-6
24374,17,86,31949,57,23,4,19,50,-18
24376,23,86,31949,28,10,4,6,32,0
24377,23,72,31949,49,10,5,5,25,-1
24378,26,88,31949,65,14,3,11,34,1
24379,29,84,31949,13,1,0,1,4,-6
24380,50,76,321,15,2,1,1,0,-2
24381,53,76,321,16,3,2,1,0,1
24382,56,76,321,59,33,9,24,18,-4
24383,59,76,321,76,38,12,26,6,4
24384,62,76,321,71,44,13,31,38,13
24385,65,76,321,82,47,17,30,6,-3
24386,68,76,321,48,29,6,23,12,-3
24387,71,76,321,80,58,25,33,8,-11
24388,74,76,321,78,43,14,29,12,8
24389,77,76,321,81,52,20,32,12,1
24390,80,85,321,79,41,17,24,18,-19
24391,83,85,321,79,33,16,17,14,1
24393,47,89,241,1,0,0,0,2,0
24394,2,89,8549,54,28,12,16,47,-10
24395,5,89,8549,71,56,28,28,42,16
24396,8,89,8549,83,85,37,48,70,8
24397,11,89,8549,69,43,24,19,40,22
24398,14,89,8549,47,43,34,9,24,9
24399,17,89,8549,67,80,52,28,40,18
24400,20,89,8549,77,77,46,31,72,7
24401,23,89,8549,76,78,52,26,44,14
24402,26,89,8549,66,55,31,24,56,-1
24403,29,89,8549,62,38,21,17,30,5
24404,32,89,8549,82,81,45,36,60,8
24405,35,89,8549,77,70,39,31,80,-2
24406,38,89,8549,76,56,30,26,52,-3
24407,41,89,8549,54,35,21,14,22,-17
24408,41,80,8549,23,14,5,9,16,1
24411,47,82,3975,3,0,0,0,0,0
24412,50,82,3975,9,1,1,0,4,-3
24413,53,82,3975,25,7,3,4,14,0
24415,65,64,3975,16,5,2,3,0,-9
24416,74,78,3975,34,6,3,3,8,-8
24417,74,83,3975,19,4,1,3,4,-7
24418,38,69,9078,50,20,7,13,18,1
24419,41,69,9078,61,22,4,18,22,-7
24420,47,69,9078,80,59,17,42,28,3
24421,50,69,9078,82,57,20,37,14,13
24422,53,69,9078,81,63,13,50,34,11
24423,56,69,9078,71,46,16,30,20,-5
24424,59,69,9078,1,0,0,0,2,0
24425,62,69,9078,59,38,12,26,14,-3
24426,65,69,9078,37,22,9,13,18,-1
24427,68,69,9078,43,20,8,12,8,3
24429,38,68,3654,82,16,4,12,14,-29
24430,41,68,3654,61,20,2,18,30,-15
24431,47,68,3654,82,46,5,41,79,1
24432,50,68,3654,82,42,12,30,66,23
24433,53,68,3654,82,37,15,22,72,-5
24434,56,68,3654,82,42,15,27,68,-2
24435,59,62,3654,82,29,3,26,48,-4
24436,62,62,3654,82,24,4,20,44,-2
24437,65,62,3654,82,29,5,24,26,-21
24438,68,62,3654,33,15,6,9,16,-11
24439,68,78,3654,14,7,1,6,6,5
24440,71,78,3654,82,37,4,33,20,26
24441,74,78,3654,72,13,2,11,24,7
24442,77,78,3654,72,19,3,16,18,-4
24443,80,78,3654,81,15,1,14,28,6
24444,83,78,3654,35,7,2,5,16,5
24447,62,83,9390,48,15,3,12,24,-1
24448,65,83,9390,67,26,11,15,33,1
24449,68,89,9390,26,2,2,0,8,-1
24450,71,68,9390,9,1,0,1,7,-2
24451,41,89,9519,41,6,1,5,8,-9
24452,47,89,9519,25,1,0,1,4,-4
24453,50,89,9519,71,29,7,22,14,10
24454,53,89,9519,67,16,7,9,12,5
24455,56,89,9519,63,14,5,9,16,-4
24456,59,89,9519,36,10,4,6,12,4
24457,62,89,9519,60,9,3,6,16,-5
24460,71,71,9519,74,21,8,13,20,-15
24461,74,71,9519,68,13,6,7,17,-5
24462,77,87,9519,65,4,2,2,10,-7
24338,26,88,8577,62,35,12,23,128,-7
24339,29,88,8577,77,57,18,39,112,10
24467,50,83,8884,82,39,10,29,44,3
24468,53,83,8884,82,33,16,17,47,-11
24469,56,83,8884,76,55,15,40,54,-4
24470,59,83,8884,55,41,16,25,30,-3
24471,59,62,8884,27,16,3,13,2,-3
24472,62,62,8884,76,31,6,25,32,1
24473,65,62,8884,61,18,8,10,29,-3
24474,68,62,8884,43,23,5,18,26,7
24475,71,62,8884,63,33,14,19,42,-13
24476,74,62,8884,59,17,7,10,28,7
24477,77,62,8884,80,17,6,11,52,-4
24478,80,62,8884,81,23,6,17,40,3
24479,83,62,8884,68,12,4,8,28,4
24480,47,69,9155,19,5,2,3,16,-4
24481,50,69,9155,9,0,0,0,4,-1
24482,53,69,9155,28,8,4,4,28,-1
24484,68,547,75430,4,0,0,0,0,0
24485,71,547,75430,63,34,13,21,14,9
24486,74,547,75430,82,49,15,34,24,11
24487,77,547,75430,71,61,29,32,48,16
24488,80,547,75430,79,82,32,50,38,18
24489,83,547,75430,60,60,23,37,18,19
24490,86,547,75430,82,84,38,46,38,8
24491,41,68,9101,2,0,0,0,5,-1
24492,47,68,9101,64,9,3,6,40,-11
24493,50,68,9101,79,9,6,3,66,-10
24494,53,68,9101,81,18,5,13,72,-12
24495,56,68,9101,77,32,13,19,76,0
24496,59,68,9101,60,17,2,15,53,-5
24497,62,63,9101,80,29,13,16,93,11
24498,65,63,9101,78,16,8,8,80,-3
24499,68,63,9101,48,13,4,9,41,2
24501,74,63,9101,70,12,6,6,45,1
24502,77,82,9101,82,11,3,8,78,-6
24503,47,82,3210,5,0,0,0,2,-2
24504,50,82,3210,70,5,2,3,123,2
24505,53,82,3210,51,4,2,2,111,-3
24506,56,82,3210,19,1,0,1,37,-4
24507,59,77,3210,18,2,0,2,23,1
24508,47,79,273443,48,8,5,3,59,-12
24509,50,79,273443,75,24,13,11,53,-2
24510,53,79,273443,63,26,12,14,53,8
24511,56,79,273443,75,22,12,10,63,-9
24512,59,79,273443,45,7,2,5,30,-9
24513,62,79,273443,82,21,8,13,66,-3
24514,65,77,273443,81,34,19,15,59,5
24515,68,77,273443,35,10,5,5,23,2
24516,71,77,273443,11,2,1,1,2,1
24518,74,64,273443,63,15,5,10,27,2
24519,74,63,273443,18,3,0,3,2,-3
24520,77,63,273443,38,7,2,5,15,-11
24521,41,69,4190,35,9,4,5,8,-2
24522,83,77,129114,4,0,0,0,0,-1
24523,86,81,129114,9,2,0,2,8,3
24524,77,63,59783,39,11,8,3,14,-3
24525,80,63,59783,44,18,10,8,14,-3
24526,83,63,59783,25,2,2,0,22,-3
24527,83,68,59783,16,8,5,3,12,6
24528,86,68,59783,81,39,24,15,38,-10
24529,41,76,2704,18,2,1,1,4,-4
24530,47,76,2704,28,9,4,5,20,-11
24531,53,76,2704,78,22,10,12,62,-3
24532,56,76,2704,59,24,15,9,64,-2
24533,59,76,2704,63,23,10,13,45,1
24535,65,68,2704,62,23,17,6,48,-5
24536,71,68,2704,62,29,16,13,40,-16
24537,74,68,2704,39,18,8,10,34,2
24538,74,69,2704,17,1,1,0,6,-4
24539,2,72,31953,78,20,11,9,77,-1
24540,5,72,31953,75,28,8,20,121,9
24541,8,80,31953,70,16,9,7,101,-26
24542,80,85,62795,2,1,0,1,0,0
24543,77,83,94728,11,5,2,3,6,-4
24544,80,83,94728,56,9,5,4,16,1
24545,83,83,94728,3,0,0,0,0,-2
24546,83,78,94728,12,2,1,1,4,0
24547,86,78,94728,5,0,0,0,0,-1
24548,47,62,6667,2,0,0,0,0,-1
24549,53,62,6667,44,10,3,7,48,-5
24550,56,62,6667,76,10,5,5,89,-7
24552,62,69,6667,82,12,4,8,30,-16
24553,65,70,6667,74,21,16,5,24,-10
24554,68,70,6667,48,11,7,4,61,-3
24555,71,73,6667,79,21,15,6,60,-25
24556,74,73,6667,60,12,7,5,15,0
24557,77,73,6667,46,7,7,0,20,-6
24558,74,83,45883,6,1,1,0,2,1
24559,80,80,45883,7,0,0,0,0,-1
24560,47,82,8612,66,22,12,10,26,-1
24561,50,82,8612,8,2,1,1,4,-3
24562,53,64,9086,4,0,0,0,0,1
24563,56,63,9086,1,0,0,0,0,0
24564,59,63,9086,51,15,5,10,43,10
24565,62,63,9086,69,16,3,13,45,15
24566,65,63,9086,77,15,5,10,53,27
24567,68,63,9086,44,6,1,5,12,5
24569,74,76,9086,72,35,9,26,14,15
24570,77,76,9086,70,25,9,16,31,17
24571,80,76,9086,66,23,6,17,19,11
24572,83,76,9086,58,18,6,12,30,-8
24573,86,76,9086,74,19,3,16,25,10
24574,56,62,11740,6,2,0,2,0,-1
24575,62,64,11740,6,3,1,2,2,4
24576,65,64,11740,25,6,1,5,2,3
24577,68,64,11740,9,2,0,2,6,2
24578,71,64,11740,2,0,0,0,0,0
24579,74,88,11740,1,0,0,0,0,0
24580,38,89,9143,17,2,0,2,24,-3
24581,41,89,9143,41,4,0,4,45,-11
24582,47,89,9143,66,18,5,13,81,-12
24464,38,83,8884,1,1,1,0,0,1
24465,41,83,8884,69,27,14,13,22,7
24587,56,68,9143,9,1,1,0,6,1
24588,59,1479,9143,63,16,4,12,30,1
24589,62,74,9143,65,6,2,4,22,-5
24590,65,74,9143,42,5,2,3,28,0
24591,68,74,9143,35,3,0,3,8,9
24592,2,63,19141,76,94,21,73,75,33
24593,5,63,19141,80,81,21,60,56,11
24594,8,63,19141,78,82,19,63,40,38
24595,11,63,19141,72,91,20,71,58,26
24596,14,63,19141,46,43,12,31,20,3
24597,17,63,19141,82,82,20,62,58,31
24598,20,63,19141,62,50,19,31,18,-11
24599,23,63,19141,82,48,13,35,80,2
24600,26,63,19141,81,57,10,47,34,-7
24601,29,63,19141,65,38,10,28,20,-11
24602,29,64,19141,14,14,8,6,6,9
24604,47,72,8841,10,2,1,1,2,-2
24605,50,72,8841,3,0,0,0,0,-1
24606,53,72,8841,3,0,0,0,0,0
24607,56,72,8841,4,0,0,0,0,-1
24608,41,85,6662,12,3,1,2,10,-1
24609,47,85,6662,4,0,0,0,2,0
24610,50,85,6662,76,25,15,10,36,16
24611,53,85,6662,81,42,13,29,26,11
24612,56,85,6662,82,57,23,34,16,7
24613,62,85,6662,73,37,10,27,28,-7
24614,65,85,6662,81,50,25,25,42,10
24615,68,62,6662,42,27,10,17,22,-13
24616,71,62,6662,75,54,17,37,16,4
24617,74,62,6662,78,76,31,45,14,17
24618,77,62,6662,53,35,10,25,17,-1
24619,77,68,6662,19,11,6,5,10,0
24621,74,65,76870,3,0,0,0,0,-1
24622,77,65,76870,2,0,0,0,0,-2
24623,41,82,10290,6,0,0,0,4,-2
24624,59,76,10290,1,0,0,0,0,-1
24625,62,64,10290,29,10,5,5,8,5
24626,77,66,177758,79,22,4,18,22,-14
24627,80,66,177758,81,29,4,25,26,-19
24628,83,66,177758,79,32,10,22,21,-20
24629,86,62,177758,80,33,5,28,12,18
24630,2,79,74385,78,34,20,14,106,7
24631,5,79,74385,58,26,10,16,58,-6
24632,8,74,74385,55,20,6,14,39,-9
24633,11,74,74385,16,1,0,1,8,-2
24634,11,80,74385,11,5,2,3,0,-2
24635,14,80,74385,38,7,4,3,20,-17
24636,17,80,74385,13,2,1,1,14,-3
24638,83,62,723,10,0,0,0,4,-1
24639,86,62,723,79,19,2,17,23,17
24640,41,1479,8994,75,34,13,21,28,-6
24641,47,1479,8994,81,53,28,25,48,-13
24642,50,71,8994,81,28,16,12,45,-29
24643,53,77,8994,56,46,20,26,35,2
24644,56,77,8994,79,50,25,25,58,1
24645,59,1479,8994,23,14,10,4,18,3
24646,62,1479,8994,26,13,5,8,14,-4
24647,62,83,8994,28,18,9,9,19,-7
24648,65,83,8994,66,67,25,42,48,1
24649,68,83,8994,16,18,11,7,12,8
24650,71,83,8994,69,44,22,22,44,-15
24651,74,83,8994,55,21,10,11,26,-10
24652,77,83,8994,46,14,11,3,12,-10
24653,80,80,183872,2,0,0,0,0,0
24655,86,80,183872,71,41,14,27,24,-24
24656,77,72,130839,1,2,0,2,0,4
24657,80,72,130839,70,24,8,16,19,-17
24658,83,72,130839,69,25,8,17,30,-3
24659,86,72,130839,61,25,13,12,15,-6
24660,53,66,12584,1,0,0,0,0,0
24661,77,67,192014,81,56,24,32,22,-16
24662,80,67,192014,61,57,24,33,22,-13
24663,83,67,192014,67,64,25,39,32,-25
24664,86,67,192014,77,82,28,54,26,-11
24665,86,89,105460,26,4,0,4,10,6
24666,77,71,183496,45,48,16,32,18,-1
24667,80,71,183496,82,100,30,70,26,27
24668,83,71,183496,82,108,41,67,26,20
24669,86,71,183496,78,116,41,75,20,3
24670,83,78,161865,75,24,5,19,20,1
24672,83,83,214724,37,13,1,12,8,16
24673,86,83,214724,64,17,4,13,22,-5
24674,86,73,106572,1,0,0,0,0,-1
24675,83,69,183516,6,1,0,1,0,0
24676,86,69,183516,81,24,12,12,29,-12
24677,47,65,9402,19,7,2,5,36,0
24678,50,65,9402,50,10,2,8,39,3
24679,53,65,9402,68,26,7,19,103,12
24680,56,65,9402,31,13,2,11,14,6
24681,56,1479,9402,17,11,1,10,16,3
24682,59,1479,9402,69,30,3,27,56,-5
24683,62,76,9402,32,21,3,18,18,-18
24684,62,75,9402,43,30,7,23,20,4
24685,65,82,9402,48,27,6,21,37,-13
24686,68,82,9402,30,14,5,9,15,-1
24687,71,82,9402,75,51,7,44,61,0
24689,74,1479,9402,13,5,0,5,10,-3
24690,77,66,9402,1,0,0,0,0,0
24691,47,71,8797,3,0,0,0,0,-2
24692,47,63,8797,17,4,1,3,10,-2
24693,50,63,8797,21,2,0,2,19,-3
24694,53,78,8797,12,2,1,1,9,0
24695,56,78,8797,34,7,3,4,20,-14
24696,59,78,8797,4,1,1,0,0,1
24697,20,76,9071,82,48,8,40,86,1
24698,23,76,9071,75,46,14,32,59,-32
24699,26,76,9071,31,15,4,11,26,-6
24700,26,83,9071,38,19,5,14,22,7
24701,29,83,9071,64,30,3,27,42,11
24702,35,74,9071,82,23,2,21,60,-1
24584,53,89,9143,20,2,0,2,8,-4
24585,56,77,9143,12,2,0,2,8,0
24707,53,76,9071,54,22,5,17,48,-17
24708,20,80,8932,82,30,6,24,41,1
24709,23,80,8932,80,22,8,14,27,17
24710,26,80,8932,72,29,8,21,54,7
24711,29,80,8932,81,36,10,26,49,-1
24712,32,80,8932,78,47,10,37,49,22
24713,35,80,8932,79,34,9,25,48,22
24714,38,80,8932,76,45,10,35,70,23
24715,41,80,8932,81,43,17,26,65,21
24716,47,80,8932,65,50,10,40,63,35
24717,50,80,8932,64,36,7,29,50,1
24718,53,80,8932,80,38,6,32,60,11
24719,56,74,8932,81,26,3,23,51,-5
24720,59,74,8932,75,14,2,12,27,8
24721,68,78,8932,23,5,2,3,11,-2
24722,68,63,8932,6,2,1,1,0,0
24801,80,63,115212,1,0,0,0,0,0
24802,86,63,115212,28,9,3,6,2,1
24803,17,81,8981,4,1,0,1,0,-1
24804,20,81,8981,79,28,15,13,35,1
24805,23,81,8981,68,22,8,14,62,-9
24806,26,81,8981,22,10,4,6,15,0
24807,26,77,8981,56,23,10,13,24,-8
24808,29,77,8981,82,50,18,32,56,1
24809,32,77,8981,71,54,13,41,50,12
24813,47,62,8981,82,59,25,34,46,2
24814,50,62,8981,81,77,33,44,44,23
24815,53,62,8981,80,65,30,35,19,16
24816,56,62,8981,73,49,21,28,20,1
24817,59,62,8981,72,37,14,23,30,2
24818,62,62,8981,4,1,0,1,0,3
24820,20,71,7110,8,1,1,0,6,-1
24822,23,81,7110,24,3,2,1,15,-9
24823,26,81,7110,34,4,1,3,27,-15
24824,29,72,7110,1,0,0,0,0,0
24825,32,72,7110,24,4,2,2,21,0
24826,32,88,7110,11,1,1,0,4,0
24827,35,88,7110,8,1,0,1,2,-1
24828,38,88,7110,15,5,2,3,0,-6
24829,41,88,7110,3,0,0,0,0,0
24830,53,69,7110,2,0,0,0,0,0
24831,47,67,9518,14,3,1,2,2,5
24832,50,67,9518,29,11,3,8,18,5
24833,53,67,9518,77,35,19,16,14,9
24834,56,67,9518,73,27,12,15,20,0
24835,59,67,9518,2,1,0,1,0,1
24836,59,63,9518,74,19,10,9,12,-4
24837,62,63,9518,43,13,6,7,28,3
24839,68,63,9518,46,17,10,7,8,3
24840,71,63,9518,72,18,9,9,6,9
24841,74,63,9518,71,13,6,7,12,-9
24842,77,74,9518,12,0,0,0,0,-2
24843,2,67,678,39,3,1,2,35,-20
24844,8,67,678,10,1,0,1,6,-5
24845,11,79,678,36,11,3,8,28,1
24847,50,83,11039,15,4,2,2,26,4
24848,53,83,11039,28,2,1,1,32,-7
24849,56,83,11039,1,0,0,0,2,0
24850,59,85,11039,4,1,1,0,4,1
24851,62,74,11039,11,1,0,1,35,-1
24852,65,74,11039,7,0,0,0,24,-1
24853,68,74,11039,6,1,0,1,9,1
24854,71,77,11039,4,1,0,1,7,0
24855,2,72,54819,3,0,0,0,0,0
24857,8,80,54819,55,24,7,17,57,-25
24858,11,70,54819,5,1,0,1,21,-1
24859,17,68,8594,77,27,13,14,20,5
24860,20,68,8594,78,39,18,21,30,-2
24861,23,68,8594,64,36,12,24,33,-1
24862,26,68,8594,82,43,19,24,29,7
24863,29,68,8594,35,17,7,10,6,5
24864,29,74,8594,46,33,11,22,10,0
24865,32,74,8594,82,67,31,36,20,9
24866,35,74,8594,65,37,17,20,14,-20
24867,38,74,8594,63,27,6,21,16,-3
24868,38,71,8594,12,8,4,4,14,-3
24869,41,71,8594,78,50,15,35,26,18
24870,47,71,8594,64,28,8,20,26,-2
24871,50,78,8594,82,37,10,27,48,-6
24872,53,68,8594,67,17,8,9,16,-1
24874,59,68,8594,76,32,14,18,20,-7
24875,62,68,8594,53,21,7,14,20,2
24877,65,70,8594,73,21,4,17,12,-16
24878,68,1479,8594,9,4,4,0,2,2
24879,71,66,8594,60,9,4,5,41,3
24880,20,62,9034,82,50,21,29,37,-4
24881,23,62,9034,70,32,13,19,29,-10
24882,26,62,9034,82,51,28,23,58,1
24883,29,62,9034,77,63,29,34,26,0
24884,32,62,9034,77,71,31,40,62,-2
24885,35,62,9034,82,96,52,44,77,27
24886,38,62,9034,75,67,35,32,49,-10
24887,41,62,9034,81,73,41,32,84,21
24888,47,62,9034,82,67,35,32,86,5
24889,50,62,9034,70,94,39,55,40,12
24890,53,62,9034,82,98,50,48,83,27
24892,59,62,9034,82,69,32,37,58,-2
24893,62,62,9034,82,86,43,43,40,0
24894,65,62,9034,82,67,32,35,43,-10
24895,68,62,9034,31,22,9,13,22,-7
24896,68,79,9034,13,11,5,6,9,2
24897,71,63,9034,78,61,30,31,47,34
24898,74,64,9034,82,59,29,30,42,0
24899,77,64,9034,82,47,22,25,41,-22
24900,80,64,9034,61,18,8,10,54,-21
24901,80,88,9034,19,9,6,3,16,-9
24902,17,63,8976,74,17,5,12,73,16
24903,20,63,8976,58,14,5,9,54,-9
24904,23,63,8976,66,25,5,20,56,13
24905,26,63,8976,52,24,6,18,48,1
24704,41,65,9071,58,47,13,34,53,-24
24705,47,82,9071,44,32,12,20,32,-29
24910,41,86,8976,64,24,2,22,60,10
24911,47,86,8976,77,23,2,21,66,6
24912,50,86,8976,67,17,5,12,61,10
24913,53,86,8976,61,11,3,8,84,3
24914,17,67,8974,1,1,0,1,2,1
24915,20,67,8974,43,10,1,9,35,3
24916,23,67,8974,56,14,1,13,42,-1
24917,26,67,8974,72,6,0,6,75,20
24918,29,67,8974,78,17,5,12,50,5
24919,32,67,8974,74,11,1,10,76,9
24920,35,67,8974,81,13,2,11,43,18
24921,38,67,8974,59,5,0,5,49,-16
24922,41,67,8974,43,5,2,3,41,6
24923,47,67,8974,75,16,5,11,57,0
24924,50,78,8974,23,0,0,0,12,-9
24925,53,78,8974,66,9,2,7,42,2
24927,59,79,8974,62,10,1,9,54,6
24928,80,67,63310,3,0,0,0,0,1
24929,83,67,63310,18,5,0,5,10,-6
24930,86,67,63310,2,0,0,0,2,1
24931,86,1479,63310,6,1,0,1,2,-3
24932,38,67,58540,14,0,0,0,2,0
24933,23,65,19552,25,11,7,4,10,-1
24934,26,76,19552,4,2,0,2,2,4
24935,29,76,19552,26,11,4,7,16,-8
24936,23,62,8856,10,0,0,0,16,-5
24937,26,62,8856,55,7,3,4,68,3
24938,29,62,8856,39,2,1,1,50,-4
24939,32,62,8856,62,8,2,6,78,3
24940,35,62,8856,66,13,5,8,91,9
24941,38,62,8856,72,12,1,11,99,5
24942,41,62,8856,80,16,1,15,113,4
24945,50,77,8856,43,4,0,4,45,-11
24946,56,88,8856,65,4,2,2,90,-11
24947,20,71,9097,5,0,0,0,4,-1
24948,23,71,9097,18,1,0,1,43,-1
24949,26,71,9097,51,7,0,7,188,1
24950,29,71,9097,72,12,4,8,192,1
24951,32,71,9097,62,5,2,3,110,2
24952,35,71,9097,61,10,6,4,127,8
24953,35,63,9097,12,1,0,1,47,-1
24954,38,63,9097,69,6,1,5,117,-6
24955,41,72,9097,39,3,0,3,44,5
24956,47,72,9097,35,12,1,11,27,-14
24957,47,84,9097,12,0,0,0,8,-3
24958,41,65,729545,10,1,0,1,0,-3
24959,47,65,729545,26,12,3,9,17,-4
24960,47,77,729545,5,1,0,1,2,2
24962,23,79,396127,76,26,13,13,8,-4
24963,26,79,396127,67,19,9,10,14,5
24964,29,79,396127,68,31,12,19,14,12
24965,32,79,396127,66,19,5,14,6,-8
24966,35,79,396127,72,49,20,29,16,-7
24967,38,79,396127,27,25,9,16,16,-3
24968,41,79,396127,75,50,16,34,24,-24
24969,80,77,205203,70,28,11,17,49,-2
24970,83,77,205203,81,47,24,23,46,17
24971,86,77,205203,82,49,24,25,40,-4
24972,2,84,22341,44,31,11,20,42,-2
24973,2,83,22341,26,11,0,11,20,-7
24974,5,83,22341,59,31,10,21,48,-3
24975,8,81,22341,80,86,42,44,92,-24
24976,11,81,22341,78,64,24,40,56,-8
24977,14,81,22341,46,40,13,27,42,-6
24979,20,81,22341,35,24,7,17,16,2
24980,23,81,22341,14,7,2,5,6,-9
24981,26,77,74526,1,0,0,0,5,1
24982,80,63,121020,82,16,6,10,59,9
24983,83,63,121020,76,6,0,6,45,10
24984,86,63,121020,72,10,2,8,47,22
24985,23,71,5690,11,0,0,0,59,-4
24986,26,71,5690,39,5,3,2,57,-1
24987,29,71,5690,76,16,8,8,123,5
24988,32,71,5690,82,29,13,16,148,5
24989,35,71,5690,80,19,5,14,157,6
24990,38,71,5690,64,13,6,7,110,-4
24991,41,71,5690,66,17,6,11,99,7
24992,47,71,5690,72,12,2,10,73,-5
24994,50,79,5690,17,2,0,2,18,-3
24995,53,79,5690,71,13,4,9,141,0
24997,59,75,5690,28,3,1,2,28,-6
24998,80,76,186364,2,0,0,0,6,-2
24999,83,76,186364,82,85,22,63,30,1
25000,86,76,186364,82,62,18,44,46,-5
25001,23,88,8950,22,7,5,2,4,-1
25002,32,83,8950,3,1,0,1,2,-2
25003,41,82,8950,4,1,1,0,0,-1
25004,47,85,8950,3,2,1,1,0,2
25009,29,74,15347,7,1,0,1,22,-2
25010,32,74,15347,3,0,0,0,0,0
25011,38,89,15347,55,8,3,5,108,-3
25012,41,89,15347,65,11,2,9,105,-12
25013,23,1479,11806,1,0,0,0,0,0
25014,29,73,11806,8,0,0,0,40,-3
25015,32,73,11806,6,0,0,0,12,1
25016,35,73,11806,13,0,0,0,23,-3
25018,47,83,556,75,45,18,27,42,-9
25019,50,83,556,82,35,15,20,26,5
25020,53,83,556,76,42,15,27,32,0
25021,56,83,556,20,4,2,2,6,-4
25022,56,78,556,61,24,6,18,24,-6
25023,59,78,556,68,47,24,23,30,6
25024,62,78,556,72,51,20,31,26,-3
25025,65,78,556,43,28,15,13,28,24
25026,68,78,556,40,27,8,19,14,5
25027,71,78,556,68,62,33,29,46,17
25028,74,78,556,74,64,24,40,33,8
25029,77,78,556,67,52,17,35,48,3
25030,80,78,556,76,51,16,35,53,-2
25031,83,78,556,76,46,15,31,20,-11
24907,32,63,8976,58,17,5,12,53,-5
24908,35,63,8976,38,8,0,8,19,-4
25036,26,74,10816,6,0,0,0,0,0
25037,23,84,12801,36,3,1,2,106,-12
25038,26,84,12801,28,2,1,1,63,-7
25039,26,83,12801,20,2,0,2,39,4
25040,29,83,12801,36,3,0,3,68,-4
25041,32,77,12801,60,4,2,2,124,1
25042,35,77,12801,42,5,0,5,113,-7
25043,38,77,12801,19,0,0,0,21,-2
25044,38,64,12801,14,1,0,1,26,6
25045,41,64,12801,34,0,0,0,62,-2
25046,41,74,12801,12,1,0,1,12,-4
25047,2,63,47123,40,11,2,9,8,-4
25048,5,63,47123,23,27,10,17,2,6
25051,83,75,199960,23,3,1,2,4,1
25052,86,75,199960,21,5,1,4,6,5
25053,20,83,73567,8,1,0,1,7,-5
25055,38,64,73567,34,1,1,0,55,2
25056,35,73,8910,22,3,1,2,74,-1
25057,38,73,8910,1,0,0,0,5,0
25058,41,83,8910,40,3,1,2,116,-1
25059,47,83,8910,3,0,0,0,2,-5
25060,47,70,8910,23,3,2,1,54,2
25061,2,79,20976,25,16,6,10,31,0
25064,5,65,20976,25,16,5,11,34,-1
25065,8,65,20976,15,7,1,6,33,6
25066,11,70,20976,1,0,0,0,0,-1
25067,14,88,20976,2,0,0,0,0,-2
25068,23,79,20976,82,40,15,25,59,-1
25069,26,79,20976,58,24,13,11,16,-15
25070,29,79,20976,50,23,10,13,10,-13
25071,20,65,13631,4,1,0,1,2,3
25072,23,65,13631,72,11,0,11,59,14
25074,26,71,13631,11,1,0,1,0,-3
25075,29,71,13631,50,5,0,5,32,-4
25076,29,75,13631,15,2,0,2,8,-5
25077,32,75,13631,39,3,0,3,42,-11
25078,35,78,13631,8,1,0,1,4,3
25079,38,78,13631,47,9,0,9,45,1
25080,41,78,13631,16,1,0,1,20,-3
25081,41,88,9569,4,1,0,1,0,-4
25082,47,88,9569,8,2,0,2,12,-4
25083,47,76,9569,21,3,0,3,8,-8
25084,53,71,9569,71,18,3,15,22,2
25085,56,71,9569,72,39,7,32,38,12
25086,59,71,9569,47,19,6,13,26,-16
25087,59,73,9569,4,2,1,1,6,0
25088,71,71,9569,7,1,0,1,2,0
25089,26,78,8669,3,0,0,0,0,-2
25091,32,78,8669,72,44,19,25,48,11
25092,35,71,8669,82,40,16,24,60,4
25093,38,67,8669,49,26,10,16,30,4
25094,41,67,8669,64,52,15,37,49,17
25095,47,67,8669,64,42,18,24,34,10
25096,50,67,8669,76,56,19,37,39,19
25097,53,67,8669,75,49,22,27,38,1
25098,56,67,8669,70,27,12,15,33,-9
25099,59,67,8669,79,42,21,21,35,14
25100,62,67,8669,67,29,12,17,40,4
25101,65,67,8669,22,8,4,4,6,1
25102,68,67,8669,47,14,5,9,18,6
25103,50,80,9566,6,1,0,1,0,1
25104,80,76,213490,66,24,9,15,10,1
25105,83,76,213490,71,36,21,15,16,2
25106,86,76,213490,81,28,18,10,8,1
25108,47,65,8651,17,5,2,3,16,-5
25109,47,66,8651,22,5,3,2,6,-2
25110,50,66,8651,52,14,2,12,30,-6
25111,56,66,8651,72,35,16,19,16,13
25112,62,66,8651,17,8,3,5,12,-4
25113,62,62,8651,65,27,8,19,20,18
25114,65,62,8651,32,10,2,8,6,2
25115,68,62,8651,7,1,0,1,0,-1
25116,29,74,8711,67,42,19,23,16,3
25117,32,74,8711,79,64,28,36,20,3
25118,35,77,8711,31,10,7,3,8,5
25119,35,84,8711,46,21,9,12,10,4
25120,38,84,8711,9,2,1,1,6,-1
25121,38,66,8711,52,24,9,15,22,-9
25122,41,74,8711,72,26,5,21,16,-8
25123,53,81,8711,62,22,9,13,32,-10
25125,41,75,9046,2,0,0,0,0,0
25126,47,75,9046,80,38,23,15,26,-1
25127,50,75,9046,61,38,22,16,26,-11
25128,53,75,9046,82,52,27,25,22,0
25129,56,75,9046,57,23,12,11,22,-1
25130,59,74,9046,55,14,6,8,32,-9
25131,59,62,9046,12,3,2,1,0,0
25132,62,68,9046,48,23,11,12,10,5
25133,62,84,9046,14,5,2,3,6,0
25134,65,84,9046,71,43,18,25,16,11
25135,68,84,9046,41,15,10,5,10,-4
25136,71,84,9046,78,39,17,22,30,-14
25137,74,84,9046,77,36,12,24,16,8
25138,77,84,9046,33,4,3,1,4,-14
25139,77,79,231345,18,2,2,0,0,-1
25140,83,79,231345,8,3,2,1,0,2
25142,86,1479,231345,47,19,14,5,10,-9
25143,86,63,213766,16,1,1,0,2,-1
25144,80,80,213655,1,0,0,0,0,-2
25145,83,80,213655,63,25,9,16,14,-12
25146,86,80,213655,70,55,14,41,32,-12
25147,2,78,32748,67,59,12,47,39,4
25148,5,78,32748,80,59,20,39,38,8
25149,8,78,32748,71,78,25,53,58,-6
25150,11,78,32748,63,60,13,47,46,-13
25151,11,84,32748,11,6,1,5,10,2
25152,14,84,32748,33,31,8,23,16,-2
25153,17,84,32748,28,17,1,16,18,6
25156,23,66,32748,32,13,3,10,16,-1
25157,23,83,32748,19,9,1,8,10,2
25033,23,81,77149,27,1,0,1,8,-10
25034,26,81,77149,37,6,0,6,14,-11
25162,56,83,9511,71,26,10,16,57,6
25163,59,83,9511,56,26,9,17,39,1
25164,59,62,9511,27,12,4,8,12,7
25165,62,62,9511,16,6,2,4,6,-10
25166,62,66,9511,39,10,0,10,12,4
25167,62,86,9511,23,10,2,8,8,9
25168,65,85,9511,77,32,7,25,22,23
25169,68,85,9511,25,4,2,2,4,5
25170,47,77,8822,25,8,3,5,18,0
25171,50,77,8822,63,11,6,5,233,-13
25172,53,77,8822,23,0,0,0,62,-8
25173,53,65,8822,9,2,0,2,27,-1
25174,56,65,8822,75,15,11,4,161,1
25175,59,65,8822,60,16,7,9,120,9
25177,62,86,8822,34,7,4,3,43,0
25178,65,71,8822,63,13,8,5,107,-1
25180,71,71,8822,7,1,0,1,2,1
25181,26,75,18477,12,1,0,1,4,-1
25182,29,75,18477,24,3,1,2,12,-5
25183,47,74,3173,6,2,2,0,0,-1
25184,50,74,3173,14,6,1,5,4,-2
25185,50,1479,9505,15,1,1,0,6,-5
25186,53,79,9505,1,0,0,0,0,-1
25187,56,65,9505,2,0,0,0,2,0
25188,59,83,9505,1,0,0,0,0,0
25189,62,83,9505,79,20,8,12,33,-4
25190,65,66,9505,79,24,12,12,27,-8
25191,68,66,9505,30,3,0,3,8,-3
25192,26,66,7303,7,0,0,0,0,-2
25193,29,66,7303,2,0,0,0,0,-1
25194,32,66,7303,73,44,20,24,45,-6
25195,35,66,7303,59,17,7,10,24,-8
25197,41,81,7303,12,6,0,6,2,1
25198,26,84,8755,25,8,4,4,8,-1
25199,29,84,8755,71,31,16,15,20,0
25200,32,84,8755,82,36,16,20,22,4
25201,38,80,8755,75,23,6,17,32,11
25202,41,80,8755,81,39,15,24,26,22
25203,47,80,8755,82,50,20,30,40,16
25204,50,80,8755,77,46,12,34,32,7
25205,53,63,8755,63,26,9,17,18,4
25206,62,84,8755,16,2,1,1,2,-3
25209,29,76,8700,64,42,22,20,100,-18
25210,32,76,8700,51,32,18,14,59,-19
25211,35,76,8700,79,38,17,21,113,1
25212,38,76,8700,53,23,10,13,34,-9
25213,38,71,8700,13,5,3,2,9,0
25214,41,71,8700,51,18,10,8,54,-2
25216,50,74,8700,19,5,1,4,14,5
25217,53,84,8700,55,11,6,5,38,-4
25218,80,72,186462,3,0,0,0,0,0
25219,2,71,72941,58,7,3,4,160,-7
25220,5,77,72941,70,6,4,2,81,-11
25221,8,77,72941,70,2,0,2,78,-5
25222,11,77,72941,71,5,1,4,137,-12
25223,14,77,72941,28,3,1,2,53,-1
25224,17,86,72941,37,4,3,1,46,4
25225,2,65,70627,45,11,1,10,55,9
25226,5,65,70627,57,16,6,10,69,7
25227,8,65,70627,33,8,2,6,39,3
25228,11,68,70627,51,12,4,8,60,11
25229,14,68,70627,13,0,0,0,2,1
25230,80,83,223243,77,61,19,42,38,0
25231,83,83,223243,82,69,22,47,26,-1
25233,23,62,68861,12,0,0,0,61,0
25234,26,62,68861,3,0,0,0,25,0
25235,32,68,68861,4,0,0,0,19,0
25236,35,68,68861,6,0,0,0,12,0
25237,86,63,245162,2,1,1,0,0,0
25238,38,74,13517,9,3,1,2,2,1
25239,41,88,13517,34,6,1,5,33,-4
25240,47,88,11834,2,0,0,0,0,-1
25241,53,79,11834,13,1,1,0,2,-2
25242,56,79,11834,1,0,0,0,0,0
25243,83,80,157583,20,4,1,3,4,-5
25244,86,80,157583,5,1,1,0,4,-2
25245,23,83,8971,60,16,6,10,6,-7
25246,26,83,8971,39,24,9,15,2,7
25247,29,83,8971,45,10,5,5,10,-6
25248,32,83,8971,14,1,1,0,0,0
25250,38,83,8971,64,15,6,9,16,3
25251,38,86,8971,16,10,3,7,4,-2
25252,41,86,8971,82,47,20,27,28,23
25253,47,86,8971,76,26,12,14,30,-3
25254,50,88,8971,10,1,1,0,2,0
25255,47,79,10875,33,13,6,7,34,-3
25256,50,79,10875,61,33,18,15,26,-3
25257,53,79,10875,49,20,9,11,28,-3
25260,56,1479,10875,17,9,2,7,6,-2
25261,59,1479,10875,9,0,0,0,2,-3
25262,59,74,10875,49,26,8,18,24,14
25263,62,74,10875,63,27,11,16,18,3
25264,65,74,10875,20,5,1,4,2,0
25265,65,69,10875,29,7,6,1,6,-13
25269,11,70,22102,79,52,17,35,62,10
25270,14,70,22102,17,4,0,4,4,-8
25272,17,72,22102,55,23,7,16,14,-3
25273,20,72,22102,3,1,0,1,0,-1
25274,20,88,22102,19,4,0,4,0,-9
25275,20,70,22102,20,15,8,7,12,6
25276,56,83,11752,21,1,0,1,75,-3
25277,59,83,11752,1,0,0,0,0,-1
25278,65,74,11752,9,1,0,1,29,3
25282,38,82,2087,12,3,1,2,8,-7
25283,38,77,2087,7,1,1,0,2,-1
25285,2,83,25721,27,10,6,4,32,12
25287,38,77,10324,2,0,0,0,0,1
25288,26,75,41709,1,0,0,0,0,0
25289,2,72,69560,58,30,14,16,4,18
25290,5,72,69560,71,28,11,17,27,17
25159,47,83,9511,12,6,1,5,10,2
25160,50,83,9511,76,26,3,23,40,8
25295,20,85,69560,49,13,6,7,8,-3
25296,23,85,69560,80,42,19,23,12,17
25297,26,85,69560,80,28,9,19,42,5
25298,29,85,69560,51,18,10,8,12,8
25299,32,85,69560,60,22,9,13,14,0
25302,23,66,2653,81,63,26,37,16,9
25303,26,66,2653,81,59,24,35,10,-1
25304,29,66,2653,76,48,24,24,12,10
25305,32,66,2653,82,57,20,37,24,-12
25306,35,66,2653,77,69,27,42,23,9
25307,38,66,2653,43,18,6,12,12,-17
25308,38,77,2653,28,13,4,9,6,-1
25309,41,77,2653,74,30,12,18,14,9
25310,47,77,2653,58,34,12,22,12,-9
25311,50,77,2653,77,25,11,14,22,-21
25312,53,77,2653,74,8,5,3,16,-12
25314,83,77,242635,82,41,17,24,20,17
25315,86,77,242635,82,26,7,19,32,-16
25316,2,71,62815,64,4,3,1,160,-6
25317,5,71,62815,79,44,20,24,157,9
25318,8,71,62815,83,30,12,18,133,-27
25319,11,71,62815,84,21,3,18,199,-20
25320,14,71,62815,48,24,7,17,82,0
25321,17,71,62815,82,25,11,14,184,-20
25322,20,71,62815,81,38,8,30,159,4
25323,23,71,62815,82,23,6,17,122,-10
25324,26,71,62815,52,8,4,4,68,-6
25326,29,88,62815,13,3,2,1,13,-2
25327,32,88,62815,82,20,6,14,75,-10
25328,35,88,62815,74,13,6,7,105,-13
25330,41,79,62815,71,4,1,3,109,-19
25331,23,74,8570,28,6,1,5,4,-4
25333,29,62,8570,78,53,22,31,56,-2
25334,32,62,8570,77,65,23,42,46,-12
25335,35,62,8570,56,33,14,19,48,-18
25336,38,62,8570,10,3,1,2,8,-3
25340,50,63,8570,82,96,22,74,96,-19
25341,53,63,8570,74,78,15,63,66,3
25342,56,63,8570,82,88,25,63,70,25
25343,59,63,8570,41,33,10,23,14,2
25344,62,63,8570,25,10,2,8,29,-7
25345,2,78,8785,78,49,17,32,93,2
25346,5,77,8785,80,77,33,44,100,-3
25347,8,77,8785,81,86,37,49,89,-8
25348,11,77,8785,84,97,35,62,85,-9
25349,14,77,8785,48,39,12,27,33,-4
25350,17,77,8785,82,87,26,61,110,20
25351,20,77,8785,82,59,27,32,41,2
25353,26,77,8785,82,74,24,50,47,3
25354,29,77,8785,12,8,5,3,4,-1
25355,29,66,8785,33,14,4,10,22,-12
25356,32,66,8785,79,56,20,36,47,-7
25357,35,66,8785,81,55,23,32,40,3
25358,38,66,8785,48,37,14,23,37,-9
25359,41,66,8785,78,38,12,26,28,0
25360,47,66,8785,78,70,31,39,68,8
25361,50,66,8785,78,82,26,56,46,7
25362,53,66,8785,59,51,19,32,38,0
25363,56,66,8785,80,51,16,35,36,-23
25364,59,66,8785,80,19,9,10,36,-29
25365,2,74,71815,28,10,4,6,18,7
25366,5,74,71815,74,28,13,15,102,14
25367,8,74,71815,60,14,5,9,48,-6
25368,11,70,71815,64,24,12,12,30,18
25370,17,78,71815,17,1,0,1,4,-1
25371,47,79,9395,68,38,6,32,85,-7
25372,50,79,9395,81,59,14,45,77,9
25373,53,79,9395,76,40,12,28,45,-2
25374,56,79,9395,28,13,2,11,16,-15
25375,56,1479,9395,20,10,0,10,12,1
25376,59,1479,9395,62,28,4,24,48,-6
25377,59,71,9395,19,11,3,8,22,7
25378,62,71,9395,35,27,2,25,33,13
25379,65,71,9395,51,20,3,17,16,-16
25380,68,71,9395,34,13,4,9,23,-7
25381,71,68,9395,7,0,0,0,6,-7
25382,83,63,84308,70,43,16,27,19,13
25383,86,63,84308,68,42,27,15,18,2
25384,2,75,69531,17,4,1,3,0,-1
25385,5,75,69531,18,10,4,6,14,4
25387,11,75,69531,71,30,10,20,20,14
25388,14,75,69531,45,25,7,18,16,7
25389,17,75,69531,26,15,7,8,17,-4
25390,20,75,69531,39,23,10,13,14,6
25391,23,75,69531,68,32,12,20,61,11
25392,26,75,69531,60,31,14,17,31,-1
25393,29,75,69531,50,29,14,15,13,3
25394,32,75,69531,35,14,3,11,12,-4
25395,35,75,69531,16,2,0,2,4,-4
25396,35,70,69531,32,13,4,9,8,5
25397,35,80,69531,13,8,5,3,0,-4
25398,2,75,8775,10,2,0,2,4,1
25399,5,75,8775,26,10,2,8,20,9
25400,8,75,8775,70,31,10,21,79,6
25401,11,75,8775,53,23,2,21,63,5
25402,14,75,8775,35,12,4,8,26,-2
25404,20,75,8775,49,15,2,13,24,-7
25405,23,75,8775,79,37,10,27,67,16
25406,26,75,8775,54,12,3,9,28,-8
25407,29,75,8775,54,35,10,25,18,-1
25408,32,75,8775,77,36,15,21,28,-31
25409,35,75,8775,71,33,4,29,25,9
25410,38,75,8775,73,29,4,25,32,-14
25411,41,75,8775,71,31,4,27,22,17
25412,47,64,8775,80,38,10,28,55,1
25413,50,64,8775,33,11,1,10,22,-5
25414,53,75,8775,43,11,3,8,26,-2
25415,56,75,8775,62,18,5,13,19,-3
25416,50,77,10809,9,2,0,2,4,0
25417,53,77,10809,2,0,0,0,2,2
25292,11,79,69560,77,55,18,37,18,19
25293,14,85,69560,45,21,9,12,16,14
25422,71,64,10809,68,9,1,8,46,3
25423,74,64,10809,76,15,2,13,32,-1
25424,77,64,10809,29,0,0,0,2,2
25425,23,63,14806,9,1,0,1,4,1
25426,26,63,14806,33,7,5,2,17,0
25427,29,63,14806,32,12,8,4,13,-6
25428,32,63,14806,15,4,1,3,6,0
25429,38,73,14806,4,0,0,0,0,-2
25430,38,77,5675,60,18,8,10,10,9
25431,41,77,5675,53,14,4,10,17,-2
25432,80,63,20704,49,13,5,8,12,-10
25433,83,63,20704,10,4,0,4,0,-1
25434,86,62,20704,54,18,6,12,8,-1
25435,41,86,8930,4,0,0,0,0,0
25436,47,86,8930,18,6,3,3,8,1
25437,50,86,8930,79,22,7,15,22,1
25439,56,74,8930,2,0,0,0,0,-2
25441,62,68,8930,9,1,0,1,0,0
25442,26,78,8681,66,16,4,12,30,-9
25443,29,78,8681,81,53,25,28,44,19
25444,32,78,8681,36,24,10,14,12,11
25447,38,77,8681,82,44,23,21,46,13
25448,41,77,8681,82,58,20,38,82,18
25449,47,77,8681,73,44,11,33,38,-2
25450,50,65,8681,8,8,3,5,6,4
25451,53,88,8681,82,21,7,14,45,-21
25452,56,88,8681,82,42,18,24,32,-7
25453,59,88,8681,81,42,20,22,38,4
25454,62,88,8681,82,30,12,18,20,-5
25455,65,86,8681,67,24,7,17,18,-6
25456,68,86,8681,28,2,1,1,12,-9
25457,68,65,8681,11,6,1,5,4,7
25459,47,86,9160,49,6,0,6,31,5
25460,50,86,9160,47,4,1,3,26,-3
25461,50,75,9160,7,0,0,0,0,-1
25462,53,75,9160,62,9,0,9,32,0
25463,56,75,9160,81,23,4,19,37,12
25464,59,75,9160,82,10,3,7,39,2
25465,62,75,9160,36,7,1,6,18,-3
25466,65,75,9160,82,16,2,14,39,14
25467,68,75,9160,48,9,2,7,15,4
25468,71,75,9160,66,14,1,13,12,6
25469,74,67,9160,46,6,0,6,16,-28
25470,77,67,9160,77,12,2,10,72,-7
25471,80,67,9160,66,6,1,5,50,-3
25472,83,67,9160,34,2,0,2,17,-4
25473,53,85,1305,8,1,1,0,4,-3
25474,56,85,1305,19,4,1,3,15,-1
25476,62,85,1305,74,15,3,12,87,8
25477,65,85,1305,69,11,1,10,47,16
25478,68,85,1305,45,13,3,10,29,6
25479,71,85,1305,48,11,1,10,34,2
25480,74,85,1305,82,15,3,12,70,-5
25481,77,85,1305,71,15,3,12,56,2
25482,80,85,1305,51,9,1,8,63,-2
25483,83,85,1305,81,13,3,10,47,-7
25484,86,85,1305,52,5,3,2,35,-10
25485,23,89,13957,6,1,0,1,6,1
25486,26,89,13957,16,7,4,3,16,-1
25487,29,62,13957,10,2,0,2,10,1
25488,32,62,13957,14,4,1,3,14,0
25489,35,75,13957,8,1,1,0,8,-1
25490,41,75,13957,4,1,0,1,4,0
25491,23,76,1607,11,1,0,1,2,-3
25493,29,76,1607,11,3,2,1,4,1
25494,35,73,1607,79,36,15,21,56,-15
25495,38,73,1607,78,32,16,16,38,-1
25496,41,73,1607,82,37,16,21,74,-4
25497,47,78,1607,16,9,4,5,14,-2
25498,47,76,9103,80,34,9,25,46,-16
25499,50,76,9103,51,14,1,13,23,-3
25500,53,76,9103,46,18,4,14,16,-1
25501,56,76,9103,51,17,6,11,43,-20
25502,56,80,9103,25,13,5,8,12,4
25503,59,80,9103,67,18,4,14,16,-3
25504,62,80,9103,58,14,3,11,34,-3
25505,62,65,9103,19,7,1,6,2,3
25506,65,75,9103,43,11,2,9,8,-3
25507,83,81,274926,18,11,5,6,6,11
25508,86,81,274926,82,39,19,20,34,25
25510,50,78,10370,3,1,0,1,0,1
25511,53,78,10370,4,0,0,0,5,-1
25512,29,74,205912,1,0,0,0,2,-1
25513,2,84,209898,1,0,0,0,7,0
25514,50,72,10255,19,1,0,1,4,-1
25515,77,65,55848,17,3,1,2,2,-2
25516,80,65,55848,47,16,6,10,8,15
25517,83,65,55848,8,3,1,2,0,1
25518,47,62,10985,2,0,0,0,0,-1
25519,50,62,10985,2,0,0,0,0,0
25520,29,74,14750,1,0,0,0,7,-1
25521,32,74,14750,42,2,0,2,180,5
25522,35,74,14750,40,4,0,4,113,4
25523,38,74,14750,58,12,3,9,161,-2
25524,41,74,14750,40,2,1,1,117,-9
25525,20,88,10400,3,0,0,0,0,-3
25527,41,62,10400,13,2,0,2,2,1
25528,41,73,10400,6,2,0,2,2,0
25529,47,65,10400,7,2,1,1,6,1
25530,50,69,10400,4,0,0,0,4,-1
25531,50,84,11026,2,0,0,0,0,0
25532,47,62,8900,14,2,0,2,6,0
25533,50,62,8900,6,2,1,1,0,-1
25534,5,83,27152,65,28,14,14,40,-19
25535,77,82,45432,4,0,0,0,0,-2
25536,80,82,45432,10,2,1,1,6,0
25537,83,82,45432,33,6,3,3,6,-1
25538,86,82,45432,44,7,4,3,2,-5
25539,77,67,62577,2,2,1,1,0,2
25540,80,67,62577,30,6,4,2,4,-7
25419,59,79,10809,2,0,0,0,0,-2
25420,62,82,10809,3,0,0,0,2,-3
25545,32,79,8619,78,43,15,28,48,19
25546,35,79,8619,79,57,24,33,50,-7
25547,38,79,8619,57,39,14,25,34,1
25550,41,72,8619,13,7,1,6,10,4
25551,47,82,8619,75,33,10,23,78,-8
25552,2,62,68736,5,0,0,0,2,-4
25555,8,81,68736,63,31,10,21,111,-12
25556,11,81,68736,75,15,8,7,30,-9
25557,14,81,68736,48,14,2,12,30,-8
25558,17,75,68736,65,10,3,7,46,-3
25559,20,75,68736,43,15,6,9,16,4
25560,23,75,68736,74,19,13,6,12,0
25561,26,77,68736,71,10,4,6,10,-2
25562,29,77,68736,54,4,2,2,10,-1
25563,29,62,68736,9,4,1,3,2,-3
25564,26,77,41640,62,10,2,8,30,-1
25566,50,84,10222,81,9,3,6,93,-7
25567,53,84,10222,82,31,12,19,179,11
25568,56,84,10222,82,51,28,23,150,23
25569,59,84,10222,82,67,35,32,121,34
25570,62,84,10222,72,48,26,22,77,26
25571,65,84,10222,80,52,28,24,90,24
25572,68,84,10222,47,24,13,11,54,15
25573,71,84,10222,49,15,5,10,71,-9
25574,74,84,10222,70,33,18,15,68,0
25575,77,84,10222,79,22,9,13,49,-13
25576,80,84,10222,55,20,9,11,53,-3
25577,80,80,10222,20,11,6,5,9,6
25578,83,80,10222,71,14,6,8,59,-8
25586,23,66,67421,76,12,1,11,106,-6
25587,26,66,67421,51,3,0,3,46,3
25588,26,77,67421,17,1,0,1,14,1
25591,77,65,24661,80,77,30,47,32,8
25592,80,65,24661,82,74,31,43,21,18
25593,83,82,24661,81,82,27,55,26,23
25594,86,82,24661,79,87,28,59,23,14
25595,2,85,42479,80,50,20,30,112,14
25596,5,85,42479,79,51,19,32,118,26
25597,8,85,42479,80,35,10,25,74,18
25598,11,85,42479,51,22,10,12,31,12
25599,14,85,42479,42,14,6,8,60,13
25600,17,81,42479,81,28,13,15,119,4
25601,20,81,42479,74,35,14,21,106,5
25602,23,86,42479,42,12,6,6,50,2
25603,26,86,42479,18,1,0,1,29,-3
25604,29,81,42479,4,2,0,2,0,2
25605,2,63,22703,62,28,15,13,40,17
25606,5,89,22703,66,67,23,44,50,-4
25608,11,89,22703,78,42,25,17,73,-1
25609,14,89,22703,2,0,0,0,2,0
25610,14,88,22703,38,19,4,15,8,-4
25611,17,67,22703,74,58,25,33,30,0
25612,20,67,22703,55,31,10,21,20,17
25613,23,67,22703,30,10,4,6,0,0
25614,47,65,10669,2,0,0,0,0,-1
25615,50,65,10669,14,4,1,3,8,-3
25616,53,65,10669,5,0,0,0,0,-3
25617,56,63,10669,14,4,2,2,4,-1
25618,59,80,10669,3,0,0,0,0,-2
25619,71,75,10669,1,0,0,0,0,0
25620,26,84,10228,5,1,1,0,4,-1
25621,29,84,10228,18,6,2,4,12,9
25622,32,84,10228,52,14,4,10,10,4
25623,35,84,10228,66,25,8,17,44,21
25625,41,84,10228,80,42,10,32,36,11
25626,47,76,10228,57,27,2,25,64,-9
25627,47,88,10228,11,1,0,1,6,-4
25628,50,88,10228,44,23,4,19,14,2
25629,50,84,10228,20,5,1,4,10,0
25630,53,65,10228,58,20,1,19,28,9
25631,56,65,10228,23,2,1,1,8,-4
25632,59,65,10228,73,8,1,7,34,3
25634,62,75,10228,12,0,0,0,0,-1
25635,77,64,11952,55,11,4,7,47,-4
25636,80,64,11952,55,7,3,4,32,-10
25637,80,75,11952,9,0,0,0,0,-4
25638,83,65,11952,9,1,1,0,17,-1
25639,86,65,11952,24,4,1,3,14,-5
25640,77,77,16727,45,12,4,8,34,5
25641,77,63,7958,44,5,2,3,4,-6
25643,47,76,10188,13,8,2,6,8,0
25644,50,65,10188,70,39,18,21,22,-4
25645,53,66,10188,58,24,9,15,10,-8
25646,56,83,10188,15,6,3,3,4,2
25647,77,72,43901,78,15,8,7,33,-9
25648,80,72,43901,43,4,2,2,15,-14
25649,50,71,3415,68,16,4,12,52,-1
25650,53,71,3415,17,3,2,1,6,-4
25651,53,77,3415,21,5,0,5,8,-6
25652,20,63,18502,3,1,1,0,0,-2
25653,29,67,9037,3,1,1,0,0,-1
25654,32,67,9037,41,11,8,3,22,-2
25655,35,67,9037,61,8,2,6,28,-1
25656,38,67,9037,25,2,2,0,17,-4
25657,41,80,9037,5,0,0,0,0,-3
25658,47,80,9037,4,1,1,0,0,1
25661,50,77,9037,7,0,0,0,0,-4
25662,77,63,214791,19,1,0,1,8,-4
25663,80,63,214791,29,5,2,3,16,3
25664,83,63,214791,60,11,10,1,9,-6
25665,86,63,214791,72,14,6,8,47,-3
25666,62,80,386180,8,1,0,1,6,-1
25667,68,80,386180,33,10,3,7,8,-3
25668,71,64,386180,79,28,7,21,26,2
25669,74,67,386180,59,9,1,8,20,-19
25670,77,78,386180,2,0,0,0,0,1
25671,2,84,33739,69,18,6,12,257,-18
25672,2,78,33739,13,4,0,4,32,4
25673,5,78,33739,68,20,5,15,189,5
25674,8,78,33739,84,15,5,10,211,0
25542,86,67,62577,74,29,9,20,25,-7
25543,26,79,8619,82,42,13,29,40,-2
25680,32,62,8824,81,15,7,8,69,-11
25681,35,62,8824,66,18,4,14,61,-1
25682,38,73,8824,82,16,5,11,36,-11
25683,41,83,8824,10,0,0,0,7,0
25684,47,83,8824,60,8,1,7,43,-15
25685,32,82,3573,6,1,1,0,2,-1
25686,35,82,3573,4,1,1,0,2,-2
25687,53,79,11349,15,2,1,1,10,-1
25688,56,79,11349,20,3,1,2,4,0
25689,59,71,11349,5,1,0,1,0,-3
25690,77,82,66228,8,0,0,0,0,9
25691,83,82,66228,11,4,0,4,2,2
25692,86,82,66228,25,5,0,5,6,6
25693,29,75,8727,1,0,0,0,0,0
25694,32,75,8727,65,12,6,6,14,0
25695,35,75,8727,56,11,1,10,14,-25
25697,41,70,8727,14,1,1,0,8,-2
25698,41,65,8727,45,12,2,10,33,6
25699,47,70,8727,75,20,5,15,67,15
25700,50,70,8727,75,17,0,17,86,-1
25701,53,70,8727,82,26,9,17,85,0
25702,56,70,8727,72,26,3,23,76,10
25703,59,70,8727,82,41,10,31,70,-10
25704,62,70,8727,81,30,5,25,67,-7
25705,65,70,8727,75,22,5,17,48,-5
25706,68,70,8727,48,13,1,12,56,2
25707,71,70,8727,24,5,4,1,12,7
25708,71,1479,8727,14,5,1,4,8,3
25709,74,83,8727,52,7,1,6,34,8
25710,26,66,4516,3,0,0,0,0,0
25711,29,66,4516,26,2,0,2,17,-10
25712,35,66,4516,4,0,0,0,2,0
25714,38,68,4516,30,3,0,3,19,-4
25715,41,68,4516,50,11,5,6,84,-10
25716,47,62,4516,45,6,4,2,69,-2
25717,50,62,4516,64,14,8,6,68,3
25718,53,84,4516,71,11,3,8,80,-10
25719,2,63,1821,18,4,1,3,6,1
25720,5,63,1821,3,1,1,0,0,-1
25721,23,68,69525,19,0,0,0,153,-4
25722,26,68,69525,62,9,4,5,258,0
25723,29,68,69525,48,9,3,6,169,-7
25724,32,68,69525,71,10,3,7,248,-10
25725,35,68,69525,79,9,4,5,354,-15
25726,38,68,69525,63,5,2,3,193,-14
25727,41,64,69525,49,4,3,1,179,2
25728,77,72,99073,7,0,0,0,4,0
25729,77,66,67708,6,2,2,0,2,1
25731,83,66,67708,80,38,15,23,28,-15
25732,86,62,67708,81,38,13,25,24,21
25733,2,63,40939,19,4,2,2,82,-2
25734,5,63,40939,31,2,1,1,129,-5
25735,8,86,40939,18,5,4,1,122,-2
25736,2,76,30932,4,0,0,0,14,-2
25737,5,65,30932,1,0,0,0,0,0
25738,23,63,191228,82,27,8,19,38,-14
25739,26,63,191228,77,17,7,10,18,-14
25740,29,63,191228,81,26,10,16,24,1
25741,32,63,191228,81,23,8,15,27,-12
25742,35,63,191228,78,24,7,17,16,6
25743,38,63,191228,66,36,17,19,24,8
25744,41,63,191228,68,20,6,14,42,2
25745,47,63,191228,59,28,10,18,4,-3
25746,50,63,191228,55,27,11,16,52,-10
25748,56,63,191228,75,30,6,24,16,-1
25749,26,67,5517,16,1,0,1,17,0
25750,29,67,5517,11,0,0,0,15,-1
25751,32,82,5517,64,5,1,4,73,-6
25752,35,82,5517,81,8,2,6,90,-29
25753,38,82,5517,41,1,1,0,64,-6
25754,41,82,5517,16,0,0,0,12,-3
25756,41,89,5517,13,1,1,0,14,-2
25757,26,64,11757,12,0,0,0,9,5
25758,29,64,11757,3,0,0,0,0,2
25759,47,71,11757,7,0,0,0,7,1
25760,23,76,69981,13,1,0,1,45,3
25761,26,76,69981,4,0,0,0,7,-2
25762,29,76,69981,9,1,0,1,30,1
25763,32,76,69981,13,2,0,2,40,-1
25764,35,76,69981,2,0,0,0,5,-1
25766,32,78,3734,4,0,0,0,2,1
25767,35,64,3734,3,0,0,0,0,0
25768,26,68,8634,5,1,0,1,0,2
25769,29,68,8634,13,6,1,5,2,-3
25770,32,69,8634,75,30,9,21,28,-6
25771,35,69,8634,62,24,5,19,32,-6
25772,38,69,8634,78,29,8,21,29,0
25773,41,69,8634,77,24,5,19,28,-7
25774,47,69,8634,65,25,6,19,44,0
25775,50,81,8634,81,37,15,22,36,-9
25776,53,81,8634,75,31,6,25,40,-8
25779,62,80,8634,64,16,2,14,16,-26
25780,65,80,8634,73,32,6,26,26,26
25781,68,68,8634,44,10,1,9,24,-18
25782,41,85,13399,5,0,0,0,2,-1
25783,47,63,13399,2,0,0,0,0,0
25784,38,86,13554,7,1,0,1,0,2
25785,32,65,67158,11,1,0,1,9,-3
25786,35,65,67158,3,0,0,0,0,-2
25787,41,1479,67158,4,0,0,0,4,0
25788,29,78,12780,1,0,0,0,0,0
25789,38,88,12780,6,0,0,0,4,-1
25790,41,76,12780,4,0,0,0,2,0
25791,20,78,76906,34,6,1,5,44,-1
25792,23,78,76906,6,1,0,1,6,-3
25793,8,81,62572,8,2,1,1,2,-5
25794,20,75,281541,13,2,0,2,2,1
25795,23,75,281541,9,1,1,0,0,-3
25796,26,75,281541,8,2,1,1,2,-2
25677,14,83,33739,45,8,1,7,59,-5
25678,26,62,8824,78,18,10,8,53,11
25797,23,83,8610,25,7,2,5,28,0
25798,26,83,8610,57,12,4,8,47,5
25799,29,83,8610,59,10,0,10,28,13
25800,32,83,8610,59,16,3,13,34,6
25803,41,66,8610,44,14,4,10,37,-6
25804,41,77,8610,34,5,2,3,58,0
25805,47,73,8610,58,11,0,11,62,9
25806,50,85,8610,66,16,4,12,59,25
25807,41,72,69978,8,1,1,0,22,1
25808,41,89,70168,3,0,0,0,14,-1
25809,2,84,40091,3,0,0,0,0,0
25810,5,63,40091,2,0,0,0,0,-1
25811,2,84,40083,61,44,13,31,42,1
25812,8,81,40083,6,2,1,1,2,-4
25813,11,86,40083,4,1,0,1,0,-5
25814,2,77,40942,79,32,7,25,204,-15
25815,5,77,40942,73,16,4,12,195,-14
25816,8,77,40942,83,19,3,16,150,18
25817,11,85,40942,68,7,1,6,130,13
25818,14,85,40942,20,3,1,2,21,7
25819,17,68,40942,73,13,3,10,80,10
25820,20,68,40942,70,14,0,14,96,-4
25821,23,68,40942,74,8,1,7,63,6
25822,26,68,40942,62,11,2,9,54,0
